AIRPORT,Year,Month,Int_Pax_In,Int_Pax_Out,Int_Pax_Total,Date
ADELAIDE,1985,1,5806,4733,10539,1985-01-01T00:00:00
ADELAIDE,1985,2,4260,3555,7815,1985-02-01T00:00:00
ADELAIDE,1985,3,5288,5157,10445,1985-03-01T00:00:00
ADELAIDE,1985,4,3346,4721,8067,1985-04-01T00:00:00
ADELAIDE,1985,5,3943,5037,8980,1985-05-01T00:00:00
ADELAIDE,1985,6,4304,4905,9209,1985-06-01T00:00:00
ADELAIDE,1985,7,3851,3766,7617,1985-07-01T00:00:00
ADELAIDE,1985,8,4056,4822,8878,1985-08-01T00:00:00
ADELAIDE,1985,9,5283,3531,8814,1985-09-01T00:00:00
ADELAIDE,1985,10,5286,2970,8256,1985-10-01T00:00:00
ADELAIDE,1985,11,4903,4107,9010,1985-11-01T00:00:00
ADELAIDE,1985,12,5027,5377,10404,1985-12-01T00:00:00
ADELAIDE,1986,1,6341,5521,11862,1986-01-01T00:00:00
ADELAIDE,1986,2,5204,3761,8965,1986-02-01T00:00:00
ADELAIDE,1986,3,5466,5979,11445,1986-03-01T00:00:00
ADELAIDE,1986,4,3791,6316,10107,1986-04-01T00:00:00
ADELAIDE,1986,5,5231,7070,12301,1986-05-01T00:00:00
ADELAIDE,1986,6,5394,5506,10900,1986-06-01T00:00:00
ADELAIDE,1986,7,5279,5665,10944,1986-07-01T00:00:00
ADELAIDE,1986,8,6065,5195,11260,1986-08-01T00:00:00
ADELAIDE,1986,9,7182,5557,12739,1986-09-01T00:00:00
ADELAIDE,1986,10,7598,4383,11981,1986-10-01T00:00:00
ADELAIDE,1986,11,6006,5070,11076,1986-11-01T00:00:00
ADELAIDE,1986,12,6716,6275,12991,1986-12-01T00:00:00
ADELAIDE,1987,1,7394,6411,13805,1987-01-01T00:00:00
ADELAIDE,1987,2,5470,4329,9799,1987-02-01T00:00:00
ADELAIDE,1987,3,5750,7052,12802,1987-03-01T00:00:00
ADELAIDE,1987,4,4916,6156,11072,1987-04-01T00:00:00
ADELAIDE,1987,5,4564,6034,10598,1987-05-01T00:00:00
ADELAIDE,1987,6,4655,5161,9816,1987-06-01T00:00:00
ADELAIDE,1987,7,6530,5611,12141,1987-07-01T00:00:00
ADELAIDE,1987,8,6011,5629,11640,1987-08-01T00:00:00
ADELAIDE,1987,9,6478,5777,12255,1987-09-01T00:00:00
ADELAIDE,1987,10,7776,4707,12483,1987-10-01T00:00:00
ADELAIDE,1987,11,6313,4681,10994,1987-11-01T00:00:00
ADELAIDE,1987,12,5908,6379,12287,1987-12-01T00:00:00
ADELAIDE,1988,1,7498,6560,14058,1988-01-01T00:00:00
ADELAIDE,1988,2,5796,4601,10397,1988-02-01T00:00:00
ADELAIDE,1988,3,6143,6241,12384,1988-03-01T00:00:00
ADELAIDE,1988,4,5466,6875,12341,1988-04-01T00:00:00
ADELAIDE,1988,5,4197,6040,10237,1988-05-01T00:00:00
ADELAIDE,1988,6,4872,5430,10302,1988-06-01T00:00:00
ADELAIDE,1988,7,6347,5702,12049,1988-07-01T00:00:00
ADELAIDE,1988,8,5888,5534,11422,1988-08-01T00:00:00
ADELAIDE,1988,9,6160,5815,11975,1988-09-01T00:00:00
ADELAIDE,1988,10,7712,4862,12574,1988-10-01T00:00:00
ADELAIDE,1988,11,6615,4764,11379,1988-11-01T00:00:00
ADELAIDE,1988,12,5779,5987,11766,1988-12-01T00:00:00
ADELAIDE,1989,1,7284,6036,13320,1989-01-01T00:00:00
ADELAIDE,1989,2,5748,4585,10333,1989-02-01T00:00:00
ADELAIDE,1989,3,5487,6162,11649,1989-03-01T00:00:00
ADELAIDE,1989,4,5130,6246,11376,1989-04-01T00:00:00
ADELAIDE,1989,5,4075,5943,10018,1989-05-01T00:00:00
ADELAIDE,1989,6,5062,5510,10572,1989-06-01T00:00:00
ADELAIDE,1989,7,6723,5765,12488,1989-07-01T00:00:00
ADELAIDE,1989,8,6288,6661,12949,1989-08-01T00:00:00
ADELAIDE,1989,9,6895,6568,13463,1989-09-01T00:00:00
ADELAIDE,1989,10,8922,5202,14124,1989-10-01T00:00:00
ADELAIDE,1989,11,6981,6010,12991,1989-11-01T00:00:00
ADELAIDE,1989,12,7030,6865,13895,1989-12-01T00:00:00
ADELAIDE,1990,1,8799,7675,16474,1990-01-01T00:00:00
ADELAIDE,1990,2,7620,5683,13303,1990-02-01T00:00:00
ADELAIDE,1990,3,7488,8255,15743,1990-03-01T00:00:00
ADELAIDE,1990,4,7428,8430,15858,1990-04-01T00:00:00
ADELAIDE,1990,5,5471,7577,13048,1990-05-01T00:00:00
ADELAIDE,1990,6,6392,7531,13923,1990-06-01T00:00:00
ADELAIDE,1990,7,8749,7164,15913,1990-07-01T00:00:00
ADELAIDE,1990,8,7633,7886,15519,1990-08-01T00:00:00
ADELAIDE,1990,9,8297,7188,15485,1990-09-01T00:00:00
ADELAIDE,1990,10,9307,5805,15112,1990-10-01T00:00:00
ADELAIDE,1990,11,7845,7732,15577,1990-11-01T00:00:00
ADELAIDE,1990,12,7840,7602,15442,1990-12-01T00:00:00
ADELAIDE,1991,1,10111,8467,18578,1991-01-01T00:00:00
ADELAIDE,1991,2,7757,6561,14318,1991-02-01T00:00:00
ADELAIDE,1991,3,7155,8125,15280,1991-03-01T00:00:00
ADELAIDE,1991,4,6806,8661,15467,1991-04-01T00:00:00
ADELAIDE,1991,5,5375,7596,12971,1991-05-01T00:00:00
ADELAIDE,1991,6,7166,8046,15212,1991-06-01T00:00:00
ADELAIDE,1991,7,9047,8858,17905,1991-07-01T00:00:00
ADELAIDE,1991,8,8228,7673,15901,1991-08-01T00:00:00
ADELAIDE,1991,9,8573,7961,16534,1991-09-01T00:00:00
ADELAIDE,1991,10,11096,7035,18131,1991-10-01T00:00:00
ADELAIDE,1991,11,8315,7736,16051,1991-11-01T00:00:00
ADELAIDE,1991,12,7331,8405,15736,1991-12-01T00:00:00
ADELAIDE,1992,1,9464,8109,17573,1992-01-01T00:00:00
ADELAIDE,1992,2,8648,6261,14909,1992-02-01T00:00:00
ADELAIDE,1992,3,7441,8565,16006,1992-03-01T00:00:00
ADELAIDE,1992,4,7219,9252,16471,1992-04-01T00:00:00
ADELAIDE,1992,5,5971,7988,13959,1992-05-01T00:00:00
ADELAIDE,1992,6,6921,7561,14482,1992-06-01T00:00:00
ADELAIDE,1992,7,9753,9946,19699,1992-07-01T00:00:00
ADELAIDE,1992,8,8487,7914,16401,1992-08-01T00:00:00
ADELAIDE,1992,9,9830,8314,18144,1992-09-01T00:00:00
ADELAIDE,1992,10,12087,7679,19766,1992-10-01T00:00:00
ADELAIDE,1992,11,9285,8656,17941,1992-11-01T00:00:00
ADELAIDE,1992,12,8826,10286,19112,1992-12-01T00:00:00
ADELAIDE,1993,1,11608,8542,20150,1993-01-01T00:00:00
ADELAIDE,1993,2,8654,6639,15293,1993-02-01T00:00:00
ADELAIDE,1993,3,8619,9027,17646,1993-03-01T00:00:00
ADELAIDE,1993,4,8341,9601,17942,1993-04-01T00:00:00
ADELAIDE,1993,5,7059,8815,15874,1993-05-01T00:00:00
ADELAIDE,1993,6,7650,7877,15527,1993-06-01T00:00:00
ADELAIDE,1993,7,11010,9204,20214,1993-07-01T00:00:00
ADELAIDE,1993,8,8538,8082,16620,1993-08-01T00:00:00
ADELAIDE,1993,9,10553,9358,19911,1993-09-01T00:00:00
ADELAIDE,1993,10,11970,7755,19725,1993-10-01T00:00:00
ADELAIDE,1993,11,9388,8592,17980,1993-11-01T00:00:00
ADELAIDE,1993,12,8900,10637,19537,1993-12-01T00:00:00
ADELAIDE,1994,1,11395,8634,20029,1994-01-01T00:00:00
ADELAIDE,1994,2,9896,6851,16747,1994-02-01T00:00:00
ADELAIDE,1994,3,8719,9729,18448,1994-03-01T00:00:00
ADELAIDE,1994,4,8102,9679,17781,1994-04-01T00:00:00
ADELAIDE,1994,5,6250,8464,14714,1994-05-01T00:00:00
ADELAIDE,1994,6,7094,7826,14920,1994-06-01T00:00:00
ADELAIDE,1994,7,10622,9948,20570,1994-07-01T00:00:00
ADELAIDE,1994,8,8534,7828,16362,1994-08-01T00:00:00
ADELAIDE,1994,9,10106,8100,18206,1994-09-01T00:00:00
ADELAIDE,1994,10,11592,7112,18704,1994-10-01T00:00:00
ADELAIDE,1994,11,10131,8148,18279,1994-11-01T00:00:00
ADELAIDE,1994,12,8966,10630,19596,1994-12-01T00:00:00
ADELAIDE,1995,1,11250,8889,20139,1995-01-01T00:00:00
ADELAIDE,1995,2,9130,6914,16044,1995-02-01T00:00:00
ADELAIDE,1995,3,8120,9584,17704,1995-03-01T00:00:00
ADELAIDE,1995,4,8398,8721,17119,1995-04-01T00:00:00
ADELAIDE,1995,5,6882,8291,15173,1995-05-01T00:00:00
ADELAIDE,1995,6,7417,7651,15068,1995-06-01T00:00:00
ADELAIDE,1995,7,10092,9260,19352,1995-07-01T00:00:00
ADELAIDE,1995,8,8867,7549,16416,1995-08-01T00:00:00
ADELAIDE,1995,9,9803,7582,17385,1995-09-01T00:00:00
ADELAIDE,1995,10,10182,7374,17556,1995-10-01T00:00:00
ADELAIDE,1995,11,9491,8875,18366,1995-11-01T00:00:00
ADELAIDE,1995,12,8044,9255,17299,1995-12-01T00:00:00
ADELAIDE,1996,1,9923,8637,18560,1996-01-01T00:00:00
ADELAIDE,1996,2,8401,6914,15315,1996-02-01T00:00:00
ADELAIDE,1996,3,8309,9248,17557,1996-03-01T00:00:00
ADELAIDE,1996,4,7834,9469,17303,1996-04-01T00:00:00
ADELAIDE,1996,5,6754,8634,15388,1996-05-01T00:00:00
ADELAIDE,1996,6,7582,8188,15770,1996-06-01T00:00:00
ADELAIDE,1996,7,9575,9251,18826,1996-07-01T00:00:00
ADELAIDE,1996,8,8437,8076,16513,1996-08-01T00:00:00
ADELAIDE,1996,9,9246,8165,17411,1996-09-01T00:00:00
ADELAIDE,1996,10,10650,7256,17906,1996-10-01T00:00:00
ADELAIDE,1996,11,8254,7305,15559,1996-11-01T00:00:00
ADELAIDE,1996,12,8739,11016,19755,1996-12-01T00:00:00
ADELAIDE,1997,1,10628,8761,19389,1997-01-01T00:00:00
ADELAIDE,1997,2,9105,7659,16764,1997-02-01T00:00:00
ADELAIDE,1997,3,7810,9157,16967,1997-03-01T00:00:00
ADELAIDE,1997,4,7022,8848,15870,1997-04-01T00:00:00
ADELAIDE,1997,5,6472,9269,15741,1997-05-01T00:00:00
ADELAIDE,1997,6,7375,7916,15291,1997-06-01T00:00:00
ADELAIDE,1997,7,9937,9100,19037,1997-07-01T00:00:00
ADELAIDE,1997,8,8846,7939,16785,1997-08-01T00:00:00
ADELAIDE,1997,9,8947,7789,16736,1997-09-01T00:00:00
ADELAIDE,1997,10,11139,7355,18494,1997-10-01T00:00:00
ADELAIDE,1997,11,9446,8657,18103,1997-11-01T00:00:00
ADELAIDE,1997,12,9168,10545,19713,1997-12-01T00:00:00
ADELAIDE,1998,1,9797,9124,18921,1998-01-01T00:00:00
ADELAIDE,1998,2,9706,7361,17067,1998-02-01T00:00:00
ADELAIDE,1998,3,7992,9944,17936,1998-03-01T00:00:00
ADELAIDE,1998,4,7889,9719,17608,1998-04-01T00:00:00
ADELAIDE,1998,5,6504,9856,16360,1998-05-01T00:00:00
ADELAIDE,1998,6,8000,7770,15770,1998-06-01T00:00:00
ADELAIDE,1998,7,9833,9558,19391,1998-07-01T00:00:00
ADELAIDE,1998,8,10037,9176,19213,1998-08-01T00:00:00
ADELAIDE,1998,9,10092,8787,18879,1998-09-01T00:00:00
ADELAIDE,1998,10,11855,9352,21207,1998-10-01T00:00:00
ADELAIDE,1998,11,10534,8372,18906,1998-11-01T00:00:00
ADELAIDE,1998,12,10450,11327,21777,1998-12-01T00:00:00
ADELAIDE,1999,1,12067,10481,22548,1999-01-01T00:00:00
ADELAIDE,1999,2,10018,8079,18097,1999-02-01T00:00:00
ADELAIDE,1999,3,9575,9900,19475,1999-03-01T00:00:00
ADELAIDE,1999,4,8852,10625,19477,1999-04-01T00:00:00
ADELAIDE,1999,5,7057,9639,16696,1999-05-01T00:00:00
ADELAIDE,1999,6,8000,8901,16901,1999-06-01T00:00:00
ADELAIDE,1999,7,11313,9647,20960,1999-07-01T00:00:00
ADELAIDE,1999,8,9570,9967,19537,1999-08-01T00:00:00
ADELAIDE,1999,9,11396,9686,21082,1999-09-01T00:00:00
ADELAIDE,1999,10,13669,9988,23657,1999-10-01T00:00:00
ADELAIDE,1999,11,11373,9303,20676,1999-11-01T00:00:00
ADELAIDE,1999,12,10623,11285,21908,1999-12-01T00:00:00
ADELAIDE,2000,1,12600,10158,22758,2000-01-01T00:00:00
ADELAIDE,2000,2,12498,8095,20593,2000-02-01T00:00:00
ADELAIDE,2000,3,10494,10812,21306,2000-03-01T00:00:00
ADELAIDE,2000,4,11000,12737,23737,2000-04-01T00:00:00
ADELAIDE,2000,5,7765,10890,18655,2000-05-01T00:00:00
ADELAIDE,2000,6,9452,9579,19031,2000-06-01T00:00:00
ADELAIDE,2000,7,13181,12116,25297,2000-07-01T00:00:00
ADELAIDE,2000,8,11577,11424,23001,2000-08-01T00:00:00
ADELAIDE,2000,9,12581,11343,23924,2000-09-01T00:00:00
ADELAIDE,2000,10,13840,9895,23735,2000-10-01T00:00:00
ADELAIDE,2000,11,12124,10650,22774,2000-11-01T00:00:00
ADELAIDE,2000,12,12423,12865,25288,2000-12-01T00:00:00
ADELAIDE,2001,1,12908,11239,24147,2001-01-01T00:00:00
ADELAIDE,2001,2,10674,8310,18984,2001-02-01T00:00:00
ADELAIDE,2001,3,9991,10080,20071,2001-03-01T00:00:00
ADELAIDE,2001,4,9402,10934,20336,2001-04-01T00:00:00
ADELAIDE,2001,5,7358,10058,17416,2001-05-01T00:00:00
ADELAIDE,2001,6,9350,9540,18890,2001-06-01T00:00:00
ADELAIDE,2001,7,11404,10468,21872,2001-07-01T00:00:00
ADELAIDE,2001,8,9823,9193,19016,2001-08-01T00:00:00
ADELAIDE,2001,9,10938,9440,20378,2001-09-01T00:00:00
ADELAIDE,2001,10,12933,9145,22078,2001-10-01T00:00:00
ADELAIDE,2001,11,9686,8967,18653,2001-11-01T00:00:00
ADELAIDE,2001,12,9894,10109,20003,2001-12-01T00:00:00
ADELAIDE,2002,1,10638,9181,19819,2002-01-01T00:00:00
ADELAIDE,2002,2,9245,7261,16506,2002-02-01T00:00:00
ADELAIDE,2002,3,9520,9248,18768,2002-03-01T00:00:00
ADELAIDE,2002,4,8064,9920,17984,2002-04-01T00:00:00
ADELAIDE,2002,5,7399,9532,16931,2002-05-01T00:00:00
ADELAIDE,2002,6,8463,9154,17617,2002-06-01T00:00:00
ADELAIDE,2002,7,11119,9866,20985,2002-07-01T00:00:00
ADELAIDE,2002,8,10171,9170,19341,2002-08-01T00:00:00
ADELAIDE,2002,9,10182,9382,19564,2002-09-01T00:00:00
ADELAIDE,2002,10,11179,8100,19279,2002-10-01T00:00:00
ADELAIDE,2002,11,9875,7582,17457,2002-11-01T00:00:00
ADELAIDE,2002,12,9593,10507,20100,2002-12-01T00:00:00
ADELAIDE,2003,1,11042,9146,20188,2003-01-01T00:00:00
ADELAIDE,2003,2,9785,6665,16450,2003-02-01T00:00:00
ADELAIDE,2003,3,8401,8183,16584,2003-03-01T00:00:00
ADELAIDE,2003,4,6541,7098,13639,2003-04-01T00:00:00
ADELAIDE,2003,5,4880,6339,11219,2003-05-01T00:00:00
ADELAIDE,2003,6,5811,6511,12322,2003-06-01T00:00:00
ADELAIDE,2003,7,9592,8398,17990,2003-07-01T00:00:00
ADELAIDE,2003,8,9165,8981,18146,2003-08-01T00:00:00
ADELAIDE,2003,9,9426,8703,18129,2003-09-01T00:00:00
ADELAIDE,2003,10,11750,7694,19444,2003-10-01T00:00:00
ADELAIDE,2003,11,10046,9603,19649,2003-11-01T00:00:00
ADELAIDE,2003,12,11138,11951,23089,2003-12-01T00:00:00
ADELAIDE,2004,1,13508,11289,24797,2004-01-01T00:00:00
ADELAIDE,2004,2,12530,8745,21275,2004-02-01T00:00:00
ADELAIDE,2004,3,10960,11578,22538,2004-03-01T00:00:00
ADELAIDE,2004,4,11267,11970,23237,2004-04-01T00:00:00
ADELAIDE,2004,5,8731,11527,20258,2004-05-01T00:00:00
ADELAIDE,2004,6,10254,11207,21461,2004-06-01T00:00:00
ADELAIDE,2004,7,14312,11764,26076,2004-07-01T00:00:00
ADELAIDE,2004,8,11938,11625,23563,2004-08-01T00:00:00
ADELAIDE,2004,9,12404,12436,24840,2004-09-01T00:00:00
ADELAIDE,2004,10,14912,10464,25376,2004-10-01T00:00:00
ADELAIDE,2004,11,11890,11101,22991,2004-11-01T00:00:00
ADELAIDE,2004,12,14349,15322,29671,2004-12-01T00:00:00
ADELAIDE,2005,1,16357,14082,30439,2005-01-01T00:00:00
ADELAIDE,2005,2,14947,10875,25822,2005-02-01T00:00:00
ADELAIDE,2005,3,14716,13922,28638,2005-03-01T00:00:00
ADELAIDE,2005,4,13485,14559,28044,2005-04-01T00:00:00
ADELAIDE,2005,5,11771,14314,26085,2005-05-01T00:00:00
ADELAIDE,2005,6,12830,13596,26426,2005-06-01T00:00:00
ADELAIDE,2005,7,16226,13907,30133,2005-07-01T00:00:00
ADELAIDE,2005,8,14766,13102,27868,2005-08-01T00:00:00
ADELAIDE,2005,9,13429,11769,25198,2005-09-01T00:00:00
ADELAIDE,2005,10,15960,12620,28580,2005-10-01T00:00:00
ADELAIDE,2005,11,13653,12548,26201,2005-11-01T00:00:00
ADELAIDE,2005,12,14431,16433,30864,2005-12-01T00:00:00
ADELAIDE,2006,1,16837,14519,31356,2006-01-01T00:00:00
ADELAIDE,2006,2,15580,10304,25884,2006-02-01T00:00:00
ADELAIDE,2006,3,14838,13676,28514,2006-03-01T00:00:00
ADELAIDE,2006,4,15941,17566,33507,2006-04-01T00:00:00
ADELAIDE,2006,5,13450,15116,28566,2006-05-01T00:00:00
ADELAIDE,2006,6,14554,15839,30393,2006-06-01T00:00:00
ADELAIDE,2006,7,20973,17547,38520,2006-07-01T00:00:00
ADELAIDE,2006,8,18345,17044,35389,2006-08-01T00:00:00
ADELAIDE,2006,9,18215,16346,34561,2006-09-01T00:00:00
ADELAIDE,2006,10,21877,15822,37699,2006-10-01T00:00:00
ADELAIDE,2006,11,18211,15523,33734,2006-11-01T00:00:00
ADELAIDE,2006,12,20208,22158,42366,2006-12-01T00:00:00
ADELAIDE,2007,1,22042,17928,39970,2007-01-01T00:00:00
ADELAIDE,2007,2,19381,14132,33513,2007-02-01T00:00:00
ADELAIDE,2007,3,20874,18490,39364,2007-03-01T00:00:00
ADELAIDE,2007,4,17956,20398,38354,2007-04-01T00:00:00
ADELAIDE,2007,5,14657,17770,32427,2007-05-01T00:00:00
ADELAIDE,2007,6,17277,18186,35463,2007-06-01T00:00:00
ADELAIDE,2007,7,21235,18685,39920,2007-07-01T00:00:00
ADELAIDE,2007,8,18744,17726,36470,2007-08-01T00:00:00
ADELAIDE,2007,9,18979,18782,37761,2007-09-01T00:00:00
ADELAIDE,2007,10,22764,16099,38863,2007-10-01T00:00:00
ADELAIDE,2007,11,20060,18046,38106,2007-11-01T00:00:00
ADELAIDE,2007,12,20782,24156,44938,2007-12-01T00:00:00
ADELAIDE,2008,1,25056,20073,45129,2008-01-01T00:00:00
ADELAIDE,2008,2,21507,15549,37056,2008-02-01T00:00:00
ADELAIDE,2008,3,21218,19282,40500,2008-03-01T00:00:00
ADELAIDE,2008,4,19019,21367,40386,2008-04-01T00:00:00
ADELAIDE,2008,5,17470,19098,36568,2008-05-01T00:00:00
ADELAIDE,2008,6,17653,17991,35644,2008-06-01T00:00:00
ADELAIDE,2008,7,22705,19301,42006,2008-07-01T00:00:00
ADELAIDE,2008,8,20289,19088,39377,2008-08-01T00:00:00
ADELAIDE,2008,9,20161,19772,39933,2008-09-01T00:00:00
ADELAIDE,2008,10,24131,17330,41461,2008-10-01T00:00:00
ADELAIDE,2008,11,20339,18220,38559,2008-11-01T00:00:00
ADELAIDE,2008,12,19827,23233,43060,2008-12-01T00:00:00
ADELAIDE,2009,1,25145,19968,45113,2009-01-01T00:00:00
ADELAIDE,2009,2,21389,14795,36184,2009-02-01T00:00:00
ADELAIDE,2009,3,19466,18154,37620,2009-03-01T00:00:00
ADELAIDE,2009,4,20087,21353,41440,2009-04-01T00:00:00
ADELAIDE,2009,5,17085,19321,36406,2009-05-01T00:00:00
ADELAIDE,2009,6,17680,19449,37129,2009-06-01T00:00:00
ADELAIDE,2009,7,24152,21200,45352,2009-07-01T00:00:00
ADELAIDE,2009,8,20859,19768,40627,2009-08-01T00:00:00
ADELAIDE,2009,9,22039,22699,44738,2009-09-01T00:00:00
ADELAIDE,2009,10,26544,20496,47040,2009-10-01T00:00:00
ADELAIDE,2009,11,21906,21543,43449,2009-11-01T00:00:00
ADELAIDE,2009,12,21402,24899,46301,2009-12-01T00:00:00
ADELAIDE,2010,1,26569,22236,48805,2010-01-01T00:00:00
ADELAIDE,2010,2,21576,16706,38282,2010-02-01T00:00:00
ADELAIDE,2010,3,22086,20609,42695,2010-03-01T00:00:00
ADELAIDE,2010,4,22393,23027,45420,2010-04-01T00:00:00
ADELAIDE,2010,5,18231,21100,39331,2010-05-01T00:00:00
ADELAIDE,2010,6,19742,21699,41441,2010-06-01T00:00:00
ADELAIDE,2010,7,25332,21846,47178,2010-07-01T00:00:00
ADELAIDE,2010,8,21613,21756,43369,2010-08-01T00:00:00
ADELAIDE,2010,9,23201,22552,45753,2010-09-01T00:00:00
ADELAIDE,2010,10,27111,19830,46941,2010-10-01T00:00:00
ADELAIDE,2010,11,22317,21729,44046,2010-11-01T00:00:00
ADELAIDE,2010,12,23166,25965,49131,2010-12-01T00:00:00
ADELAIDE,2011,1,26556,22938,49494,2011-01-01T00:00:00
ADELAIDE,2011,2,22587,17514,40101,2011-02-01T00:00:00
ADELAIDE,2011,3,21787,21351,43138,2011-03-01T00:00:00
ADELAIDE,2011,4,22983,25799,48782,2011-04-01T00:00:00
ADELAIDE,2011,5,21287,24027,45314,2011-05-01T00:00:00
ADELAIDE,2011,6,21671,22929,44600,2011-06-01T00:00:00
ADELAIDE,2011,7,28138,25253,53391,2011-07-01T00:00:00
ADELAIDE,2011,8,25653,24324,49977,2011-08-01T00:00:00
ADELAIDE,2011,9,25906,25166,51072,2011-09-01T00:00:00
ADELAIDE,2011,10,28930,23095,52025,2011-10-01T00:00:00
ADELAIDE,2011,11,24604,23324,47928,2011-11-01T00:00:00
ADELAIDE,2011,12,26035,31216,57251,2011-12-01T00:00:00
ADELAIDE,2012,1,34486,27251,61737,2012-01-01T00:00:00
ADELAIDE,2012,2,26957,20520,47477,2012-02-01T00:00:00
ADELAIDE,2012,3,25746,25886,51632,2012-03-01T00:00:00
ADELAIDE,2012,4,25399,26317,51716,2012-04-01T00:00:00
ADELAIDE,2012,5,20661,24575,45236,2012-05-01T00:00:00
ADELAIDE,2012,6,23206,26101,49307,2012-06-01T00:00:00
ADELAIDE,2012,7,31466,24802,56268,2012-07-01T00:00:00
ADELAIDE,2012,8,24624,24733,49357,2012-08-01T00:00:00
ADELAIDE,2012,9,27126,27912,55038,2012-09-01T00:00:00
ADELAIDE,2012,10,30722,22970,53692,2012-10-01T00:00:00
ADELAIDE,2012,11,28453,30172,58625,2012-11-01T00:00:00
ADELAIDE,2012,12,31996,37996,69992,2012-12-01T00:00:00
ADELAIDE,2013,1,39912,30336,70248,2013-01-01T00:00:00
ADELAIDE,2013,2,32894,25038,57932,2013-02-01T00:00:00
ADELAIDE,2013,3,30633,30591,61224,2013-03-01T00:00:00
ADELAIDE,2013,4,30059,33507,63566,2013-04-01T00:00:00
ADELAIDE,2013,5,25232,29676,54908,2013-05-01T00:00:00
ADELAIDE,2013,6,27642,30977,58619,2013-06-01T00:00:00
ADELAIDE,2013,7,38906,33858,72764,2013-07-01T00:00:00
ADELAIDE,2013,8,33245,31092,64337,2013-08-01T00:00:00
ADELAIDE,2013,9,34517,35056,69573,2013-09-01T00:00:00
ADELAIDE,2013,10,39954,28567,68521,2013-10-01T00:00:00
ADELAIDE,2013,11,34066,34016,68082,2013-11-01T00:00:00
ADELAIDE,2013,12,39818,49993,89811,2013-12-01T00:00:00
ADELAIDE,2014,1,53530,41795,95325,2014-01-01T00:00:00
ADELAIDE,2014,2,40484,29320,69804,2014-02-01T00:00:00
ADELAIDE,2014,3,35407,35805,71212,2014-03-01T00:00:00
ADELAIDE,2014,4,39176,42911,82087,2014-04-01T00:00:00
ADELAIDE,2014,5,34798,39547,74345,2014-05-01T00:00:00
ADELAIDE,2014,6,35861,44801,80662,2014-06-01T00:00:00
ADELAIDE,2014,7,51507,44103,95610,2014-07-01T00:00:00
ADELAIDE,2014,8,41013,39796,80809,2014-08-01T00:00:00
ADELAIDE,2014,9,39785,40956,80741,2014-09-01T00:00:00
ADELAIDE,2014,10,44279,35206,79485,2014-10-01T00:00:00
ADELAIDE,2014,11,33966,35010,68976,2014-11-01T00:00:00
ADELAIDE,2014,12,38989,49220,88209,2014-12-01T00:00:00
ADELAIDE,2015,1,50816,40325,91141,2015-01-01T00:00:00
ADELAIDE,2015,2,38274,30765,69039,2015-02-01T00:00:00
ADELAIDE,2015,3,34114,36696,70810,2015-03-01T00:00:00
ADELAIDE,2015,4,33223,37246,70469,2015-04-01T00:00:00
ADELAIDE,2015,5,31243,36424,67667,2015-05-01T00:00:00
ADELAIDE,2015,6,32695,37826,70521,2015-06-01T00:00:00
ADELAIDE,2015,7,40295,36893,77188,2015-07-01T00:00:00
ADELAIDE,2015,8,35798,34901,70699,2015-08-01T00:00:00
ADELAIDE,2015,9,35418,35682,71100,2015-09-01T00:00:00
ADELAIDE,2015,10,39982,32407,72389,2015-10-01T00:00:00
ADELAIDE,2015,11,30136,30705,60841,2015-11-01T00:00:00
ADELAIDE,2015,12,36126,43398,79524,2015-12-01T00:00:00
ADELAIDE,2016,1,44890,39537,84427,2016-01-01T00:00:00
ADELAIDE,2016,2,35415,29381,64796,2016-02-01T00:00:00
ADELAIDE,2016,3,32873,33552,66425,2016-03-01T00:00:00
ADELAIDE,2016,4,31541,36181,67722,2016-04-01T00:00:00
ADELAIDE,2016,5,31336,37676,69012,2016-05-01T00:00:00
ADELAIDE,2016,6,33289,39790,73079,2016-06-01T00:00:00
ADELAIDE,2016,7,47258,43425,90683,2016-07-01T00:00:00
ADELAIDE,2016,8,39027,40220,79247,2016-08-01T00:00:00
ADELAIDE,2016,9,42085,41067,83152,2016-09-01T00:00:00
ADELAIDE,2016,10,46341,35408,81749,2016-10-01T00:00:00
ADELAIDE,2016,11,34776,36227,71003,2016-11-01T00:00:00
ADELAIDE,2016,12,41707,51177,92884,2016-12-01T00:00:00
ADELAIDE,2017,1,51344,42933,94277,2017-01-01T00:00:00
ADELAIDE,2017,2,37838,30773,68611,2017-02-01T00:00:00
ADELAIDE,2017,3,34763,36346,71109,2017-03-01T00:00:00
ADELAIDE,2017,4,34119,39693,73812,2017-04-01T00:00:00
ADELAIDE,2017,5,33197,37924,71121,2017-05-01T00:00:00
ADELAIDE,2017,6,34097,39198,73295,2017-06-01T00:00:00
ADELAIDE,2017,7,46589,43123,89712,2017-07-01T00:00:00
ADELAIDE,2017,8,42160,40424,82584,2017-08-01T00:00:00
ADELAIDE,2017,9,44410,42623,87033,2017-09-01T00:00:00
ADELAIDE,2017,10,46426,36194,82620,2017-10-01T00:00:00
ADELAIDE,2017,11,37547,36871,74418,2017-11-01T00:00:00
ADELAIDE,2017,12,42206,52177,94383,2017-12-01T00:00:00
ADELAIDE,2018,1,58412,47172,105584,2018-01-01T00:00:00
ADELAIDE,2018,2,40981,32712,73693,2018-02-01T00:00:00
ADELAIDE,2018,3,37451,40042,77493,2018-03-01T00:00:00
ADELAIDE,2018,4,36246,41703,77949,2018-04-01T00:00:00
ADELAIDE,2018,5,34981,39547,74528,2018-05-01T00:00:00
ADELAIDE,2018,6,34610,43963,78573,2018-06-01T00:00:00
ADELAIDE,2018,7,48394,42872,91266,2018-07-01T00:00:00
ADELAIDE,2018,8,43581,43992,87573,2018-08-01T00:00:00
ADELAIDE,2018,9,45590,43804,89394,2018-09-01T00:00:00
ADELAIDE,2018,10,49784,38321,88105,2018-10-01T00:00:00
ADELAIDE,2018,11,40957,41321,82278,2018-11-01T00:00:00
ADELAIDE,2018,12,44574,54951,99525,2018-12-01T00:00:00
ADELAIDE,2019,1,58221,49255,107476,2019-01-01T00:00:00
ADELAIDE,2019,2,44990,35260,80250,2019-02-01T00:00:00
ADELAIDE,2019,3,38857,39981,78838,2019-03-01T00:00:00
ADELAIDE,2019,4,40996,46294,87290,2019-04-01T00:00:00
ADELAIDE,2019,5,38454,43024,81478,2019-05-01T00:00:00
ADELAIDE,2019,6,40583,47455,88038,2019-06-01T00:00:00
ADELAIDE,2019,7,55934,49299,105233,2019-07-01T00:00:00
ADELAIDE,2019,8,49885,49320,99205,2019-08-01T00:00:00
ADELAIDE,2019,9,53080,51858,104938,2019-09-01T00:00:00
ADELAIDE,2019,10,55867,43338,99205,2019-10-01T00:00:00
ADELAIDE,2019,11,43856,43075,86931,2019-11-01T00:00:00
ADELAIDE,2019,12,48765,60945,109710,2019-12-01T00:00:00
ADELAIDE,2020,1,63966,53541,117507,2020-01-01T00:00:00
ADELAIDE,2020,2,41150,30615,71765,2020-02-01T00:00:00
ADELAIDE,2020,3,23735,18459,42194,2020-03-01T00:00:00
ADELAIDE,2020,4,0,0,0,2020-04-01T00:00:00
ADELAIDE,2020,5,0,0,0,2020-05-01T00:00:00
ADELAIDE,2020,6,26,51,77,2020-06-01T00:00:00
ADELAIDE,2020,7,350,313,663,2020-07-01T00:00:00
ADELAIDE,2020,8,754,661,1415,2020-08-01T00:00:00
ADELAIDE,2020,9,1123,590,1713,2020-09-01T00:00:00
ADELAIDE,2020,10,1509,537,2046,2020-10-01T00:00:00
ADELAIDE,2020,11,959,481,1440,2020-11-01T00:00:00
ADELAIDE,2020,12,1429,710,2139,2020-12-01T00:00:00
ADELAIDE,2021,1,2115,526,2641,2021-01-01T00:00:00
ADELAIDE,2021,2,1919,459,2378,2021-02-01T00:00:00
ADELAIDE,2021,3,2124,413,2537,2021-03-01T00:00:00
ADELAIDE,2021,4,1798,439,2237,2021-04-01T00:00:00
ADELAIDE,2021,5,2823,1464,4287,2021-05-01T00:00:00
ADELAIDE,2021,6,3040,1642,4682,2021-06-01T00:00:00
ADELAIDE,2021,7,2816,2120,4936,2021-07-01T00:00:00
ADELAIDE,2021,8,1063,871,1934,2021-08-01T00:00:00
ADELAIDE,2021,9,1173,681,1854,2021-09-01T00:00:00
ADELAIDE,2021,10,1152,835,1987,2021-10-01T00:00:00
ADELAIDE,2021,11,1180,1299,2479,2021-11-01T00:00:00
ADELAIDE,2021,12,937,2799,3736,2021-12-01T00:00:00
ADELAIDE,2022,1,4211,3718,7929,2022-01-01T00:00:00
ADELAIDE,2022,2,7289,4956,12245,2022-02-01T00:00:00
ADELAIDE,2022,3,7098,8046,15144,2022-03-01T00:00:00
ADELAIDE,2022,4,10306,12112,22418,2022-04-01T00:00:00
ADELAIDE,2022,5,12693,12808,25501,2022-05-01T00:00:00
ADELAIDE,2022,6,13847,17516,31363,2022-06-01T00:00:00
ADELAIDE,2022,7,22259,22240,44499,2022-07-01T00:00:00
ADELAIDE,2022,8,21150,20231,41381,2022-08-01T00:00:00
ADELAIDE,2022,9,23363,22819,46182,2022-09-01T00:00:00
ADELAIDE,2022,10,25603,22827,48430,2022-10-01T00:00:00
ADELAIDE,2022,11,26291,25667,51958,2022-11-01T00:00:00
ADELAIDE,2022,12,28493,34434,62927,2022-12-01T00:00:00
ADELAIDE,2023,1,41237,34113,75350,2023-01-01T00:00:00
ADELAIDE,2023,2,30587,24931,55518,2023-02-01T00:00:00
ADELAIDE,2023,3,33742,30455,64197,2023-03-01T00:00:00
ADELAIDE,2023,4,36738,38284,75022,2023-04-01T00:00:00
ADELAIDE,2023,5,31211,33022,64233,2023-05-01T00:00:00
ADELAIDE,2023,6,31799,35432,67231,2023-06-01T00:00:00
ADELAIDE,2023,7,45312,40896,86208,2023-07-01T00:00:00
ADELAIDE,2023,8,36548,33483,70031,2023-08-01T00:00:00
ADELAIDE,2023,9,39684,37768,77452,2023-09-01T00:00:00
ADELAIDE,2023,10,44490,35907,80397,2023-10-01T00:00:00
ADELAIDE,2023,11,36152,34700,70852,2023-11-01T00:00:00
ADELAIDE,2023,12,41665,52958,94623,2023-12-01T00:00:00
ADELAIDE,2024,1,59785,42023,101808,2024-01-01T00:00:00
ADELAIDE,2024,2,37176,29696,66872,2024-02-01T00:00:00
ADELAIDE,2024,3,33433,35570,69003,2024-03-01T00:00:00
ADELAIDE,2024,4,40476,41307,81783,2024-04-01T00:00:00
ADELAIDE,2024,5,35227,37267,72494,2024-05-01T00:00:00
ADELAIDE,2024,6,37588,42099,79687,2024-06-01T00:00:00
ADELAIDE,2024,7,47983,43207,91190,2024-07-01T00:00:00
ADELAIDE,2024,8,36769,36542,73311,2024-08-01T00:00:00
ADELAIDE,2024,9,36630,36812,73442,2024-09-01T00:00:00
ADELAIDE,2024,10,40835,35579,76414,2024-10-01T00:00:00
ADELAIDE,2024,11,40857,41848,82705,2024-11-01T00:00:00
ADELAIDE,2024,12,44204,51530,95734,2024-12-01T00:00:00
ADELAIDE,2025,1,57473,49001,106474,2025-01-01T00:00:00
ADELAIDE,2025,2,43742,35612,79354,2025-02-01T00:00:00
ADELAIDE,2025,3,38869,39156,78025,2025-03-01T00:00:00
ADELAIDE,2025,4,42042,48663,90705,2025-04-01T00:00:00
ADELAIDE,2025,5,44413,46353,90766,2025-05-01T00:00:00
ADELAIDE,2025,6,42945,48625,91570,2025-06-01T00:00:00
ALICE SPRINGS,1985,1,0,0,0,1985-01-01T00:00:00
ALICE SPRINGS,1985,2,0,0,0,1985-02-01T00:00:00
ALICE SPRINGS,1985,3,0,0,0,1985-03-01T00:00:00
ALICE SPRINGS,1985,4,0,0,0,1985-04-01T00:00:00
ALICE SPRINGS,1985,5,0,0,0,1985-05-01T00:00:00
ALICE SPRINGS,1985,6,0,0,0,1985-06-01T00:00:00
ALICE SPRINGS,1985,7,0,0,0,1985-07-01T00:00:00
ALICE SPRINGS,1985,8,0,0,0,1985-08-01T00:00:00
ALICE SPRINGS,1985,9,0,0,0,1985-09-01T00:00:00
ALICE SPRINGS,1985,10,0,0,0,1985-10-01T00:00:00
ALICE SPRINGS,1985,11,0,0,0,1985-11-01T00:00:00
ALICE SPRINGS,1985,12,0,0,0,1985-12-01T00:00:00
ALICE SPRINGS,1986,1,0,0,0,1986-01-01T00:00:00
ALICE SPRINGS,1986,2,0,0,0,1986-02-01T00:00:00
ALICE SPRINGS,1986,3,0,0,0,1986-03-01T00:00:00
ALICE SPRINGS,1986,4,0,0,0,1986-04-01T00:00:00
ALICE SPRINGS,1986,5,0,0,0,1986-05-01T00:00:00
ALICE SPRINGS,1986,6,0,0,0,1986-06-01T00:00:00
ALICE SPRINGS,1986,7,0,0,0,1986-07-01T00:00:00
ALICE SPRINGS,1986,8,0,0,0,1986-08-01T00:00:00
ALICE SPRINGS,1986,9,0,0,0,1986-09-01T00:00:00
ALICE SPRINGS,1986,10,0,0,0,1986-10-01T00:00:00
ALICE SPRINGS,1986,11,0,0,0,1986-11-01T00:00:00
ALICE SPRINGS,1986,12,0,0,0,1986-12-01T00:00:00
ALICE SPRINGS,1987,1,0,0,0,1987-01-01T00:00:00
ALICE SPRINGS,1987,2,0,0,0,1987-02-01T00:00:00
ALICE SPRINGS,1987,3,0,0,0,1987-03-01T00:00:00
ALICE SPRINGS,1987,4,0,0,0,1987-04-01T00:00:00
ALICE SPRINGS,1987,5,0,0,0,1987-05-01T00:00:00
ALICE SPRINGS,1987,6,0,0,0,1987-06-01T00:00:00
ALICE SPRINGS,1987,7,0,0,0,1987-07-01T00:00:00
ALICE SPRINGS,1987,8,0,0,0,1987-08-01T00:00:00
ALICE SPRINGS,1987,9,0,0,0,1987-09-01T00:00:00
ALICE SPRINGS,1987,10,0,0,0,1987-10-01T00:00:00
ALICE SPRINGS,1987,11,0,0,0,1987-11-01T00:00:00
ALICE SPRINGS,1987,12,0,0,0,1987-12-01T00:00:00
ALICE SPRINGS,1988,1,0,0,0,1988-01-01T00:00:00
ALICE SPRINGS,1988,2,0,0,0,1988-02-01T00:00:00
ALICE SPRINGS,1988,3,0,0,0,1988-03-01T00:00:00
ALICE SPRINGS,1988,4,0,0,0,1988-04-01T00:00:00
ALICE SPRINGS,1988,5,0,0,0,1988-05-01T00:00:00
ALICE SPRINGS,1988,6,0,0,0,1988-06-01T00:00:00
ALICE SPRINGS,1988,7,0,0,0,1988-07-01T00:00:00
ALICE SPRINGS,1988,8,0,0,0,1988-08-01T00:00:00
ALICE SPRINGS,1988,9,0,0,0,1988-09-01T00:00:00
ALICE SPRINGS,1988,10,0,0,0,1988-10-01T00:00:00
ALICE SPRINGS,1988,11,0,0,0,1988-11-01T00:00:00
ALICE SPRINGS,1988,12,0,0,0,1988-12-01T00:00:00
ALICE SPRINGS,1989,1,0,0,0,1989-01-01T00:00:00
ALICE SPRINGS,1989,2,0,0,0,1989-02-01T00:00:00
ALICE SPRINGS,1989,3,0,0,0,1989-03-01T00:00:00
ALICE SPRINGS,1989,4,0,0,0,1989-04-01T00:00:00
ALICE SPRINGS,1989,5,0,0,0,1989-05-01T00:00:00
ALICE SPRINGS,1989,6,0,0,0,1989-06-01T00:00:00
ALICE SPRINGS,1989,7,0,0,0,1989-07-01T00:00:00
ALICE SPRINGS,1989,8,0,0,0,1989-08-01T00:00:00
ALICE SPRINGS,1989,9,0,0,0,1989-09-01T00:00:00
ALICE SPRINGS,1989,10,0,0,0,1989-10-01T00:00:00
ALICE SPRINGS,1989,11,0,0,0,1989-11-01T00:00:00
ALICE SPRINGS,1989,12,0,0,0,1989-12-01T00:00:00
ALICE SPRINGS,1990,1,0,0,0,1990-01-01T00:00:00
ALICE SPRINGS,1990,2,0,0,0,1990-02-01T00:00:00
ALICE SPRINGS,1990,3,0,0,0,1990-03-01T00:00:00
ALICE SPRINGS,1990,4,0,0,0,1990-04-01T00:00:00
ALICE SPRINGS,1990,5,0,0,0,1990-05-01T00:00:00
ALICE SPRINGS,1990,6,0,0,0,1990-06-01T00:00:00
ALICE SPRINGS,1990,7,0,0,0,1990-07-01T00:00:00
ALICE SPRINGS,1990,8,0,0,0,1990-08-01T00:00:00
ALICE SPRINGS,1990,9,0,0,0,1990-09-01T00:00:00
ALICE SPRINGS,1990,10,0,0,0,1990-10-01T00:00:00
ALICE SPRINGS,1990,11,0,0,0,1990-11-01T00:00:00
ALICE SPRINGS,1990,12,0,0,0,1990-12-01T00:00:00
ALICE SPRINGS,1991,1,0,0,0,1991-01-01T00:00:00
ALICE SPRINGS,1991,2,0,0,0,1991-02-01T00:00:00
ALICE SPRINGS,1991,3,0,0,0,1991-03-01T00:00:00
ALICE SPRINGS,1991,4,0,0,0,1991-04-01T00:00:00
ALICE SPRINGS,1991,5,0,0,0,1991-05-01T00:00:00
ALICE SPRINGS,1991,6,0,0,0,1991-06-01T00:00:00
ALICE SPRINGS,1991,7,0,0,0,1991-07-01T00:00:00
ALICE SPRINGS,1991,8,0,0,0,1991-08-01T00:00:00
ALICE SPRINGS,1991,9,0,0,0,1991-09-01T00:00:00
ALICE SPRINGS,1991,10,0,0,0,1991-10-01T00:00:00
ALICE SPRINGS,1991,11,0,0,0,1991-11-01T00:00:00
ALICE SPRINGS,1991,12,0,0,0,1991-12-01T00:00:00
ALICE SPRINGS,1992,1,0,0,0,1992-01-01T00:00:00
ALICE SPRINGS,1992,2,0,0,0,1992-02-01T00:00:00
ALICE SPRINGS,1992,3,0,0,0,1992-03-01T00:00:00
ALICE SPRINGS,1992,4,0,0,0,1992-04-01T00:00:00
ALICE SPRINGS,1992,5,0,0,0,1992-05-01T00:00:00
ALICE SPRINGS,1992,6,0,0,0,1992-06-01T00:00:00
ALICE SPRINGS,1992,7,0,0,0,1992-07-01T00:00:00
ALICE SPRINGS,1992,8,0,0,0,1992-08-01T00:00:00
ALICE SPRINGS,1992,9,0,0,0,1992-09-01T00:00:00
ALICE SPRINGS,1992,10,0,0,0,1992-10-01T00:00:00
ALICE SPRINGS,1992,11,0,0,0,1992-11-01T00:00:00
ALICE SPRINGS,1992,12,0,0,0,1992-12-01T00:00:00
ALICE SPRINGS,1993,1,0,0,0,1993-01-01T00:00:00
ALICE SPRINGS,1993,2,0,0,0,1993-02-01T00:00:00
ALICE SPRINGS,1993,3,0,0,0,1993-03-01T00:00:00
ALICE SPRINGS,1993,4,0,0,0,1993-04-01T00:00:00
ALICE SPRINGS,1993,5,0,0,0,1993-05-01T00:00:00
ALICE SPRINGS,1993,6,0,0,0,1993-06-01T00:00:00
ALICE SPRINGS,1993,7,0,0,0,1993-07-01T00:00:00
ALICE SPRINGS,1993,8,0,0,0,1993-08-01T00:00:00
ALICE SPRINGS,1993,9,0,0,0,1993-09-01T00:00:00
ALICE SPRINGS,1993,10,0,0,0,1993-10-01T00:00:00
ALICE SPRINGS,1993,11,0,0,0,1993-11-01T00:00:00
ALICE SPRINGS,1993,12,0,0,0,1993-12-01T00:00:00
ALICE SPRINGS,1994,1,0,0,0,1994-01-01T00:00:00
ALICE SPRINGS,1994,2,0,0,0,1994-02-01T00:00:00
ALICE SPRINGS,1994,3,0,0,0,1994-03-01T00:00:00
ALICE SPRINGS,1994,4,0,0,0,1994-04-01T00:00:00
ALICE SPRINGS,1994,5,0,0,0,1994-05-01T00:00:00
ALICE SPRINGS,1994,6,0,0,0,1994-06-01T00:00:00
ALICE SPRINGS,1994,7,0,0,0,1994-07-01T00:00:00
ALICE SPRINGS,1994,8,0,0,0,1994-08-01T00:00:00
ALICE SPRINGS,1994,9,0,0,0,1994-09-01T00:00:00
ALICE SPRINGS,1994,10,0,0,0,1994-10-01T00:00:00
ALICE SPRINGS,1994,11,0,0,0,1994-11-01T00:00:00
ALICE SPRINGS,1994,12,0,0,0,1994-12-01T00:00:00
ALICE SPRINGS,1995,1,0,0,0,1995-01-01T00:00:00
ALICE SPRINGS,1995,2,0,0,0,1995-02-01T00:00:00
ALICE SPRINGS,1995,3,0,0,0,1995-03-01T00:00:00
ALICE SPRINGS,1995,4,0,0,0,1995-04-01T00:00:00
ALICE SPRINGS,1995,5,0,0,0,1995-05-01T00:00:00
ALICE SPRINGS,1995,6,0,0,0,1995-06-01T00:00:00
ALICE SPRINGS,1995,7,0,0,0,1995-07-01T00:00:00
ALICE SPRINGS,1995,8,0,0,0,1995-08-01T00:00:00
ALICE SPRINGS,1995,9,0,0,0,1995-09-01T00:00:00
ALICE SPRINGS,1995,10,0,0,0,1995-10-01T00:00:00
ALICE SPRINGS,1995,11,0,0,0,1995-11-01T00:00:00
ALICE SPRINGS,1995,12,0,0,0,1995-12-01T00:00:00
ALICE SPRINGS,1996,1,0,0,0,1996-01-01T00:00:00
ALICE SPRINGS,1996,2,0,0,0,1996-02-01T00:00:00
ALICE SPRINGS,1996,3,0,0,0,1996-03-01T00:00:00
ALICE SPRINGS,1996,4,0,0,0,1996-04-01T00:00:00
ALICE SPRINGS,1996,5,0,0,0,1996-05-01T00:00:00
ALICE SPRINGS,1996,6,0,0,0,1996-06-01T00:00:00
ALICE SPRINGS,1996,7,0,0,0,1996-07-01T00:00:00
ALICE SPRINGS,1996,8,0,0,0,1996-08-01T00:00:00
ALICE SPRINGS,1996,9,0,0,0,1996-09-01T00:00:00
ALICE SPRINGS,1996,10,0,0,0,1996-10-01T00:00:00
ALICE SPRINGS,1996,11,0,0,0,1996-11-01T00:00:00
ALICE SPRINGS,1996,12,0,0,0,1996-12-01T00:00:00
ALICE SPRINGS,1997,1,0,0,0,1997-01-01T00:00:00
ALICE SPRINGS,1997,2,0,0,0,1997-02-01T00:00:00
ALICE SPRINGS,1997,3,0,0,0,1997-03-01T00:00:00
ALICE SPRINGS,1997,4,0,0,0,1997-04-01T00:00:00
ALICE SPRINGS,1997,5,0,0,0,1997-05-01T00:00:00
ALICE SPRINGS,1997,6,0,0,0,1997-06-01T00:00:00
ALICE SPRINGS,1997,7,0,0,0,1997-07-01T00:00:00
ALICE SPRINGS,1997,8,0,0,0,1997-08-01T00:00:00
ALICE SPRINGS,1997,9,0,0,0,1997-09-01T00:00:00
ALICE SPRINGS,1997,10,0,0,0,1997-10-01T00:00:00
ALICE SPRINGS,1997,11,0,0,0,1997-11-01T00:00:00
ALICE SPRINGS,1997,12,0,0,0,1997-12-01T00:00:00
ALICE SPRINGS,1998,1,0,0,0,1998-01-01T00:00:00
ALICE SPRINGS,1998,2,0,0,0,1998-02-01T00:00:00
ALICE SPRINGS,1998,3,0,0,0,1998-03-01T00:00:00
ALICE SPRINGS,1998,4,0,0,0,1998-04-01T00:00:00
ALICE SPRINGS,1998,5,0,0,0,1998-05-01T00:00:00
ALICE SPRINGS,1998,6,0,0,0,1998-06-01T00:00:00
ALICE SPRINGS,1998,7,0,0,0,1998-07-01T00:00:00
ALICE SPRINGS,1998,8,0,0,0,1998-08-01T00:00:00
ALICE SPRINGS,1998,9,0,0,0,1998-09-01T00:00:00
ALICE SPRINGS,1998,10,0,0,0,1998-10-01T00:00:00
ALICE SPRINGS,1998,11,0,0,0,1998-11-01T00:00:00
ALICE SPRINGS,1998,12,0,0,0,1998-12-01T00:00:00
ALICE SPRINGS,1999,1,0,0,0,1999-01-01T00:00:00
ALICE SPRINGS,1999,2,0,0,0,1999-02-01T00:00:00
ALICE SPRINGS,1999,3,0,0,0,1999-03-01T00:00:00
ALICE SPRINGS,1999,4,0,0,0,1999-04-01T00:00:00
ALICE SPRINGS,1999,5,0,0,0,1999-05-01T00:00:00
ALICE SPRINGS,1999,6,0,0,0,1999-06-01T00:00:00
ALICE SPRINGS,1999,7,0,0,0,1999-07-01T00:00:00
ALICE SPRINGS,1999,8,0,0,0,1999-08-01T00:00:00
ALICE SPRINGS,1999,9,0,0,0,1999-09-01T00:00:00
ALICE SPRINGS,1999,10,0,0,0,1999-10-01T00:00:00
ALICE SPRINGS,1999,11,0,0,0,1999-11-01T00:00:00
ALICE SPRINGS,1999,12,0,0,0,1999-12-01T00:00:00
ALICE SPRINGS,2000,1,0,0,0,2000-01-01T00:00:00
ALICE SPRINGS,2000,2,0,0,0,2000-02-01T00:00:00
ALICE SPRINGS,2000,3,0,0,0,2000-03-01T00:00:00
ALICE SPRINGS,2000,4,0,0,0,2000-04-01T00:00:00
ALICE SPRINGS,2000,5,0,0,0,2000-05-01T00:00:00
ALICE SPRINGS,2000,6,0,0,0,2000-06-01T00:00:00
ALICE SPRINGS,2000,7,0,0,0,2000-07-01T00:00:00
ALICE SPRINGS,2000,8,0,0,0,2000-08-01T00:00:00
ALICE SPRINGS,2000,9,0,0,0,2000-09-01T00:00:00
ALICE SPRINGS,2000,10,0,0,0,2000-10-01T00:00:00
ALICE SPRINGS,2000,11,0,0,0,2000-11-01T00:00:00
ALICE SPRINGS,2000,12,0,0,0,2000-12-01T00:00:00
ALICE SPRINGS,2001,1,0,0,0,2001-01-01T00:00:00
ALICE SPRINGS,2001,2,0,0,0,2001-02-01T00:00:00
ALICE SPRINGS,2001,3,0,0,0,2001-03-01T00:00:00
ALICE SPRINGS,2001,4,0,0,0,2001-04-01T00:00:00
ALICE SPRINGS,2001,5,0,0,0,2001-05-01T00:00:00
ALICE SPRINGS,2001,6,0,0,0,2001-06-01T00:00:00
ALICE SPRINGS,2001,7,0,0,0,2001-07-01T00:00:00
ALICE SPRINGS,2001,8,0,0,0,2001-08-01T00:00:00
ALICE SPRINGS,2001,9,0,0,0,2001-09-01T00:00:00
ALICE SPRINGS,2001,10,0,0,0,2001-10-01T00:00:00
ALICE SPRINGS,2001,11,0,0,0,2001-11-01T00:00:00
ALICE SPRINGS,2001,12,0,0,0,2001-12-01T00:00:00
ALICE SPRINGS,2002,1,0,0,0,2002-01-01T00:00:00
ALICE SPRINGS,2002,2,0,0,0,2002-02-01T00:00:00
ALICE SPRINGS,2002,3,0,0,0,2002-03-01T00:00:00
ALICE SPRINGS,2002,4,0,0,0,2002-04-01T00:00:00
ALICE SPRINGS,2002,5,0,0,0,2002-05-01T00:00:00
ALICE SPRINGS,2002,6,0,0,0,2002-06-01T00:00:00
ALICE SPRINGS,2002,7,0,0,0,2002-07-01T00:00:00
ALICE SPRINGS,2002,8,0,0,0,2002-08-01T00:00:00
ALICE SPRINGS,2002,9,0,0,0,2002-09-01T00:00:00
ALICE SPRINGS,2002,10,0,0,0,2002-10-01T00:00:00
ALICE SPRINGS,2002,11,0,0,0,2002-11-01T00:00:00
ALICE SPRINGS,2002,12,0,0,0,2002-12-01T00:00:00
ALICE SPRINGS,2003,1,0,0,0,2003-01-01T00:00:00
ALICE SPRINGS,2003,2,0,0,0,2003-02-01T00:00:00
ALICE SPRINGS,2003,3,0,0,0,2003-03-01T00:00:00
ALICE SPRINGS,2003,4,0,0,0,2003-04-01T00:00:00
ALICE SPRINGS,2003,5,0,0,0,2003-05-01T00:00:00
ALICE SPRINGS,2003,6,0,0,0,2003-06-01T00:00:00
ALICE SPRINGS,2003,7,0,0,0,2003-07-01T00:00:00
ALICE SPRINGS,2003,8,0,0,0,2003-08-01T00:00:00
ALICE SPRINGS,2003,9,0,0,0,2003-09-01T00:00:00
ALICE SPRINGS,2003,10,0,0,0,2003-10-01T00:00:00
ALICE SPRINGS,2003,11,0,0,0,2003-11-01T00:00:00
ALICE SPRINGS,2003,12,0,0,0,2003-12-01T00:00:00
ALICE SPRINGS,2004,1,0,0,0,2004-01-01T00:00:00
ALICE SPRINGS,2004,2,0,0,0,2004-02-01T00:00:00
ALICE SPRINGS,2004,3,0,0,0,2004-03-01T00:00:00
ALICE SPRINGS,2004,4,0,0,0,2004-04-01T00:00:00
ALICE SPRINGS,2004,5,0,0,0,2004-05-01T00:00:00
ALICE SPRINGS,2004,6,0,0,0,2004-06-01T00:00:00
ALICE SPRINGS,2004,7,0,0,0,2004-07-01T00:00:00
ALICE SPRINGS,2004,8,0,0,0,2004-08-01T00:00:00
ALICE SPRINGS,2004,9,0,0,0,2004-09-01T00:00:00
ALICE SPRINGS,2004,10,0,0,0,2004-10-01T00:00:00
ALICE SPRINGS,2004,11,0,0,0,2004-11-01T00:00:00
ALICE SPRINGS,2004,12,0,0,0,2004-12-01T00:00:00
ALICE SPRINGS,2005,1,0,0,0,2005-01-01T00:00:00
ALICE SPRINGS,2005,2,0,0,0,2005-02-01T00:00:00
ALICE SPRINGS,2005,3,0,0,0,2005-03-01T00:00:00
ALICE SPRINGS,2005,4,0,0,0,2005-04-01T00:00:00
ALICE SPRINGS,2005,5,0,0,0,2005-05-01T00:00:00
ALICE SPRINGS,2005,6,0,0,0,2005-06-01T00:00:00
ALICE SPRINGS,2005,7,0,0,0,2005-07-01T00:00:00
ALICE SPRINGS,2005,8,0,0,0,2005-08-01T00:00:00
ALICE SPRINGS,2005,9,0,0,0,2005-09-01T00:00:00
ALICE SPRINGS,2005,10,0,0,0,2005-10-01T00:00:00
ALICE SPRINGS,2005,11,0,0,0,2005-11-01T00:00:00
ALICE SPRINGS,2005,12,0,0,0,2005-12-01T00:00:00
ALICE SPRINGS,2006,1,0,0,0,2006-01-01T00:00:00
ALICE SPRINGS,2006,2,0,0,0,2006-02-01T00:00:00
ALICE SPRINGS,2006,3,0,0,0,2006-03-01T00:00:00
ALICE SPRINGS,2006,4,0,0,0,2006-04-01T00:00:00
ALICE SPRINGS,2006,5,0,0,0,2006-05-01T00:00:00
ALICE SPRINGS,2006,6,0,0,0,2006-06-01T00:00:00
ALICE SPRINGS,2006,7,0,0,0,2006-07-01T00:00:00
ALICE SPRINGS,2006,8,0,0,0,2006-08-01T00:00:00
ALICE SPRINGS,2006,9,0,0,0,2006-09-01T00:00:00
ALICE SPRINGS,2006,10,0,0,0,2006-10-01T00:00:00
ALICE SPRINGS,2006,11,0,0,0,2006-11-01T00:00:00
ALICE SPRINGS,2006,12,0,0,0,2006-12-01T00:00:00
ALICE SPRINGS,2007,1,0,0,0,2007-01-01T00:00:00
ALICE SPRINGS,2007,2,0,0,0,2007-02-01T00:00:00
ALICE SPRINGS,2007,3,0,0,0,2007-03-01T00:00:00
ALICE SPRINGS,2007,4,0,0,0,2007-04-01T00:00:00
ALICE SPRINGS,2007,5,0,0,0,2007-05-01T00:00:00
ALICE SPRINGS,2007,6,0,0,0,2007-06-01T00:00:00
ALICE SPRINGS,2007,7,0,0,0,2007-07-01T00:00:00
ALICE SPRINGS,2007,8,0,0,0,2007-08-01T00:00:00
ALICE SPRINGS,2007,9,0,0,0,2007-09-01T00:00:00
ALICE SPRINGS,2007,10,0,0,0,2007-10-01T00:00:00
ALICE SPRINGS,2007,11,0,0,0,2007-11-01T00:00:00
ALICE SPRINGS,2007,12,0,0,0,2007-12-01T00:00:00
ALICE SPRINGS,2008,1,0,0,0,2008-01-01T00:00:00
ALICE SPRINGS,2008,2,0,0,0,2008-02-01T00:00:00
ALICE SPRINGS,2008,3,0,0,0,2008-03-01T00:00:00
ALICE SPRINGS,2008,4,0,0,0,2008-04-01T00:00:00
ALICE SPRINGS,2008,5,0,0,0,2008-05-01T00:00:00
ALICE SPRINGS,2008,6,0,0,0,2008-06-01T00:00:00
ALICE SPRINGS,2008,7,0,0,0,2008-07-01T00:00:00
ALICE SPRINGS,2008,8,0,0,0,2008-08-01T00:00:00
ALICE SPRINGS,2008,9,0,0,0,2008-09-01T00:00:00
ALICE SPRINGS,2008,10,0,0,0,2008-10-01T00:00:00
ALICE SPRINGS,2008,11,0,0,0,2008-11-01T00:00:00
ALICE SPRINGS,2008,12,0,0,0,2008-12-01T00:00:00
BALLINA,1985,1,0,0,0,1985-01-01T00:00:00
BALLINA,1985,2,0,0,0,1985-02-01T00:00:00
BALLINA,1985,3,0,0,0,1985-03-01T00:00:00
BALLINA,1985,4,0,0,0,1985-04-01T00:00:00
BALLINA,1985,5,0,0,0,1985-05-01T00:00:00
BALLINA,1985,6,0,0,0,1985-06-01T00:00:00
BALLINA,1985,7,0,0,0,1985-07-01T00:00:00
BALLINA,1985,8,0,0,0,1985-08-01T00:00:00
BALLINA,1985,9,0,0,0,1985-09-01T00:00:00
BALLINA,1985,10,0,0,0,1985-10-01T00:00:00
BALLINA,1985,11,0,0,0,1985-11-01T00:00:00
BALLINA,1985,12,0,0,0,1985-12-01T00:00:00
BALLINA,1986,1,0,0,0,1986-01-01T00:00:00
BALLINA,1986,2,0,0,0,1986-02-01T00:00:00
BALLINA,1986,3,0,0,0,1986-03-01T00:00:00
BALLINA,1986,4,0,0,0,1986-04-01T00:00:00
BALLINA,1986,5,0,0,0,1986-05-01T00:00:00
BALLINA,1986,6,0,0,0,1986-06-01T00:00:00
BALLINA,1986,7,0,0,0,1986-07-01T00:00:00
BALLINA,1986,8,0,0,0,1986-08-01T00:00:00
BALLINA,1986,9,0,0,0,1986-09-01T00:00:00
BALLINA,1986,10,0,0,0,1986-10-01T00:00:00
BALLINA,1986,11,0,0,0,1986-11-01T00:00:00
BALLINA,1986,12,0,0,0,1986-12-01T00:00:00
BALLINA,1987,1,0,0,0,1987-01-01T00:00:00
BALLINA,1987,2,0,0,0,1987-02-01T00:00:00
BALLINA,1987,3,0,0,0,1987-03-01T00:00:00
BALLINA,1987,4,0,0,0,1987-04-01T00:00:00
BALLINA,1987,5,0,0,0,1987-05-01T00:00:00
BALLINA,1987,6,0,0,0,1987-06-01T00:00:00
BALLINA,1987,7,0,0,0,1987-07-01T00:00:00
BALLINA,1987,8,0,0,0,1987-08-01T00:00:00
BALLINA,1987,9,0,0,0,1987-09-01T00:00:00
BALLINA,1987,10,0,0,0,1987-10-01T00:00:00
BALLINA,1987,11,0,0,0,1987-11-01T00:00:00
BALLINA,1987,12,0,0,0,1987-12-01T00:00:00
BALLINA,1988,1,0,0,0,1988-01-01T00:00:00
BALLINA,1988,2,0,0,0,1988-02-01T00:00:00
BALLINA,1988,3,0,0,0,1988-03-01T00:00:00
BALLINA,1988,4,0,0,0,1988-04-01T00:00:00
BALLINA,1988,5,0,0,0,1988-05-01T00:00:00
BALLINA,1988,6,0,0,0,1988-06-01T00:00:00
BALLINA,1988,7,0,0,0,1988-07-01T00:00:00
BALLINA,1988,8,0,0,0,1988-08-01T00:00:00
BALLINA,1988,9,0,0,0,1988-09-01T00:00:00
BALLINA,1988,10,0,0,0,1988-10-01T00:00:00
BALLINA,1988,11,0,0,0,1988-11-01T00:00:00
BALLINA,1988,12,0,0,0,1988-12-01T00:00:00
BALLINA,1989,1,0,0,0,1989-01-01T00:00:00
BALLINA,1989,2,0,0,0,1989-02-01T00:00:00
BALLINA,1989,3,0,0,0,1989-03-01T00:00:00
BALLINA,1989,4,0,0,0,1989-04-01T00:00:00
BALLINA,1989,5,0,0,0,1989-05-01T00:00:00
BALLINA,1989,6,0,0,0,1989-06-01T00:00:00
BALLINA,1989,7,0,0,0,1989-07-01T00:00:00
BALLINA,1989,8,0,0,0,1989-08-01T00:00:00
BALLINA,1989,9,0,0,0,1989-09-01T00:00:00
BALLINA,1989,10,0,0,0,1989-10-01T00:00:00
BALLINA,1989,11,0,0,0,1989-11-01T00:00:00
BALLINA,1989,12,0,0,0,1989-12-01T00:00:00
BALLINA,1990,1,0,0,0,1990-01-01T00:00:00
BALLINA,1990,2,0,0,0,1990-02-01T00:00:00
BALLINA,1990,3,0,0,0,1990-03-01T00:00:00
BALLINA,1990,4,0,0,0,1990-04-01T00:00:00
BALLINA,1990,5,0,0,0,1990-05-01T00:00:00
BALLINA,1990,6,0,0,0,1990-06-01T00:00:00
BALLINA,1990,7,0,0,0,1990-07-01T00:00:00
BALLINA,1990,8,0,0,0,1990-08-01T00:00:00
BALLINA,1990,9,0,0,0,1990-09-01T00:00:00
BALLINA,1990,10,0,0,0,1990-10-01T00:00:00
BALLINA,1990,11,0,0,0,1990-11-01T00:00:00
BALLINA,1990,12,0,0,0,1990-12-01T00:00:00
BALLINA,1991,1,0,0,0,1991-01-01T00:00:00
BALLINA,1991,2,0,0,0,1991-02-01T00:00:00
BALLINA,1991,3,0,0,0,1991-03-01T00:00:00
BALLINA,1991,4,0,0,0,1991-04-01T00:00:00
BALLINA,1991,5,0,0,0,1991-05-01T00:00:00
BALLINA,1991,6,0,0,0,1991-06-01T00:00:00
BALLINA,1991,7,0,0,0,1991-07-01T00:00:00
BALLINA,1991,8,0,0,0,1991-08-01T00:00:00
BALLINA,1991,9,0,0,0,1991-09-01T00:00:00
BALLINA,1991,10,0,0,0,1991-10-01T00:00:00
BALLINA,1991,11,0,0,0,1991-11-01T00:00:00
BALLINA,1991,12,0,0,0,1991-12-01T00:00:00
BALLINA,1992,1,0,0,0,1992-01-01T00:00:00
BALLINA,1992,2,0,0,0,1992-02-01T00:00:00
BALLINA,1992,3,0,0,0,1992-03-01T00:00:00
BALLINA,1992,4,0,0,0,1992-04-01T00:00:00
BALLINA,1992,5,0,0,0,1992-05-01T00:00:00
BALLINA,1992,6,0,0,0,1992-06-01T00:00:00
BALLINA,1992,7,0,0,0,1992-07-01T00:00:00
BALLINA,1992,8,0,0,0,1992-08-01T00:00:00
BALLINA,1992,9,0,0,0,1992-09-01T00:00:00
BALLINA,1992,10,0,0,0,1992-10-01T00:00:00
BALLINA,1992,11,0,0,0,1992-11-01T00:00:00
BALLINA,1992,12,0,0,0,1992-12-01T00:00:00
BALLINA,1993,1,0,0,0,1993-01-01T00:00:00
BALLINA,1993,2,0,0,0,1993-02-01T00:00:00
BALLINA,1993,3,0,0,0,1993-03-01T00:00:00
BALLINA,1993,4,0,0,0,1993-04-01T00:00:00
BALLINA,1993,5,0,0,0,1993-05-01T00:00:00
BALLINA,1993,6,0,0,0,1993-06-01T00:00:00
BALLINA,1993,7,0,0,0,1993-07-01T00:00:00
BALLINA,1993,8,0,0,0,1993-08-01T00:00:00
BALLINA,1993,9,0,0,0,1993-09-01T00:00:00
BALLINA,1993,10,0,0,0,1993-10-01T00:00:00
BALLINA,1993,11,0,0,0,1993-11-01T00:00:00
BALLINA,1993,12,0,0,0,1993-12-01T00:00:00
BALLINA,1994,1,0,0,0,1994-01-01T00:00:00
BALLINA,1994,2,0,0,0,1994-02-01T00:00:00
BALLINA,1994,3,0,0,0,1994-03-01T00:00:00
BALLINA,1994,4,0,0,0,1994-04-01T00:00:00
BALLINA,1994,5,0,0,0,1994-05-01T00:00:00
BALLINA,1994,6,0,0,0,1994-06-01T00:00:00
BALLINA,1994,7,0,0,0,1994-07-01T00:00:00
BALLINA,1994,8,0,0,0,1994-08-01T00:00:00
BALLINA,1994,9,0,0,0,1994-09-01T00:00:00
BALLINA,1994,10,0,0,0,1994-10-01T00:00:00
BALLINA,1994,11,0,0,0,1994-11-01T00:00:00
BALLINA,1994,12,0,0,0,1994-12-01T00:00:00
BALLINA,1995,1,0,0,0,1995-01-01T00:00:00
BALLINA,1995,2,0,0,0,1995-02-01T00:00:00
BALLINA,1995,3,0,0,0,1995-03-01T00:00:00
BALLINA,1995,4,0,0,0,1995-04-01T00:00:00
BALLINA,1995,5,0,0,0,1995-05-01T00:00:00
BALLINA,1995,6,0,0,0,1995-06-01T00:00:00
BALLINA,1995,7,0,0,0,1995-07-01T00:00:00
BALLINA,1995,8,0,0,0,1995-08-01T00:00:00
BALLINA,1995,9,0,0,0,1995-09-01T00:00:00
BALLINA,1995,10,0,0,0,1995-10-01T00:00:00
BALLINA,1995,11,0,0,0,1995-11-01T00:00:00
BALLINA,1995,12,0,0,0,1995-12-01T00:00:00
BALLINA,1996,1,0,0,0,1996-01-01T00:00:00
BALLINA,1996,2,0,0,0,1996-02-01T00:00:00
BALLINA,1996,3,0,0,0,1996-03-01T00:00:00
BALLINA,1996,4,0,0,0,1996-04-01T00:00:00
BALLINA,1996,5,0,0,0,1996-05-01T00:00:00
BALLINA,1996,6,0,0,0,1996-06-01T00:00:00
BALLINA,1996,7,0,0,0,1996-07-01T00:00:00
BALLINA,1996,8,0,0,0,1996-08-01T00:00:00
BALLINA,1996,9,0,0,0,1996-09-01T00:00:00
BALLINA,1996,10,0,0,0,1996-10-01T00:00:00
BALLINA,1996,11,0,0,0,1996-11-01T00:00:00
BALLINA,1996,12,0,0,0,1996-12-01T00:00:00
BALLINA,1997,1,0,0,0,1997-01-01T00:00:00
BALLINA,1997,2,0,0,0,1997-02-01T00:00:00
BALLINA,1997,3,0,0,0,1997-03-01T00:00:00
BALLINA,1997,4,0,0,0,1997-04-01T00:00:00
BALLINA,1997,5,0,0,0,1997-05-01T00:00:00
BALLINA,1997,6,0,0,0,1997-06-01T00:00:00
BALLINA,1997,7,0,0,0,1997-07-01T00:00:00
BALLINA,1997,8,0,0,0,1997-08-01T00:00:00
BALLINA,1997,9,0,0,0,1997-09-01T00:00:00
BALLINA,1997,10,0,0,0,1997-10-01T00:00:00
BALLINA,1997,11,0,0,0,1997-11-01T00:00:00
BALLINA,1997,12,0,0,0,1997-12-01T00:00:00
BALLINA,1998,1,0,0,0,1998-01-01T00:00:00
BALLINA,1998,2,0,0,0,1998-02-01T00:00:00
BALLINA,1998,3,0,0,0,1998-03-01T00:00:00
BALLINA,1998,4,0,0,0,1998-04-01T00:00:00
BALLINA,1998,5,0,0,0,1998-05-01T00:00:00
BALLINA,1998,6,0,0,0,1998-06-01T00:00:00
BALLINA,1998,7,0,0,0,1998-07-01T00:00:00
BALLINA,1998,8,0,0,0,1998-08-01T00:00:00
BALLINA,1998,9,0,0,0,1998-09-01T00:00:00
BALLINA,1998,10,0,0,0,1998-10-01T00:00:00
BALLINA,1998,11,0,0,0,1998-11-01T00:00:00
BALLINA,1998,12,0,0,0,1998-12-01T00:00:00
BALLINA,1999,1,0,0,0,1999-01-01T00:00:00
BALLINA,1999,2,0,0,0,1999-02-01T00:00:00
BALLINA,1999,3,0,0,0,1999-03-01T00:00:00
BALLINA,1999,4,0,0,0,1999-04-01T00:00:00
BALLINA,1999,5,0,0,0,1999-05-01T00:00:00
BALLINA,1999,6,0,0,0,1999-06-01T00:00:00
BALLINA,1999,7,0,0,0,1999-07-01T00:00:00
BALLINA,1999,8,0,0,0,1999-08-01T00:00:00
BALLINA,1999,9,0,0,0,1999-09-01T00:00:00
BALLINA,1999,10,0,0,0,1999-10-01T00:00:00
BALLINA,1999,11,0,0,0,1999-11-01T00:00:00
BALLINA,1999,12,0,0,0,1999-12-01T00:00:00
BALLINA,2000,1,0,0,0,2000-01-01T00:00:00
BALLINA,2000,2,0,0,0,2000-02-01T00:00:00
BALLINA,2000,3,0,0,0,2000-03-01T00:00:00
BALLINA,2000,4,0,0,0,2000-04-01T00:00:00
BALLINA,2000,5,0,0,0,2000-05-01T00:00:00
BALLINA,2000,6,0,0,0,2000-06-01T00:00:00
BALLINA,2000,7,0,0,0,2000-07-01T00:00:00
BALLINA,2000,8,0,0,0,2000-08-01T00:00:00
BALLINA,2000,9,0,0,0,2000-09-01T00:00:00
BALLINA,2000,10,0,0,0,2000-10-01T00:00:00
BALLINA,2000,11,0,0,0,2000-11-01T00:00:00
BALLINA,2000,12,0,0,0,2000-12-01T00:00:00
BALLINA,2001,1,0,0,0,2001-01-01T00:00:00
BALLINA,2001,2,0,0,0,2001-02-01T00:00:00
BALLINA,2001,3,0,0,0,2001-03-01T00:00:00
BALLINA,2001,4,0,0,0,2001-04-01T00:00:00
BALLINA,2001,5,0,0,0,2001-05-01T00:00:00
BALLINA,2001,6,0,0,0,2001-06-01T00:00:00
BALLINA,2001,7,0,0,0,2001-07-01T00:00:00
BALLINA,2001,8,0,0,0,2001-08-01T00:00:00
BALLINA,2001,9,0,0,0,2001-09-01T00:00:00
BALLINA,2001,10,0,0,0,2001-10-01T00:00:00
BALLINA,2001,11,0,0,0,2001-11-01T00:00:00
BALLINA,2001,12,0,0,0,2001-12-01T00:00:00
BALLINA,2002,1,0,0,0,2002-01-01T00:00:00
BALLINA,2002,2,0,0,0,2002-02-01T00:00:00
BALLINA,2002,3,0,0,0,2002-03-01T00:00:00
BALLINA,2002,4,0,0,0,2002-04-01T00:00:00
BALLINA,2002,5,0,0,0,2002-05-01T00:00:00
BALLINA,2002,6,0,0,0,2002-06-01T00:00:00
BALLINA,2002,7,0,0,0,2002-07-01T00:00:00
BALLINA,2002,8,0,0,0,2002-08-01T00:00:00
BALLINA,2002,9,0,0,0,2002-09-01T00:00:00
BALLINA,2002,10,0,0,0,2002-10-01T00:00:00
BALLINA,2002,11,0,0,0,2002-11-01T00:00:00
BALLINA,2002,12,0,0,0,2002-12-01T00:00:00
BALLINA,2003,1,0,0,0,2003-01-01T00:00:00
BALLINA,2003,2,0,0,0,2003-02-01T00:00:00
BALLINA,2003,3,0,0,0,2003-03-01T00:00:00
BALLINA,2003,4,0,0,0,2003-04-01T00:00:00
BALLINA,2003,5,0,0,0,2003-05-01T00:00:00
BALLINA,2003,6,0,0,0,2003-06-01T00:00:00
BALLINA,2003,7,0,0,0,2003-07-01T00:00:00
BALLINA,2003,8,0,0,0,2003-08-01T00:00:00
BALLINA,2003,9,0,0,0,2003-09-01T00:00:00
BALLINA,2003,10,0,0,0,2003-10-01T00:00:00
BALLINA,2003,11,0,0,0,2003-11-01T00:00:00
BALLINA,2003,12,0,0,0,2003-12-01T00:00:00
BALLINA,2004,1,0,0,0,2004-01-01T00:00:00
BALLINA,2004,2,0,0,0,2004-02-01T00:00:00
BALLINA,2004,3,0,0,0,2004-03-01T00:00:00
BALLINA,2004,4,0,0,0,2004-04-01T00:00:00
BALLINA,2004,5,0,0,0,2004-05-01T00:00:00
BALLINA,2004,6,0,0,0,2004-06-01T00:00:00
BALLINA,2004,7,0,0,0,2004-07-01T00:00:00
BALLINA,2004,8,0,0,0,2004-08-01T00:00:00
BALLINA,2004,9,0,0,0,2004-09-01T00:00:00
BALLINA,2004,10,0,0,0,2004-10-01T00:00:00
BALLINA,2004,11,0,0,0,2004-11-01T00:00:00
BALLINA,2004,12,0,0,0,2004-12-01T00:00:00
BALLINA,2005,1,0,0,0,2005-01-01T00:00:00
BALLINA,2005,2,0,0,0,2005-02-01T00:00:00
BALLINA,2005,3,0,0,0,2005-03-01T00:00:00
BALLINA,2005,4,0,0,0,2005-04-01T00:00:00
BALLINA,2005,5,0,0,0,2005-05-01T00:00:00
BALLINA,2005,6,0,0,0,2005-06-01T00:00:00
BALLINA,2005,7,0,0,0,2005-07-01T00:00:00
BALLINA,2005,8,0,0,0,2005-08-01T00:00:00
BALLINA,2005,9,0,0,0,2005-09-01T00:00:00
BALLINA,2005,10,0,0,0,2005-10-01T00:00:00
BALLINA,2005,11,0,0,0,2005-11-01T00:00:00
BALLINA,2005,12,0,0,0,2005-12-01T00:00:00
BALLINA,2006,1,0,0,0,2006-01-01T00:00:00
BALLINA,2006,2,0,0,0,2006-02-01T00:00:00
BALLINA,2006,3,0,0,0,2006-03-01T00:00:00
BALLINA,2006,4,0,0,0,2006-04-01T00:00:00
BALLINA,2006,5,0,0,0,2006-05-01T00:00:00
BALLINA,2006,6,0,0,0,2006-06-01T00:00:00
BALLINA,2006,7,0,0,0,2006-07-01T00:00:00
BALLINA,2006,8,0,0,0,2006-08-01T00:00:00
BALLINA,2006,9,0,0,0,2006-09-01T00:00:00
BALLINA,2006,10,0,0,0,2006-10-01T00:00:00
BALLINA,2006,11,0,0,0,2006-11-01T00:00:00
BALLINA,2006,12,0,0,0,2006-12-01T00:00:00
BALLINA,2007,1,0,0,0,2007-01-01T00:00:00
BALLINA,2007,2,0,0,0,2007-02-01T00:00:00
BALLINA,2007,3,0,0,0,2007-03-01T00:00:00
BALLINA,2007,4,0,0,0,2007-04-01T00:00:00
BALLINA,2007,5,0,0,0,2007-05-01T00:00:00
BALLINA,2007,6,0,0,0,2007-06-01T00:00:00
BALLINA,2007,7,0,0,0,2007-07-01T00:00:00
BALLINA,2007,8,0,0,0,2007-08-01T00:00:00
BALLINA,2007,9,0,0,0,2007-09-01T00:00:00
BALLINA,2007,10,0,0,0,2007-10-01T00:00:00
BALLINA,2007,11,0,0,0,2007-11-01T00:00:00
BALLINA,2007,12,0,0,0,2007-12-01T00:00:00
BALLINA,2008,1,0,0,0,2008-01-01T00:00:00
BALLINA,2008,2,0,0,0,2008-02-01T00:00:00
BALLINA,2008,3,0,0,0,2008-03-01T00:00:00
BALLINA,2008,4,0,0,0,2008-04-01T00:00:00
BALLINA,2008,5,0,0,0,2008-05-01T00:00:00
BALLINA,2008,6,0,0,0,2008-06-01T00:00:00
BALLINA,2008,7,0,0,0,2008-07-01T00:00:00
BALLINA,2008,8,0,0,0,2008-08-01T00:00:00
BALLINA,2008,9,0,0,0,2008-09-01T00:00:00
BALLINA,2008,10,0,0,0,2008-10-01T00:00:00
BALLINA,2008,11,0,0,0,2008-11-01T00:00:00
BALLINA,2008,12,0,0,0,2008-12-01T00:00:00
BALLINA,2009,1,0,0,0,2009-01-01T00:00:00
BALLINA,2009,2,0,0,0,2009-02-01T00:00:00
BALLINA,2009,3,0,0,0,2009-03-01T00:00:00
BALLINA,2009,4,0,0,0,2009-04-01T00:00:00
BALLINA,2009,5,0,0,0,2009-05-01T00:00:00
BALLINA,2009,6,0,0,0,2009-06-01T00:00:00
BALLINA,2009,7,0,0,0,2009-07-01T00:00:00
BALLINA,2009,8,0,0,0,2009-08-01T00:00:00
BALLINA,2009,9,0,0,0,2009-09-01T00:00:00
BALLINA,2009,10,0,0,0,2009-10-01T00:00:00
BALLINA,2009,11,0,0,0,2009-11-01T00:00:00
BALLINA,2009,12,0,0,0,2009-12-01T00:00:00
BALLINA,2010,1,0,0,0,2010-01-01T00:00:00
BALLINA,2010,2,0,0,0,2010-02-01T00:00:00
BALLINA,2010,3,0,0,0,2010-03-01T00:00:00
BALLINA,2010,4,0,0,0,2010-04-01T00:00:00
BALLINA,2010,5,0,0,0,2010-05-01T00:00:00
BALLINA,2010,6,0,0,0,2010-06-01T00:00:00
BALLINA,2010,7,0,0,0,2010-07-01T00:00:00
BALLINA,2010,8,0,0,0,2010-08-01T00:00:00
BALLINA,2010,9,0,0,0,2010-09-01T00:00:00
BALLINA,2010,10,0,0,0,2010-10-01T00:00:00
BALLINA,2010,11,0,0,0,2010-11-01T00:00:00
BALLINA,2010,12,0,0,0,2010-12-01T00:00:00
BALLINA,2011,1,0,0,0,2011-01-01T00:00:00
BALLINA,2011,2,0,0,0,2011-02-01T00:00:00
BALLINA,2011,3,0,0,0,2011-03-01T00:00:00
BALLINA,2011,4,0,0,0,2011-04-01T00:00:00
BALLINA,2011,5,0,0,0,2011-05-01T00:00:00
BALLINA,2011,6,0,0,0,2011-06-01T00:00:00
BALLINA,2011,7,0,0,0,2011-07-01T00:00:00
BALLINA,2011,8,0,0,0,2011-08-01T00:00:00
BALLINA,2011,9,0,0,0,2011-09-01T00:00:00
BALLINA,2011,10,0,0,0,2011-10-01T00:00:00
BALLINA,2011,11,0,0,0,2011-11-01T00:00:00
BALLINA,2011,12,0,0,0,2011-12-01T00:00:00
BALLINA,2012,1,0,0,0,2012-01-01T00:00:00
BALLINA,2012,2,0,0,0,2012-02-01T00:00:00
BALLINA,2012,3,0,0,0,2012-03-01T00:00:00
BALLINA,2012,4,0,0,0,2012-04-01T00:00:00
BALLINA,2012,5,0,0,0,2012-05-01T00:00:00
BALLINA,2012,6,0,0,0,2012-06-01T00:00:00
BALLINA,2012,7,0,0,0,2012-07-01T00:00:00
BALLINA,2012,8,0,0,0,2012-08-01T00:00:00
BALLINA,2012,9,0,0,0,2012-09-01T00:00:00
BALLINA,2012,10,0,0,0,2012-10-01T00:00:00
BALLINA,2012,11,0,0,0,2012-11-01T00:00:00
BALLINA,2012,12,0,0,0,2012-12-01T00:00:00
BALLINA,2013,1,0,0,0,2013-01-01T00:00:00
BALLINA,2013,2,0,0,0,2013-02-01T00:00:00
BALLINA,2013,3,0,0,0,2013-03-01T00:00:00
BALLINA,2013,4,0,0,0,2013-04-01T00:00:00
BALLINA,2013,5,0,0,0,2013-05-01T00:00:00
BALLINA,2013,6,0,0,0,2013-06-01T00:00:00
BALLINA,2013,7,0,0,0,2013-07-01T00:00:00
BALLINA,2013,8,0,0,0,2013-08-01T00:00:00
BALLINA,2013,9,0,0,0,2013-09-01T00:00:00
BALLINA,2013,10,0,0,0,2013-10-01T00:00:00
BALLINA,2013,11,0,0,0,2013-11-01T00:00:00
BALLINA,2013,12,0,0,0,2013-12-01T00:00:00
BALLINA,2014,1,0,0,0,2014-01-01T00:00:00
BALLINA,2014,2,0,0,0,2014-02-01T00:00:00
BALLINA,2014,3,0,0,0,2014-03-01T00:00:00
BALLINA,2014,4,0,0,0,2014-04-01T00:00:00
BALLINA,2014,5,0,0,0,2014-05-01T00:00:00
BALLINA,2014,6,0,0,0,2014-06-01T00:00:00
BALLINA,2014,7,0,0,0,2014-07-01T00:00:00
BALLINA,2014,8,0,0,0,2014-08-01T00:00:00
BALLINA,2014,9,0,0,0,2014-09-01T00:00:00
BALLINA,2014,10,0,0,0,2014-10-01T00:00:00
BALLINA,2014,11,0,0,0,2014-11-01T00:00:00
BALLINA,2014,12,0,0,0,2014-12-01T00:00:00
BALLINA,2015,1,0,0,0,2015-01-01T00:00:00
BALLINA,2015,2,0,0,0,2015-02-01T00:00:00
BALLINA,2015,3,0,0,0,2015-03-01T00:00:00
BALLINA,2015,4,0,0,0,2015-04-01T00:00:00
BALLINA,2015,5,0,0,0,2015-05-01T00:00:00
BALLINA,2015,6,0,0,0,2015-06-01T00:00:00
BALLINA,2015,7,0,0,0,2015-07-01T00:00:00
BALLINA,2015,8,0,0,0,2015-08-01T00:00:00
BALLINA,2015,9,0,0,0,2015-09-01T00:00:00
BALLINA,2015,10,0,0,0,2015-10-01T00:00:00
BALLINA,2015,11,0,0,0,2015-11-01T00:00:00
BALLINA,2015,12,0,0,0,2015-12-01T00:00:00
BALLINA,2016,1,0,0,0,2016-01-01T00:00:00
BALLINA,2016,2,0,0,0,2016-02-01T00:00:00
BALLINA,2016,3,0,0,0,2016-03-01T00:00:00
BALLINA,2016,4,0,0,0,2016-04-01T00:00:00
BALLINA,2016,5,0,0,0,2016-05-01T00:00:00
BALLINA,2016,6,0,0,0,2016-06-01T00:00:00
BALLINA,2016,7,0,0,0,2016-07-01T00:00:00
BALLINA,2016,8,0,0,0,2016-08-01T00:00:00
BALLINA,2016,9,0,0,0,2016-09-01T00:00:00
BALLINA,2016,10,0,0,0,2016-10-01T00:00:00
BALLINA,2016,11,0,0,0,2016-11-01T00:00:00
BALLINA,2016,12,0,0,0,2016-12-01T00:00:00
BALLINA,2017,1,0,0,0,2017-01-01T00:00:00
BALLINA,2017,2,0,0,0,2017-02-01T00:00:00
BALLINA,2017,3,0,0,0,2017-03-01T00:00:00
BALLINA,2017,4,0,0,0,2017-04-01T00:00:00
BALLINA,2017,5,0,0,0,2017-05-01T00:00:00
BALLINA,2017,6,0,0,0,2017-06-01T00:00:00
BALLINA,2017,7,0,0,0,2017-07-01T00:00:00
BALLINA,2017,8,0,0,0,2017-08-01T00:00:00
BALLINA,2017,9,0,0,0,2017-09-01T00:00:00
BALLINA,2017,10,0,0,0,2017-10-01T00:00:00
BALLINA,2017,11,0,0,0,2017-11-01T00:00:00
BALLINA,2017,12,0,0,0,2017-12-01T00:00:00
BALLINA,2018,1,0,0,0,2018-01-01T00:00:00
BALLINA,2018,2,0,0,0,2018-02-01T00:00:00
BALLINA,2018,3,0,0,0,2018-03-01T00:00:00
BALLINA,2018,4,0,0,0,2018-04-01T00:00:00
BALLINA,2018,5,0,0,0,2018-05-01T00:00:00
BALLINA,2018,6,0,0,0,2018-06-01T00:00:00
BALLINA,2018,7,0,0,0,2018-07-01T00:00:00
BALLINA,2018,8,0,0,0,2018-08-01T00:00:00
BALLINA,2018,9,0,0,0,2018-09-01T00:00:00
BALLINA,2018,10,0,0,0,2018-10-01T00:00:00
BALLINA,2018,11,0,0,0,2018-11-01T00:00:00
BALLINA,2018,12,0,0,0,2018-12-01T00:00:00
BALLINA,2019,1,0,0,0,2019-01-01T00:00:00
BALLINA,2019,2,0,0,0,2019-02-01T00:00:00
BALLINA,2019,3,0,0,0,2019-03-01T00:00:00
BALLINA,2019,4,0,0,0,2019-04-01T00:00:00
BALLINA,2019,5,0,0,0,2019-05-01T00:00:00
BALLINA,2019,6,0,0,0,2019-06-01T00:00:00
BALLINA,2019,7,0,0,0,2019-07-01T00:00:00
BALLINA,2019,8,0,0,0,2019-08-01T00:00:00
BALLINA,2019,9,0,0,0,2019-09-01T00:00:00
BALLINA,2019,10,0,0,0,2019-10-01T00:00:00
BALLINA,2019,11,0,0,0,2019-11-01T00:00:00
BALLINA,2019,12,0,0,0,2019-12-01T00:00:00
BALLINA,2020,1,0,0,0,2020-01-01T00:00:00
BALLINA,2020,2,0,0,0,2020-02-01T00:00:00
BALLINA,2020,3,0,0,0,2020-03-01T00:00:00
BALLINA,2020,4,0,0,0,2020-04-01T00:00:00
BALLINA,2020,5,0,0,0,2020-05-01T00:00:00
BALLINA,2020,6,0,0,0,2020-06-01T00:00:00
BALLINA,2020,7,0,0,0,2020-07-01T00:00:00
BALLINA,2020,8,0,0,0,2020-08-01T00:00:00
BALLINA,2020,9,0,0,0,2020-09-01T00:00:00
BALLINA,2020,10,0,0,0,2020-10-01T00:00:00
BALLINA,2020,11,0,0,0,2020-11-01T00:00:00
BALLINA,2020,12,0,0,0,2020-12-01T00:00:00
BALLINA,2021,1,0,0,0,2021-01-01T00:00:00
BALLINA,2021,2,0,0,0,2021-02-01T00:00:00
BALLINA,2021,3,0,0,0,2021-03-01T00:00:00
BALLINA,2021,4,0,0,0,2021-04-01T00:00:00
BALLINA,2021,5,0,0,0,2021-05-01T00:00:00
BALLINA,2021,6,0,0,0,2021-06-01T00:00:00
BALLINA,2021,7,0,0,0,2021-07-01T00:00:00
BALLINA,2021,8,0,0,0,2021-08-01T00:00:00
BALLINA,2021,9,0,0,0,2021-09-01T00:00:00
BALLINA,2021,10,0,0,0,2021-10-01T00:00:00
BALLINA,2021,11,0,0,0,2021-11-01T00:00:00
BALLINA,2021,12,0,0,0,2021-12-01T00:00:00
BALLINA,2022,1,0,0,0,2022-01-01T00:00:00
BALLINA,2022,2,0,0,0,2022-02-01T00:00:00
BALLINA,2022,3,0,0,0,2022-03-01T00:00:00
BALLINA,2022,4,0,0,0,2022-04-01T00:00:00
BALLINA,2022,5,0,0,0,2022-05-01T00:00:00
BALLINA,2022,6,0,0,0,2022-06-01T00:00:00
BALLINA,2022,7,0,0,0,2022-07-01T00:00:00
BALLINA,2022,8,0,0,0,2022-08-01T00:00:00
BALLINA,2022,9,0,0,0,2022-09-01T00:00:00
BALLINA,2022,10,0,0,0,2022-10-01T00:00:00
BALLINA,2022,11,0,0,0,2022-11-01T00:00:00
BALLINA,2022,12,0,0,0,2022-12-01T00:00:00
BALLINA,2023,1,0,0,0,2023-01-01T00:00:00
BALLINA,2023,2,0,0,0,2023-02-01T00:00:00
BALLINA,2023,3,0,0,0,2023-03-01T00:00:00
BALLINA,2023,4,0,0,0,2023-04-01T00:00:00
BALLINA,2023,5,0,0,0,2023-05-01T00:00:00
BALLINA,2023,6,0,0,0,2023-06-01T00:00:00
BALLINA,2023,7,0,0,0,2023-07-01T00:00:00
BALLINA,2023,8,0,0,0,2023-08-01T00:00:00
BALLINA,2023,9,0,0,0,2023-09-01T00:00:00
BALLINA,2023,10,0,0,0,2023-10-01T00:00:00
BALLINA,2023,11,0,0,0,2023-11-01T00:00:00
BALLINA,2023,12,0,0,0,2023-12-01T00:00:00
BALLINA,2024,1,0,0,0,2024-01-01T00:00:00
BALLINA,2024,2,0,0,0,2024-02-01T00:00:00
BALLINA,2024,3,0,0,0,2024-03-01T00:00:00
BALLINA,2024,4,0,0,0,2024-04-01T00:00:00
BALLINA,2024,5,0,0,0,2024-05-01T00:00:00
BALLINA,2024,6,0,0,0,2024-06-01T00:00:00
BALLINA,2024,7,0,0,0,2024-07-01T00:00:00
BALLINA,2024,8,0,0,0,2024-08-01T00:00:00
BALLINA,2024,9,0,0,0,2024-09-01T00:00:00
BALLINA,2024,10,0,0,0,2024-10-01T00:00:00
BALLINA,2024,11,0,0,0,2024-11-01T00:00:00
BALLINA,2024,12,0,0,0,2024-12-01T00:00:00
BALLINA,2025,1,0,0,0,2025-01-01T00:00:00
BALLINA,2025,2,0,0,0,2025-02-01T00:00:00
BALLINA,2025,3,0,0,0,2025-03-01T00:00:00
BALLINA,2025,4,0,0,0,2025-04-01T00:00:00
BALLINA,2025,5,0,0,0,2025-05-01T00:00:00
BALLINA,2025,6,0,0,0,2025-06-01T00:00:00
BRISBANE,1985,1,25867,19178,45045,1985-01-01T00:00:00
BRISBANE,1985,2,15480,15964,31444,1985-02-01T00:00:00
BRISBANE,1985,3,19853,20203,40056,1985-03-01T00:00:00
BRISBANE,1985,4,17826,17715,35541,1985-04-01T00:00:00
BRISBANE,1985,5,18058,17240,35298,1985-05-01T00:00:00
BRISBANE,1985,6,21490,23819,45309,1985-06-01T00:00:00
BRISBANE,1985,7,25341,20378,45719,1985-07-01T00:00:00
BRISBANE,1985,8,19619,20210,39829,1985-08-01T00:00:00
BRISBANE,1985,9,19782,23022,42804,1985-09-01T00:00:00
BRISBANE,1985,10,23452,17953,41405,1985-10-01T00:00:00
BRISBANE,1985,11,19550,19013,38563,1985-11-01T00:00:00
BRISBANE,1985,12,25054,26399,51453,1985-12-01T00:00:00
BRISBANE,1986,1,29020,22622,51642,1986-01-01T00:00:00
BRISBANE,1986,2,18519,17159,35678,1986-02-01T00:00:00
BRISBANE,1986,3,21789,21054,42843,1986-03-01T00:00:00
BRISBANE,1986,4,21269,21090,42359,1986-04-01T00:00:00
BRISBANE,1986,5,21586,22144,43730,1986-05-01T00:00:00
BRISBANE,1986,6,25989,25327,51316,1986-06-01T00:00:00
BRISBANE,1986,7,28505,24481,52986,1986-07-01T00:00:00
BRISBANE,1986,8,25147,25817,50964,1986-08-01T00:00:00
BRISBANE,1986,9,24248,26517,50765,1986-09-01T00:00:00
BRISBANE,1986,10,26929,22475,49404,1986-10-01T00:00:00
BRISBANE,1986,11,24793,24559,49352,1986-11-01T00:00:00
BRISBANE,1986,12,27937,27687,55624,1986-12-01T00:00:00
BRISBANE,1987,1,32051,28602,60653,1987-01-01T00:00:00
BRISBANE,1987,2,22389,21595,43984,1987-02-01T00:00:00
BRISBANE,1987,3,23636,24857,48493,1987-03-01T00:00:00
BRISBANE,1987,4,26120,25134,51254,1987-04-01T00:00:00
BRISBANE,1987,5,26851,27973,54824,1987-05-01T00:00:00
BRISBANE,1987,6,28685,28309,56994,1987-06-01T00:00:00
BRISBANE,1987,7,36933,30360,67293,1987-07-01T00:00:00
BRISBANE,1987,8,32607,32682,65289,1987-08-01T00:00:00
BRISBANE,1987,9,30109,32301,62410,1987-09-01T00:00:00
BRISBANE,1987,10,33648,29173,62821,1987-10-01T00:00:00
BRISBANE,1987,11,28923,29570,58493,1987-11-01T00:00:00
BRISBANE,1987,12,34211,30734,64945,1987-12-01T00:00:00
BRISBANE,1988,1,35728,32810,68538,1988-01-01T00:00:00
BRISBANE,1988,2,28735,26531,55266,1988-02-01T00:00:00
BRISBANE,1988,3,31490,30965,62455,1988-03-01T00:00:00
BRISBANE,1988,4,34984,27498,62482,1988-04-01T00:00:00
BRISBANE,1988,5,40189,39081,79270,1988-05-01T00:00:00
BRISBANE,1988,6,46167,39129,85296,1988-06-01T00:00:00
BRISBANE,1988,7,55184,43228,98412,1988-07-01T00:00:00
BRISBANE,1988,8,52094,46859,98953,1988-08-01T00:00:00
BRISBANE,1988,9,50352,46935,97287,1988-09-01T00:00:00
BRISBANE,1988,10,48460,44163,92623,1988-10-01T00:00:00
BRISBANE,1988,11,35741,38491,74232,1988-11-01T00:00:00
BRISBANE,1988,12,43160,40821,83981,1988-12-01T00:00:00
BRISBANE,1989,1,45067,38400,83467,1989-01-01T00:00:00
BRISBANE,1989,2,32579,30841,63420,1989-02-01T00:00:00
BRISBANE,1989,3,34331,34405,68736,1989-03-01T00:00:00
BRISBANE,1989,4,36790,32953,69743,1989-04-01T00:00:00
BRISBANE,1989,5,35371,35000,70371,1989-05-01T00:00:00
BRISBANE,1989,6,38169,34614,72783,1989-06-01T00:00:00
BRISBANE,1989,7,49756,38371,88127,1989-07-01T00:00:00
BRISBANE,1989,8,43335,45193,88528,1989-08-01T00:00:00
BRISBANE,1989,9,43377,42769,86146,1989-09-01T00:00:00
BRISBANE,1989,10,43913,34949,78862,1989-10-01T00:00:00
BRISBANE,1989,11,41975,37736,79711,1989-11-01T00:00:00
BRISBANE,1989,12,50229,45944,96173,1989-12-01T00:00:00
BRISBANE,1990,1,53863,42294,96157,1990-01-01T00:00:00
BRISBANE,1990,2,40139,33847,73986,1990-02-01T00:00:00
BRISBANE,1990,3,42431,39361,81792,1990-03-01T00:00:00
BRISBANE,1990,4,46000,41651,87651,1990-04-01T00:00:00
BRISBANE,1990,5,40174,38713,78887,1990-05-01T00:00:00
BRISBANE,1990,6,43619,39650,83269,1990-06-01T00:00:00
BRISBANE,1990,7,52130,38284,90414,1990-07-01T00:00:00
BRISBANE,1990,8,47656,46384,94040,1990-08-01T00:00:00
BRISBANE,1990,9,49066,50422,99488,1990-09-01T00:00:00
BRISBANE,1990,10,49571,39413,88984,1990-10-01T00:00:00
BRISBANE,1990,11,44294,40771,85065,1990-11-01T00:00:00
BRISBANE,1990,12,53188,49816,103004,1990-12-01T00:00:00
BRISBANE,1991,1,54293,45554,99847,1991-01-01T00:00:00
BRISBANE,1991,2,40357,38497,78854,1991-02-01T00:00:00
BRISBANE,1991,3,44622,44346,88968,1991-03-01T00:00:00
BRISBANE,1991,4,40813,38994,79807,1991-04-01T00:00:00
BRISBANE,1991,5,40996,42169,83165,1991-05-01T00:00:00
BRISBANE,1991,6,55148,51339,106487,1991-06-01T00:00:00
BRISBANE,1991,7,58655,50423,109078,1991-07-01T00:00:00
BRISBANE,1991,8,54421,55376,109797,1991-08-01T00:00:00
BRISBANE,1991,9,56516,56101,112617,1991-09-01T00:00:00
BRISBANE,1991,10,59201,53587,112788,1991-10-01T00:00:00
BRISBANE,1991,11,54615,53850,108465,1991-11-01T00:00:00
BRISBANE,1991,12,56899,55398,112297,1991-12-01T00:00:00
BRISBANE,1992,1,59158,51076,110234,1992-01-01T00:00:00
BRISBANE,1992,2,51063,49800,100863,1992-02-01T00:00:00
BRISBANE,1992,3,50629,49069,99698,1992-03-01T00:00:00
BRISBANE,1992,4,50413,48707,99120,1992-04-01T00:00:00
BRISBANE,1992,5,48666,47417,96083,1992-05-01T00:00:00
BRISBANE,1992,6,52798,50210,103008,1992-06-01T00:00:00
BRISBANE,1992,7,62968,51837,114805,1992-07-01T00:00:00
BRISBANE,1992,8,54593,55236,109829,1992-08-01T00:00:00
BRISBANE,1992,9,55403,58617,114020,1992-09-01T00:00:00
BRISBANE,1992,10,64850,50583,115433,1992-10-01T00:00:00
BRISBANE,1992,11,59760,53561,113321,1992-11-01T00:00:00
BRISBANE,1992,12,68174,68351,136525,1992-12-01T00:00:00
BRISBANE,1993,1,76143,62491,138634,1993-01-01T00:00:00
BRISBANE,1993,2,55337,52286,107623,1993-02-01T00:00:00
BRISBANE,1993,3,61524,56861,118385,1993-03-01T00:00:00
BRISBANE,1993,4,60518,56080,116598,1993-04-01T00:00:00
BRISBANE,1993,5,57863,58563,116426,1993-05-01T00:00:00
BRISBANE,1993,6,64323,62938,127261,1993-06-01T00:00:00
BRISBANE,1993,7,74072,58665,132737,1993-07-01T00:00:00
BRISBANE,1993,8,66989,67875,134864,1993-08-01T00:00:00
BRISBANE,1993,9,63668,66737,130405,1993-09-01T00:00:00
BRISBANE,1993,10,76163,62422,138585,1993-10-01T00:00:00
BRISBANE,1993,11,65489,65081,130570,1993-11-01T00:00:00
BRISBANE,1993,12,73325,76798,150123,1993-12-01T00:00:00
BRISBANE,1994,1,76490,71062,147552,1994-01-01T00:00:00
BRISBANE,1994,2,65784,63202,128986,1994-02-01T00:00:00
BRISBANE,1994,3,65388,63942,129330,1994-03-01T00:00:00
BRISBANE,1994,4,63604,63550,127154,1994-04-01T00:00:00
BRISBANE,1994,5,57992,60290,118282,1994-05-01T00:00:00
BRISBANE,1994,6,67054,63444,130498,1994-06-01T00:00:00
BRISBANE,1994,7,76352,64109,140461,1994-07-01T00:00:00
BRISBANE,1994,8,70462,74167,144629,1994-08-01T00:00:00
BRISBANE,1994,9,77212,69174,146386,1994-09-01T00:00:00
BRISBANE,1994,10,87520,68517,156037,1994-10-01T00:00:00
BRISBANE,1994,11,80028,68176,148204,1994-11-01T00:00:00
BRISBANE,1994,12,90655,77883,168538,1994-12-01T00:00:00
BRISBANE,1995,1,99263,75500,174763,1995-01-01T00:00:00
BRISBANE,1995,2,78074,66883,144957,1995-02-01T00:00:00
BRISBANE,1995,3,80033,72401,152434,1995-03-01T00:00:00
BRISBANE,1995,4,84830,71971,156801,1995-04-01T00:00:00
BRISBANE,1995,5,79655,68614,148269,1995-05-01T00:00:00
BRISBANE,1995,6,86465,70079,156544,1995-06-01T00:00:00
BRISBANE,1995,7,98109,73814,171923,1995-07-01T00:00:00
BRISBANE,1995,8,91244,83683,174927,1995-08-01T00:00:00
BRISBANE,1995,9,83374,77358,160732,1995-09-01T00:00:00
BRISBANE,1995,10,93631,74338,167969,1995-10-01T00:00:00
BRISBANE,1995,11,90382,75920,166302,1995-11-01T00:00:00
BRISBANE,1995,12,101681,88025,189706,1995-12-01T00:00:00
BRISBANE,1996,1,103570,81037,184607,1996-01-01T00:00:00
BRISBANE,1996,2,93947,74180,168127,1996-02-01T00:00:00
BRISBANE,1996,3,95488,78170,173658,1996-03-01T00:00:00
BRISBANE,1996,4,95667,79327,174994,1996-04-01T00:00:00
BRISBANE,1996,5,81337,69689,151026,1996-05-01T00:00:00
BRISBANE,1996,6,98750,82648,181398,1996-06-01T00:00:00
BRISBANE,1996,7,110732,80327,191059,1996-07-01T00:00:00
BRISBANE,1996,8,102494,94918,197412,1996-08-01T00:00:00
BRISBANE,1996,9,95533,84563,180096,1996-09-01T00:00:00
BRISBANE,1996,10,106508,82387,188895,1996-10-01T00:00:00
BRISBANE,1996,11,99075,87672,186747,1996-11-01T00:00:00
BRISBANE,1996,12,115270,98821,214091,1996-12-01T00:00:00
BRISBANE,1997,1,108957,87504,196461,1997-01-01T00:00:00
BRISBANE,1997,2,94212,75759,169971,1997-02-01T00:00:00
BRISBANE,1997,3,107234,87129,194363,1997-03-01T00:00:00
BRISBANE,1997,4,99095,82251,181346,1997-04-01T00:00:00
BRISBANE,1997,5,90312,77163,167475,1997-05-01T00:00:00
BRISBANE,1997,6,98766,86173,184939,1997-06-01T00:00:00
BRISBANE,1997,7,122670,88011,210681,1997-07-01T00:00:00
BRISBANE,1997,8,102017,93788,195805,1997-08-01T00:00:00
BRISBANE,1997,9,104607,89666,194273,1997-09-01T00:00:00
BRISBANE,1997,10,114999,86137,201136,1997-10-01T00:00:00
BRISBANE,1997,11,103859,91334,195193,1997-11-01T00:00:00
BRISBANE,1997,12,109523,93734,203257,1997-12-01T00:00:00
BRISBANE,1998,1,110236,88854,199090,1998-01-01T00:00:00
BRISBANE,1998,2,88436,73730,162166,1998-02-01T00:00:00
BRISBANE,1998,3,88967,74306,163273,1998-03-01T00:00:00
BRISBANE,1998,4,97343,83832,181175,1998-04-01T00:00:00
BRISBANE,1998,5,91434,77609,169043,1998-05-01T00:00:00
BRISBANE,1998,6,104819,90178,194997,1998-06-01T00:00:00
BRISBANE,1998,7,113943,84057,198000,1998-07-01T00:00:00
BRISBANE,1998,8,102931,98576,201507,1998-08-01T00:00:00
BRISBANE,1998,9,104107,92608,196715,1998-09-01T00:00:00
BRISBANE,1998,10,110046,90793,200839,1998-10-01T00:00:00
BRISBANE,1998,11,94668,87146,181814,1998-11-01T00:00:00
BRISBANE,1998,12,106331,96290,202621,1998-12-01T00:00:00
BRISBANE,1999,1,109796,96938,206734,1999-01-01T00:00:00
BRISBANE,1999,2,91875,77585,169460,1999-02-01T00:00:00
BRISBANE,1999,3,97925,82997,180922,1999-03-01T00:00:00
BRISBANE,1999,4,94320,88874,183194,1999-04-01T00:00:00
BRISBANE,1999,5,92510,81623,174133,1999-05-01T00:00:00
BRISBANE,1999,6,100975,93305,194280,1999-06-01T00:00:00
BRISBANE,1999,7,124576,92271,216847,1999-07-01T00:00:00
BRISBANE,1999,8,109202,108299,217501,1999-08-01T00:00:00
BRISBANE,1999,9,112101,101982,214083,1999-09-01T00:00:00
BRISBANE,1999,10,119095,94645,213740,1999-10-01T00:00:00
BRISBANE,1999,11,104973,95520,200493,1999-11-01T00:00:00
BRISBANE,1999,12,102433,101947,204380,1999-12-01T00:00:00
BRISBANE,2000,1,107017,92287,199304,2000-01-01T00:00:00
BRISBANE,2000,2,99603,83005,182608,2000-02-01T00:00:00
BRISBANE,2000,3,100516,87502,188018,2000-03-01T00:00:00
BRISBANE,2000,4,110553,100105,210658,2000-04-01T00:00:00
BRISBANE,2000,5,96959,86004,182963,2000-05-01T00:00:00
BRISBANE,2000,6,106451,92973,199424,2000-06-01T00:00:00
BRISBANE,2000,7,125541,99036,224577,2000-07-01T00:00:00
BRISBANE,2000,8,111615,106425,218040,2000-08-01T00:00:00
BRISBANE,2000,9,101463,94868,196331,2000-09-01T00:00:00
BRISBANE,2000,10,115739,97650,213389,2000-10-01T00:00:00
BRISBANE,2000,11,111875,100639,212514,2000-11-01T00:00:00
BRISBANE,2000,12,122274,111278,233552,2000-12-01T00:00:00
BRISBANE,2001,1,125932,108112,234044,2001-01-01T00:00:00
BRISBANE,2001,2,100127,81302,181429,2001-02-01T00:00:00
BRISBANE,2001,3,106653,93629,200282,2001-03-01T00:00:00
BRISBANE,2001,4,115261,101408,216669,2001-04-01T00:00:00
BRISBANE,2001,5,98420,91054,189474,2001-05-01T00:00:00
BRISBANE,2001,6,116559,101832,218391,2001-06-01T00:00:00
BRISBANE,2001,7,137364,103190,240554,2001-07-01T00:00:00
BRISBANE,2001,8,119550,113153,232703,2001-08-01T00:00:00
BRISBANE,2001,9,117703,111430,229133,2001-09-01T00:00:00
BRISBANE,2001,10,112802,98633,211435,2001-10-01T00:00:00
BRISBANE,2001,11,91837,91037,182874,2001-11-01T00:00:00
BRISBANE,2001,12,106648,104084,210732,2001-12-01T00:00:00
BRISBANE,2002,1,109527,100027,209554,2002-01-01T00:00:00
BRISBANE,2002,2,98031,87700,185731,2002-02-01T00:00:00
BRISBANE,2002,3,105155,95557,200712,2002-03-01T00:00:00
BRISBANE,2002,4,96762,93619,190381,2002-04-01T00:00:00
BRISBANE,2002,5,92762,88673,181435,2002-05-01T00:00:00
BRISBANE,2002,6,102396,98871,201267,2002-06-01T00:00:00
BRISBANE,2002,7,125385,100731,226116,2002-07-01T00:00:00
BRISBANE,2002,8,113061,111913,224974,2002-08-01T00:00:00
BRISBANE,2002,9,108786,107761,216547,2002-09-01T00:00:00
BRISBANE,2002,10,119081,99545,218626,2002-10-01T00:00:00
BRISBANE,2002,11,106466,104668,211134,2002-11-01T00:00:00
BRISBANE,2002,12,113011,113594,226605,2002-12-01T00:00:00
BRISBANE,2003,1,120454,107391,227845,2003-01-01T00:00:00
BRISBANE,2003,2,100068,88166,188234,2003-02-01T00:00:00
BRISBANE,2003,3,94000,92890,186890,2003-03-01T00:00:00
BRISBANE,2003,4,90090,87917,178007,2003-04-01T00:00:00
BRISBANE,2003,5,78835,78635,157470,2003-05-01T00:00:00
BRISBANE,2003,6,89626,90844,180470,2003-06-01T00:00:00
BRISBANE,2003,7,125102,104246,229348,2003-07-01T00:00:00
BRISBANE,2003,8,107888,115826,223714,2003-08-01T00:00:00
BRISBANE,2003,9,115869,116536,232405,2003-09-01T00:00:00
BRISBANE,2003,10,126447,108154,234601,2003-10-01T00:00:00
BRISBANE,2003,11,120979,119738,240717,2003-11-01T00:00:00
BRISBANE,2003,12,133710,136033,269743,2003-12-01T00:00:00
BRISBANE,2004,1,145938,133521,279459,2004-01-01T00:00:00
BRISBANE,2004,2,123067,108439,231506,2004-02-01T00:00:00
BRISBANE,2004,3,118736,117430,236166,2004-03-01T00:00:00
BRISBANE,2004,4,126407,127522,253929,2004-04-01T00:00:00
BRISBANE,2004,5,111746,113873,225619,2004-05-01T00:00:00
BRISBANE,2004,6,125154,130083,255237,2004-06-01T00:00:00
BRISBANE,2004,7,167410,137173,304583,2004-07-01T00:00:00
BRISBANE,2004,8,139969,152497,292466,2004-08-01T00:00:00
BRISBANE,2004,9,144519,148738,293257,2004-09-01T00:00:00
BRISBANE,2004,10,156042,136006,292048,2004-10-01T00:00:00
BRISBANE,2004,11,137086,143505,280591,2004-11-01T00:00:00
BRISBANE,2004,12,156210,165410,321620,2004-12-01T00:00:00
BRISBANE,2005,1,172833,148247,321080,2005-01-01T00:00:00
BRISBANE,2005,2,137119,122375,259494,2005-02-01T00:00:00
BRISBANE,2005,3,142566,142294,284860,2005-03-01T00:00:00
BRISBANE,2005,4,140291,136337,276628,2005-04-01T00:00:00
BRISBANE,2005,5,125447,133992,259439,2005-05-01T00:00:00
BRISBANE,2005,6,144975,152816,297791,2005-06-01T00:00:00
BRISBANE,2005,7,189482,151473,340955,2005-07-01T00:00:00
BRISBANE,2005,8,153890,169943,323833,2005-08-01T00:00:00
BRISBANE,2005,9,163503,156909,320412,2005-09-01T00:00:00
BRISBANE,2005,10,160991,149945,310936,2005-10-01T00:00:00
BRISBANE,2005,11,135876,147514,283390,2005-11-01T00:00:00
BRISBANE,2005,12,160149,167723,327872,2005-12-01T00:00:00
BRISBANE,2006,1,179252,152623,331875,2006-01-01T00:00:00
BRISBANE,2006,2,138900,126649,265549,2006-02-01T00:00:00
BRISBANE,2006,3,136253,136404,272657,2006-03-01T00:00:00
BRISBANE,2006,4,148833,152560,301393,2006-04-01T00:00:00
BRISBANE,2006,5,129506,135405,264911,2006-05-01T00:00:00
BRISBANE,2006,6,147740,155368,303108,2006-06-01T00:00:00
BRISBANE,2006,7,195260,160619,355879,2006-07-01T00:00:00
BRISBANE,2006,8,156937,174756,331693,2006-08-01T00:00:00
BRISBANE,2006,9,170627,171001,341628,2006-09-01T00:00:00
BRISBANE,2006,10,182072,162195,344267,2006-10-01T00:00:00
BRISBANE,2006,11,150858,154736,305594,2006-11-01T00:00:00
BRISBANE,2006,12,165788,178972,344760,2006-12-01T00:00:00
BRISBANE,2007,1,186651,161832,348483,2007-01-01T00:00:00
BRISBANE,2007,2,149653,137565,287218,2007-02-01T00:00:00
BRISBANE,2007,3,158937,155550,314487,2007-03-01T00:00:00
BRISBANE,2007,4,157899,160567,318466,2007-04-01T00:00:00
BRISBANE,2007,5,138687,142402,281089,2007-05-01T00:00:00
BRISBANE,2007,6,152525,159817,312342,2007-06-01T00:00:00
BRISBANE,2007,7,184506,165111,349617,2007-07-01T00:00:00
BRISBANE,2007,8,163817,175834,339651,2007-08-01T00:00:00
BRISBANE,2007,9,169900,178498,348398,2007-09-01T00:00:00
BRISBANE,2007,10,181037,160564,341601,2007-10-01T00:00:00
BRISBANE,2007,11,157226,161692,318918,2007-11-01T00:00:00
BRISBANE,2007,12,170259,191223,361482,2007-12-01T00:00:00
BRISBANE,2008,1,195038,164046,359084,2008-01-01T00:00:00
BRISBANE,2008,2,160434,143781,304215,2008-02-01T00:00:00
BRISBANE,2008,3,161086,160637,321723,2008-03-01T00:00:00
BRISBANE,2008,4,152773,153127,305900,2008-04-01T00:00:00
BRISBANE,2008,5,151828,154565,306393,2008-05-01T00:00:00
BRISBANE,2008,6,158862,168991,327853,2008-06-01T00:00:00
BRISBANE,2008,7,202987,171158,374145,2008-07-01T00:00:00
BRISBANE,2008,8,170672,184812,355484,2008-08-01T00:00:00
BRISBANE,2008,9,168024,172677,340701,2008-09-01T00:00:00
BRISBANE,2008,10,185838,162537,348375,2008-10-01T00:00:00
BRISBANE,2008,11,156695,166190,322885,2008-11-01T00:00:00
BRISBANE,2008,12,171105,197927,369032,2008-12-01T00:00:00
BRISBANE,2009,1,205011,172799,377810,2009-01-01T00:00:00
BRISBANE,2009,2,156061,144635,300696,2009-02-01T00:00:00
BRISBANE,2009,3,156115,158487,314602,2009-03-01T00:00:00
BRISBANE,2009,4,161297,173044,334341,2009-04-01T00:00:00
BRISBANE,2009,5,148025,155486,303511,2009-05-01T00:00:00
BRISBANE,2009,6,151730,172408,324138,2009-06-01T00:00:00
BRISBANE,2009,7,199264,172957,372221,2009-07-01T00:00:00
BRISBANE,2009,8,169620,183377,352997,2009-08-01T00:00:00
BRISBANE,2009,9,175337,183274,358611,2009-09-01T00:00:00
BRISBANE,2009,10,191678,172089,363767,2009-10-01T00:00:00
BRISBANE,2009,11,161768,173891,335659,2009-11-01T00:00:00
BRISBANE,2009,12,175947,202871,378818,2009-12-01T00:00:00
BRISBANE,2010,1,203308,173057,376365,2010-01-01T00:00:00
BRISBANE,2010,2,160009,147233,307242,2010-02-01T00:00:00
BRISBANE,2010,3,162490,168234,330724,2010-03-01T00:00:00
BRISBANE,2010,4,161473,166938,328411,2010-04-01T00:00:00
BRISBANE,2010,5,149297,158209,307506,2010-05-01T00:00:00
BRISBANE,2010,6,163393,187027,350420,2010-06-01T00:00:00
BRISBANE,2010,7,220390,188120,408510,2010-07-01T00:00:00
BRISBANE,2010,8,179247,194188,373435,2010-08-01T00:00:00
BRISBANE,2010,9,187251,193066,380317,2010-09-01T00:00:00
BRISBANE,2010,10,197989,178468,376457,2010-10-01T00:00:00
BRISBANE,2010,11,167586,178601,346187,2010-11-01T00:00:00
BRISBANE,2010,12,183545,213138,396683,2010-12-01T00:00:00
BRISBANE,2011,1,216100,179977,396077,2011-01-01T00:00:00
BRISBANE,2011,2,160230,146869,307099,2011-02-01T00:00:00
BRISBANE,2011,3,155406,155471,310877,2011-03-01T00:00:00
BRISBANE,2011,4,170423,184505,354928,2011-04-01T00:00:00
BRISBANE,2011,5,165542,168888,334430,2011-05-01T00:00:00
BRISBANE,2011,6,166624,189150,355774,2011-06-01T00:00:00
BRISBANE,2011,7,230003,191645,421648,2011-07-01T00:00:00
BRISBANE,2011,8,186412,198789,385201,2011-08-01T00:00:00
BRISBANE,2011,9,191295,200297,391592,2011-09-01T00:00:00
BRISBANE,2011,10,216988,183402,400390,2011-10-01T00:00:00
BRISBANE,2011,11,177310,187609,364919,2011-11-01T00:00:00
BRISBANE,2011,12,196012,225920,421932,2011-12-01T00:00:00
BRISBANE,2012,1,230713,186380,417093,2012-01-01T00:00:00
BRISBANE,2012,2,171310,151617,322927,2012-02-01T00:00:00
BRISBANE,2012,3,169085,171101,340186,2012-03-01T00:00:00
BRISBANE,2012,4,180955,181959,362914,2012-04-01T00:00:00
BRISBANE,2012,5,157384,162873,320257,2012-05-01T00:00:00
BRISBANE,2012,6,178946,191999,370945,2012-06-01T00:00:00
BRISBANE,2012,7,220763,184288,405051,2012-07-01T00:00:00
BRISBANE,2012,8,183399,190788,374187,2012-08-01T00:00:00
BRISBANE,2012,9,191827,196811,388638,2012-09-01T00:00:00
BRISBANE,2012,10,212706,180386,393092,2012-10-01T00:00:00
BRISBANE,2012,11,175100,184029,359129,2012-11-01T00:00:00
BRISBANE,2012,12,200049,216945,416994,2012-12-01T00:00:00
BRISBANE,2013,1,222033,181468,403501,2013-01-01T00:00:00
BRISBANE,2013,2,176148,156465,332613,2013-02-01T00:00:00
BRISBANE,2013,3,180132,184082,364214,2013-03-01T00:00:00
BRISBANE,2013,4,183072,174775,357847,2013-04-01T00:00:00
BRISBANE,2013,5,166381,173192,339573,2013-05-01T00:00:00
BRISBANE,2013,6,186576,201564,388140,2013-06-01T00:00:00
BRISBANE,2013,7,234492,190947,425439,2013-07-01T00:00:00
BRISBANE,2013,8,202091,209981,412072,2013-08-01T00:00:00
BRISBANE,2013,9,203232,209090,412322,2013-09-01T00:00:00
BRISBANE,2013,10,225003,188766,413769,2013-10-01T00:00:00
BRISBANE,2013,11,184757,192166,376923,2013-11-01T00:00:00
BRISBANE,2013,12,209001,233727,442728,2013-12-01T00:00:00
BRISBANE,2014,1,243665,197869,441534,2014-01-01T00:00:00
BRISBANE,2014,2,184183,168744,352927,2014-02-01T00:00:00
BRISBANE,2014,3,182017,180736,362753,2014-03-01T00:00:00
BRISBANE,2014,4,203052,203842,406894,2014-04-01T00:00:00
BRISBANE,2014,5,181007,186442,367449,2014-05-01T00:00:00
BRISBANE,2014,6,185947,207236,393183,2014-06-01T00:00:00
BRISBANE,2014,7,247977,207772,455749,2014-07-01T00:00:00
BRISBANE,2014,8,213173,223083,436256,2014-08-01T00:00:00
BRISBANE,2014,9,216209,214891,431100,2014-09-01T00:00:00
BRISBANE,2014,10,234133,204479,438612,2014-10-01T00:00:00
BRISBANE,2014,11,197992,207211,405203,2014-11-01T00:00:00
BRISBANE,2014,12,221355,251966,473321,2014-12-01T00:00:00
BRISBANE,2015,1,259107,217528,476635,2015-01-01T00:00:00
BRISBANE,2015,2,204702,186053,390755,2015-02-01T00:00:00
BRISBANE,2015,3,205557,209665,415222,2015-03-01T00:00:00
BRISBANE,2015,4,205882,212965,418847,2015-04-01T00:00:00
BRISBANE,2015,5,189075,198431,387506,2015-05-01T00:00:00
BRISBANE,2015,6,194338,219792,414130,2015-06-01T00:00:00
BRISBANE,2015,7,246477,216603,463080,2015-07-01T00:00:00
BRISBANE,2015,8,217948,232266,450214,2015-08-01T00:00:00
BRISBANE,2015,9,222465,226764,449229,2015-09-01T00:00:00
BRISBANE,2015,10,242288,216271,458559,2015-10-01T00:00:00
BRISBANE,2015,11,202450,210900,413350,2015-11-01T00:00:00
BRISBANE,2015,12,232652,268343,500995,2015-12-01T00:00:00
BRISBANE,2016,1,272608,233848,506456,2016-01-01T00:00:00
BRISBANE,2016,2,212385,196486,408871,2016-02-01T00:00:00
BRISBANE,2016,3,207898,219618,427516,2016-03-01T00:00:00
BRISBANE,2016,4,212414,207393,419807,2016-04-01T00:00:00
BRISBANE,2016,5,192720,200906,393626,2016-05-01T00:00:00
BRISBANE,2016,6,201824,228594,430418,2016-06-01T00:00:00
BRISBANE,2016,7,265175,226192,491367,2016-07-01T00:00:00
BRISBANE,2016,8,221238,238799,460037,2016-08-01T00:00:00
BRISBANE,2016,9,235700,237262,472962,2016-09-01T00:00:00
BRISBANE,2016,10,251916,231523,483439,2016-10-01T00:00:00
BRISBANE,2016,11,212287,226400,438687,2016-11-01T00:00:00
BRISBANE,2016,12,242936,273622,516558,2016-12-01T00:00:00
BRISBANE,2017,1,280306,243488,523794,2017-01-01T00:00:00
BRISBANE,2017,2,217270,195290,412560,2017-02-01T00:00:00
BRISBANE,2017,3,215447,224530,439977,2017-03-01T00:00:00
BRISBANE,2017,4,236642,240158,476800,2017-04-01T00:00:00
BRISBANE,2017,5,207596,219433,427029,2017-05-01T00:00:00
BRISBANE,2017,6,216431,240442,456873,2017-06-01T00:00:00
BRISBANE,2017,7,272272,237677,509949,2017-07-01T00:00:00
BRISBANE,2017,8,233723,250234,483957,2017-08-01T00:00:00
BRISBANE,2017,9,245888,248264,494152,2017-09-01T00:00:00
BRISBANE,2017,10,260136,234779,494915,2017-10-01T00:00:00
BRISBANE,2017,11,222363,235437,457800,2017-11-01T00:00:00
BRISBANE,2017,12,257004,294531,551535,2017-12-01T00:00:00
BRISBANE,2018,1,296079,248966,545045,2018-01-01T00:00:00
BRISBANE,2018,2,231627,211703,443330,2018-02-01T00:00:00
BRISBANE,2018,3,241454,245843,487297,2018-03-01T00:00:00
BRISBANE,2018,4,243330,247399,490729,2018-04-01T00:00:00
BRISBANE,2018,5,222438,234141,456579,2018-05-01T00:00:00
BRISBANE,2018,6,230782,257206,487988,2018-06-01T00:00:00
BRISBANE,2018,7,297336,255284,552620,2018-07-01T00:00:00
BRISBANE,2018,8,256833,277712,534545,2018-08-01T00:00:00
BRISBANE,2018,9,257304,271474,528778,2018-09-01T00:00:00
BRISBANE,2018,10,284433,248094,532527,2018-10-01T00:00:00
BRISBANE,2018,11,231942,246721,478663,2018-11-01T00:00:00
BRISBANE,2018,12,265519,308614,574133,2018-12-01T00:00:00
BRISBANE,2019,1,317314,268620,585934,2019-01-01T00:00:00
BRISBANE,2019,2,242960,216993,459953,2019-02-01T00:00:00
BRISBANE,2019,3,236208,242477,478685,2019-03-01T00:00:00
BRISBANE,2019,4,253286,268696,521982,2019-04-01T00:00:00
BRISBANE,2019,5,239373,246644,486017,2019-05-01T00:00:00
BRISBANE,2019,6,242225,271760,513985,2019-06-01T00:00:00
BRISBANE,2019,7,313718,267968,581686,2019-07-01T00:00:00
BRISBANE,2019,8,272091,295442,567533,2019-08-01T00:00:00
BRISBANE,2019,9,262254,278326,540580,2019-09-01T00:00:00
BRISBANE,2019,10,295301,259813,555114,2019-10-01T00:00:00
BRISBANE,2019,11,255212,266720,521932,2019-11-01T00:00:00
BRISBANE,2019,12,284412,327751,612163,2019-12-01T00:00:00
BRISBANE,2020,1,333471,283668,617139,2020-01-01T00:00:00
BRISBANE,2020,2,223875,197282,421157,2020-02-01T00:00:00
BRISBANE,2020,3,138690,125177,263867,2020-03-01T00:00:00
BRISBANE,2020,4,2379,6582,8961,2020-04-01T00:00:00
BRISBANE,2020,5,1809,2679,4488,2020-05-01T00:00:00
BRISBANE,2020,6,4496,5537,10033,2020-06-01T00:00:00
BRISBANE,2020,7,3985,7081,11066,2020-07-01T00:00:00
BRISBANE,2020,8,2853,8057,10910,2020-08-01T00:00:00
BRISBANE,2020,9,2123,5762,7885,2020-09-01T00:00:00
BRISBANE,2020,10,5315,7184,12499,2020-10-01T00:00:00
BRISBANE,2020,11,4601,4844,9445,2020-11-01T00:00:00
BRISBANE,2020,12,5302,5539,10841,2020-12-01T00:00:00
BRISBANE,2021,1,4659,5284,9943,2021-01-01T00:00:00
BRISBANE,2021,2,4586,4144,8730,2021-02-01T00:00:00
BRISBANE,2021,3,6444,3936,10380,2021-03-01T00:00:00
BRISBANE,2021,4,9980,11642,21622,2021-04-01T00:00:00
BRISBANE,2021,5,25723,22710,48433,2021-05-01T00:00:00
BRISBANE,2021,6,28021,24882,52903,2021-06-01T00:00:00
BRISBANE,2021,7,19956,21025,40981,2021-07-01T00:00:00
BRISBANE,2021,8,5549,4909,10458,2021-08-01T00:00:00
BRISBANE,2021,9,3420,4240,7660,2021-09-01T00:00:00
BRISBANE,2021,10,3399,4891,8290,2021-10-01T00:00:00
BRISBANE,2021,11,2578,7419,9997,2021-11-01T00:00:00
BRISBANE,2021,12,4454,14148,18602,2021-12-01T00:00:00
BRISBANE,2022,1,13581,11602,25183,2022-01-01T00:00:00
BRISBANE,2022,2,29642,16900,46542,2022-02-01T00:00:00
BRISBANE,2022,3,44992,40392,85384,2022-03-01T00:00:00
BRISBANE,2022,4,75699,78551,154250,2022-04-01T00:00:00
BRISBANE,2022,5,84015,90484,174499,2022-05-01T00:00:00
BRISBANE,2022,6,96894,110899,207793,2022-06-01T00:00:00
BRISBANE,2022,7,141980,131641,273621,2022-07-01T00:00:00
BRISBANE,2022,8,139711,135646,275357,2022-08-01T00:00:00
BRISBANE,2022,9,147935,143906,291841,2022-09-01T00:00:00
BRISBANE,2022,10,164173,145909,310082,2022-10-01T00:00:00
BRISBANE,2022,11,160209,164470,324679,2022-11-01T00:00:00
BRISBANE,2022,12,168050,192056,360106,2022-12-01T00:00:00
BRISBANE,2023,1,202387,175332,377719,2023-01-01T00:00:00
BRISBANE,2023,2,165788,148389,314177,2023-02-01T00:00:00
BRISBANE,2023,3,173754,173503,347257,2023-03-01T00:00:00
BRISBANE,2023,4,177699,184288,361987,2023-04-01T00:00:00
BRISBANE,2023,5,173763,180078,353841,2023-05-01T00:00:00
BRISBANE,2023,6,190044,207687,397731,2023-06-01T00:00:00
BRISBANE,2023,7,225371,206945,432316,2023-07-01T00:00:00
BRISBANE,2023,8,207038,215279,422317,2023-08-01T00:00:00
BRISBANE,2023,9,217038,216383,433421,2023-09-01T00:00:00
BRISBANE,2023,10,225733,208142,433875,2023-10-01T00:00:00
BRISBANE,2023,11,213208,227229,440437,2023-11-01T00:00:00
BRISBANE,2023,12,249928,280462,530390,2023-12-01T00:00:00
BRISBANE,2024,1,284827,238356,523183,2024-01-01T00:00:00
BRISBANE,2024,2,241020,221717,462737,2024-02-01T00:00:00
BRISBANE,2024,3,240810,249842,490652,2024-03-01T00:00:00
BRISBANE,2024,4,233829,234502,468331,2024-04-01T00:00:00
BRISBANE,2024,5,221626,231012,452638,2024-05-01T00:00:00
BRISBANE,2024,6,234534,252607,487141,2024-06-01T00:00:00
BRISBANE,2024,7,279427,244221,523648,2024-07-01T00:00:00
BRISBANE,2024,8,248309,263879,512188,2024-08-01T00:00:00
BRISBANE,2024,9,260420,267838,528258,2024-09-01T00:00:00
BRISBANE,2024,10,278725,258579,537304,2024-10-01T00:00:00
BRISBANE,2024,11,257240,275082,532322,2024-11-01T00:00:00
BRISBANE,2024,12,292785,335351,628136,2024-12-01T00:00:00
BRISBANE,2025,1,344059,293588,637647,2025-01-01T00:00:00
BRISBANE,2025,2,262101,233161,495262,2025-02-01T00:00:00
BRISBANE,2025,3,241768,245700,487468,2025-03-01T00:00:00
BRISBANE,2025,4,268046,284719,552765,2025-04-01T00:00:00
BRISBANE,2025,5,261414,262439,523853,2025-05-01T00:00:00
BRISBANE,2025,6,263642,281568,545210,2025-06-01T00:00:00
CAIRNS,1985,1,1683,1329,3012,1985-01-01T00:00:00
CAIRNS,1985,2,1023,1238,2261,1985-02-01T00:00:00
CAIRNS,1985,3,1407,1383,2790,1985-03-01T00:00:00
CAIRNS,1985,4,2161,1442,3603,1985-04-01T00:00:00
CAIRNS,1985,5,1401,1843,3244,1985-05-01T00:00:00
CAIRNS,1985,6,2227,1594,3821,1985-06-01T00:00:00
CAIRNS,1985,7,2382,1957,4339,1985-07-01T00:00:00
CAIRNS,1985,8,2691,2243,4934,1985-08-01T00:00:00
CAIRNS,1985,9,2132,1488,3620,1985-09-01T00:00:00
CAIRNS,1985,10,2928,1471,4399,1985-10-01T00:00:00
CAIRNS,1985,11,3230,2229,5459,1985-11-01T00:00:00
CAIRNS,1985,12,2195,1845,4040,1985-12-01T00:00:00
CAIRNS,1986,1,2725,2392,5117,1986-01-01T00:00:00
CAIRNS,1986,2,1657,1605,3262,1986-02-01T00:00:00
CAIRNS,1986,3,2105,2088,4193,1986-03-01T00:00:00
CAIRNS,1986,4,2876,2365,5241,1986-04-01T00:00:00
CAIRNS,1986,5,1882,2266,4148,1986-05-01T00:00:00
CAIRNS,1986,6,2782,2115,4897,1986-06-01T00:00:00
CAIRNS,1986,7,3583,3073,6656,1986-07-01T00:00:00
CAIRNS,1986,8,3095,2895,5990,1986-08-01T00:00:00
CAIRNS,1986,9,3157,2093,5250,1986-09-01T00:00:00
CAIRNS,1986,10,3935,2598,6533,1986-10-01T00:00:00
CAIRNS,1986,11,3415,2756,6171,1986-11-01T00:00:00
CAIRNS,1986,12,3316,2639,5955,1986-12-01T00:00:00
CAIRNS,1987,1,4302,3241,7543,1987-01-01T00:00:00
CAIRNS,1987,2,2812,2928,5740,1987-02-01T00:00:00
CAIRNS,1987,3,2525,2427,4952,1987-03-01T00:00:00
CAIRNS,1987,4,5406,4517,9923,1987-04-01T00:00:00
CAIRNS,1987,5,4251,4090,8341,1987-05-01T00:00:00
CAIRNS,1987,6,5347,3979,9326,1987-06-01T00:00:00
CAIRNS,1987,7,5957,5187,11144,1987-07-01T00:00:00
CAIRNS,1987,8,4757,4797,9554,1987-08-01T00:00:00
CAIRNS,1987,9,5559,4713,10272,1987-09-01T00:00:00
CAIRNS,1987,10,7435,4650,12085,1987-10-01T00:00:00
CAIRNS,1987,11,6466,4839,11305,1987-11-01T00:00:00
CAIRNS,1987,12,5456,4648,10104,1987-12-01T00:00:00
CAIRNS,1988,1,5930,4748,10678,1988-01-01T00:00:00
CAIRNS,1988,2,4961,3959,8920,1988-02-01T00:00:00
CAIRNS,1988,3,5353,5196,10549,1988-03-01T00:00:00
CAIRNS,1988,4,5673,5050,10723,1988-04-01T00:00:00
CAIRNS,1988,5,5680,5520,11200,1988-05-01T00:00:00
CAIRNS,1988,6,7904,5649,13553,1988-06-01T00:00:00
CAIRNS,1988,7,8186,6248,14434,1988-07-01T00:00:00
CAIRNS,1988,8,8581,8426,17007,1988-08-01T00:00:00
CAIRNS,1988,9,8488,6645,15133,1988-09-01T00:00:00
CAIRNS,1988,10,8334,6711,15045,1988-10-01T00:00:00
CAIRNS,1988,11,8676,7756,16432,1988-11-01T00:00:00
CAIRNS,1988,12,9045,7076,16121,1988-12-01T00:00:00
CAIRNS,1989,1,9637,9132,18769,1989-01-01T00:00:00
CAIRNS,1989,2,8068,6423,14491,1989-02-01T00:00:00
CAIRNS,1989,3,7653,7938,15591,1989-03-01T00:00:00
CAIRNS,1989,4,7840,7909,15749,1989-04-01T00:00:00
CAIRNS,1989,5,6892,7800,14692,1989-05-01T00:00:00
CAIRNS,1989,6,9172,6910,16082,1989-06-01T00:00:00
CAIRNS,1989,7,12392,9649,22041,1989-07-01T00:00:00
CAIRNS,1989,8,11575,11110,22685,1989-08-01T00:00:00
CAIRNS,1989,9,9944,8714,18658,1989-09-01T00:00:00
CAIRNS,1989,10,10510,8580,19090,1989-10-01T00:00:00
CAIRNS,1989,11,8864,7824,16688,1989-11-01T00:00:00
CAIRNS,1989,12,9725,8387,18112,1989-12-01T00:00:00
CAIRNS,1990,1,12292,10662,22954,1990-01-01T00:00:00
CAIRNS,1990,2,9530,8477,18007,1990-02-01T00:00:00
CAIRNS,1990,3,9951,10505,20456,1990-03-01T00:00:00
CAIRNS,1990,4,9974,10280,20254,1990-04-01T00:00:00
CAIRNS,1990,5,9794,10724,20518,1990-05-01T00:00:00
CAIRNS,1990,6,11394,9505,20899,1990-06-01T00:00:00
CAIRNS,1990,7,14120,11951,26071,1990-07-01T00:00:00
CAIRNS,1990,8,14118,13939,28057,1990-08-01T00:00:00
CAIRNS,1990,9,12313,12653,24966,1990-09-01T00:00:00
CAIRNS,1990,10,13556,10585,24141,1990-10-01T00:00:00
CAIRNS,1990,11,13230,12737,25967,1990-11-01T00:00:00
CAIRNS,1990,12,14458,12588,27046,1990-12-01T00:00:00
CAIRNS,1991,1,15375,15169,30544,1991-01-01T00:00:00
CAIRNS,1991,2,11649,10246,21895,1991-02-01T00:00:00
CAIRNS,1991,3,13679,13302,26981,1991-03-01T00:00:00
CAIRNS,1991,4,12855,12348,25203,1991-04-01T00:00:00
CAIRNS,1991,5,15329,15171,30500,1991-05-01T00:00:00
CAIRNS,1991,6,20061,17128,37189,1991-06-01T00:00:00
CAIRNS,1991,7,19918,18339,38257,1991-07-01T00:00:00
CAIRNS,1991,8,16961,18079,35040,1991-08-01T00:00:00
CAIRNS,1991,9,16527,15898,32425,1991-09-01T00:00:00
CAIRNS,1991,10,16476,14836,31312,1991-10-01T00:00:00
CAIRNS,1991,11,16970,16343,33313,1991-11-01T00:00:00
CAIRNS,1991,12,20595,16720,37315,1991-12-01T00:00:00
CAIRNS,1992,1,19595,18815,38410,1992-01-01T00:00:00
CAIRNS,1992,2,16197,14747,30944,1992-02-01T00:00:00
CAIRNS,1992,3,16689,17098,33787,1992-03-01T00:00:00
CAIRNS,1992,4,20165,17392,37557,1992-04-01T00:00:00
CAIRNS,1992,5,22048,19384,41432,1992-05-01T00:00:00
CAIRNS,1992,6,25235,20797,46032,1992-06-01T00:00:00
CAIRNS,1992,7,29118,23191,52309,1992-07-01T00:00:00
CAIRNS,1992,8,26273,24618,50891,1992-08-01T00:00:00
CAIRNS,1992,9,23342,20995,44337,1992-09-01T00:00:00
CAIRNS,1992,10,27307,16945,44252,1992-10-01T00:00:00
CAIRNS,1992,11,28556,22819,51375,1992-11-01T00:00:00
CAIRNS,1992,12,32401,22486,54887,1992-12-01T00:00:00
CAIRNS,1993,1,31617,27078,58695,1993-01-01T00:00:00
CAIRNS,1993,2,26095,19603,45698,1993-02-01T00:00:00
CAIRNS,1993,3,23672,24359,48031,1993-03-01T00:00:00
CAIRNS,1993,4,24217,20806,45023,1993-04-01T00:00:00
CAIRNS,1993,5,27450,23537,50987,1993-05-01T00:00:00
CAIRNS,1993,6,29986,23676,53662,1993-06-01T00:00:00
CAIRNS,1993,7,31461,26000,57461,1993-07-01T00:00:00
CAIRNS,1993,8,32195,32128,64323,1993-08-01T00:00:00
CAIRNS,1993,9,27573,23783,51356,1993-09-01T00:00:00
CAIRNS,1993,10,32766,23618,56384,1993-10-01T00:00:00
CAIRNS,1993,11,31873,24373,56246,1993-11-01T00:00:00
CAIRNS,1993,12,37256,26315,63571,1993-12-01T00:00:00
CAIRNS,1994,1,33668,29828,63496,1994-01-01T00:00:00
CAIRNS,1994,2,34183,23984,58167,1994-02-01T00:00:00
CAIRNS,1994,3,32101,28370,60471,1994-03-01T00:00:00
CAIRNS,1994,4,27534,22088,49622,1994-04-01T00:00:00
CAIRNS,1994,5,27912,24232,52144,1994-05-01T00:00:00
CAIRNS,1994,6,31364,23510,54874,1994-06-01T00:00:00
CAIRNS,1994,7,31988,26048,58036,1994-07-01T00:00:00
CAIRNS,1994,8,32717,36287,69004,1994-08-01T00:00:00
CAIRNS,1994,9,25303,25074,50377,1994-09-01T00:00:00
CAIRNS,1994,10,29723,24847,54570,1994-10-01T00:00:00
CAIRNS,1994,11,26115,24753,50868,1994-11-01T00:00:00
CAIRNS,1994,12,33156,24490,57646,1994-12-01T00:00:00
CAIRNS,1995,1,29904,30614,60518,1995-01-01T00:00:00
CAIRNS,1995,2,23832,21971,45803,1995-02-01T00:00:00
CAIRNS,1995,3,25513,26678,52191,1995-03-01T00:00:00
CAIRNS,1995,4,23163,22810,45973,1995-04-01T00:00:00
CAIRNS,1995,5,21897,26443,48340,1995-05-01T00:00:00
CAIRNS,1995,6,24090,23961,48051,1995-06-01T00:00:00
CAIRNS,1995,7,30610,27929,58539,1995-07-01T00:00:00
CAIRNS,1995,8,33045,39441,72486,1995-08-01T00:00:00
CAIRNS,1995,9,24247,27552,51799,1995-09-01T00:00:00
CAIRNS,1995,10,28282,25170,53452,1995-10-01T00:00:00
CAIRNS,1995,11,27454,29454,56908,1995-11-01T00:00:00
CAIRNS,1995,12,36612,27725,64337,1995-12-01T00:00:00
CAIRNS,1996,1,30383,34522,64905,1996-01-01T00:00:00
CAIRNS,1996,2,31926,27500,59426,1996-02-01T00:00:00
CAIRNS,1996,3,28282,30739,59021,1996-03-01T00:00:00
CAIRNS,1996,4,24457,25328,49785,1996-04-01T00:00:00
CAIRNS,1996,5,22935,26410,49345,1996-05-01T00:00:00
CAIRNS,1996,6,27475,27172,54647,1996-06-01T00:00:00
CAIRNS,1996,7,32453,29758,62211,1996-07-01T00:00:00
CAIRNS,1996,8,33840,38961,72801,1996-08-01T00:00:00
CAIRNS,1996,9,30631,30371,61002,1996-09-01T00:00:00
CAIRNS,1996,10,30954,27523,58477,1996-10-01T00:00:00
CAIRNS,1996,11,29871,28321,58192,1996-11-01T00:00:00
CAIRNS,1996,12,41360,28224,69584,1996-12-01T00:00:00
CAIRNS,1997,1,32539,35271,67810,1997-01-01T00:00:00
CAIRNS,1997,2,34380,29328,63708,1997-02-01T00:00:00
CAIRNS,1997,3,33010,32231,65241,1997-03-01T00:00:00
CAIRNS,1997,4,26845,28141,54986,1997-04-01T00:00:00
CAIRNS,1997,5,23866,25450,49316,1997-05-01T00:00:00
CAIRNS,1997,6,29619,27161,56780,1997-06-01T00:00:00
CAIRNS,1997,7,36984,32082,69066,1997-07-01T00:00:00
CAIRNS,1997,8,36031,41002,77033,1997-08-01T00:00:00
CAIRNS,1997,9,30718,31126,61844,1997-09-01T00:00:00
CAIRNS,1997,10,32609,28821,61430,1997-10-01T00:00:00
CAIRNS,1997,11,29527,31209,60736,1997-11-01T00:00:00
CAIRNS,1997,12,31897,25263,57160,1997-12-01T00:00:00
CAIRNS,1998,1,27675,31286,58961,1998-01-01T00:00:00
CAIRNS,1998,2,26265,26337,52602,1998-02-01T00:00:00
CAIRNS,1998,3,27306,27910,55216,1998-03-01T00:00:00
CAIRNS,1998,4,24192,26198,50390,1998-04-01T00:00:00
CAIRNS,1998,5,22471,24708,47179,1998-05-01T00:00:00
CAIRNS,1998,6,26771,26235,53006,1998-06-01T00:00:00
CAIRNS,1998,7,33275,31711,64986,1998-07-01T00:00:00
CAIRNS,1998,8,32697,37490,70187,1998-08-01T00:00:00
CAIRNS,1998,9,30545,31604,62149,1998-09-01T00:00:00
CAIRNS,1998,10,29962,28735,58697,1998-10-01T00:00:00
CAIRNS,1998,11,27752,30062,57814,1998-11-01T00:00:00
CAIRNS,1998,12,30858,26013,56871,1998-12-01T00:00:00
CAIRNS,1999,1,26400,30153,56553,1999-01-01T00:00:00
CAIRNS,1999,2,26675,23630,50305,1999-02-01T00:00:00
CAIRNS,1999,3,27752,28857,56609,1999-03-01T00:00:00
CAIRNS,1999,4,23264,27279,50543,1999-04-01T00:00:00
CAIRNS,1999,5,21519,25241,46760,1999-05-01T00:00:00
CAIRNS,1999,6,26436,25533,51969,1999-06-01T00:00:00
CAIRNS,1999,7,32252,29828,62080,1999-07-01T00:00:00
CAIRNS,1999,8,30593,34235,64828,1999-08-01T00:00:00
CAIRNS,1999,9,29077,28437,57514,1999-09-01T00:00:00
CAIRNS,1999,10,29302,27813,57115,1999-10-01T00:00:00
CAIRNS,1999,11,27079,28307,55386,1999-11-01T00:00:00
CAIRNS,1999,12,27073,23924,50997,1999-12-01T00:00:00
CAIRNS,2000,1,23591,24206,47797,2000-01-01T00:00:00
CAIRNS,2000,2,26080,23720,49800,2000-02-01T00:00:00
CAIRNS,2000,3,25976,28293,54269,2000-03-01T00:00:00
CAIRNS,2000,4,25685,25901,51586,2000-04-01T00:00:00
CAIRNS,2000,5,24323,27257,51580,2000-05-01T00:00:00
CAIRNS,2000,6,27172,25797,52969,2000-06-01T00:00:00
CAIRNS,2000,7,32551,30177,62728,2000-07-01T00:00:00
CAIRNS,2000,8,32279,35487,67766,2000-08-01T00:00:00
CAIRNS,2000,9,24942,27067,52009,2000-09-01T00:00:00
CAIRNS,2000,10,32754,29142,61896,2000-10-01T00:00:00
CAIRNS,2000,11,32630,32793,65423,2000-11-01T00:00:00
CAIRNS,2000,12,33287,29023,62310,2000-12-01T00:00:00
CAIRNS,2001,1,29986,29195,59181,2001-01-01T00:00:00
CAIRNS,2001,2,26454,24322,50776,2001-02-01T00:00:00
CAIRNS,2001,3,29354,29556,58910,2001-03-01T00:00:00
CAIRNS,2001,4,26027,27165,53192,2001-04-01T00:00:00
CAIRNS,2001,5,24651,27175,51826,2001-05-01T00:00:00
CAIRNS,2001,6,27756,27252,55008,2001-06-01T00:00:00
CAIRNS,2001,7,29037,28446,57483,2001-07-01T00:00:00
CAIRNS,2001,8,31795,34133,65928,2001-08-01T00:00:00
CAIRNS,2001,9,26640,27707,54347,2001-09-01T00:00:00
CAIRNS,2001,10,25650,24925,50575,2001-10-01T00:00:00
CAIRNS,2001,11,26151,26647,52798,2001-11-01T00:00:00
CAIRNS,2001,12,30451,24643,55094,2001-12-01T00:00:00
CAIRNS,2002,1,28140,28915,57055,2002-01-01T00:00:00
CAIRNS,2002,2,28950,25119,54069,2002-02-01T00:00:00
CAIRNS,2002,3,33218,31235,64453,2002-03-01T00:00:00
CAIRNS,2002,4,29253,29918,59171,2002-04-01T00:00:00
CAIRNS,2002,5,28581,30130,58711,2002-05-01T00:00:00
CAIRNS,2002,6,31758,29190,60948,2002-06-01T00:00:00
CAIRNS,2002,7,33028,31489,64517,2002-07-01T00:00:00
CAIRNS,2002,8,34601,38315,72916,2002-08-01T00:00:00
CAIRNS,2002,9,30969,32670,63639,2002-09-01T00:00:00
CAIRNS,2002,10,37340,32436,69776,2002-10-01T00:00:00
CAIRNS,2002,11,35324,36121,71445,2002-11-01T00:00:00
CAIRNS,2002,12,35910,33646,69556,2002-12-01T00:00:00
CAIRNS,2003,1,35904,34735,70639,2003-01-01T00:00:00
CAIRNS,2003,2,30925,30161,61086,2003-02-01T00:00:00
CAIRNS,2003,3,32065,34794,66859,2003-03-01T00:00:00
CAIRNS,2003,4,25439,27552,52991,2003-04-01T00:00:00
CAIRNS,2003,5,19872,20728,40600,2003-05-01T00:00:00
CAIRNS,2003,6,24576,23926,48502,2003-06-01T00:00:00
CAIRNS,2003,7,30875,27413,58288,2003-07-01T00:00:00
CAIRNS,2003,8,33926,34964,68890,2003-08-01T00:00:00
CAIRNS,2003,9,32204,33713,65917,2003-09-01T00:00:00
CAIRNS,2003,10,37089,32070,69159,2003-10-01T00:00:00
CAIRNS,2003,11,36673,35911,72584,2003-11-01T00:00:00
CAIRNS,2003,12,36271,34775,71046,2003-12-01T00:00:00
CAIRNS,2004,1,36512,33924,70436,2004-01-01T00:00:00
CAIRNS,2004,2,31776,28575,60351,2004-02-01T00:00:00
CAIRNS,2004,3,33226,32978,66204,2004-03-01T00:00:00
CAIRNS,2004,4,33354,32588,65942,2004-04-01T00:00:00
CAIRNS,2004,5,32391,33545,65936,2004-05-01T00:00:00
CAIRNS,2004,6,33390,32658,66048,2004-06-01T00:00:00
CAIRNS,2004,7,38695,33214,71909,2004-07-01T00:00:00
CAIRNS,2004,8,36293,41467,77760,2004-08-01T00:00:00
CAIRNS,2004,9,37392,35464,72856,2004-09-01T00:00:00
CAIRNS,2004,10,40935,37819,78754,2004-10-01T00:00:00
CAIRNS,2004,11,39793,39791,79584,2004-11-01T00:00:00
CAIRNS,2004,12,36863,34203,71066,2004-12-01T00:00:00
CAIRNS,2005,1,39113,37860,76973,2005-01-01T00:00:00
CAIRNS,2005,2,33076,33019,66095,2005-02-01T00:00:00
CAIRNS,2005,3,38099,38431,76530,2005-03-01T00:00:00
CAIRNS,2005,4,29976,30847,60823,2005-04-01T00:00:00
CAIRNS,2005,5,28700,33264,61964,2005-05-01T00:00:00
CAIRNS,2005,6,33002,30829,63831,2005-06-01T00:00:00
CAIRNS,2005,7,38578,33760,72338,2005-07-01T00:00:00
CAIRNS,2005,8,37629,43419,81048,2005-08-01T00:00:00
CAIRNS,2005,9,38153,37265,75418,2005-09-01T00:00:00
CAIRNS,2005,10,38776,35016,73792,2005-10-01T00:00:00
CAIRNS,2005,11,38753,38455,77208,2005-11-01T00:00:00
CAIRNS,2005,12,39929,36235,76164,2005-12-01T00:00:00
CAIRNS,2006,1,40753,37480,78233,2006-01-01T00:00:00
CAIRNS,2006,2,33353,32784,66137,2006-02-01T00:00:00
CAIRNS,2006,3,35895,36073,71968,2006-03-01T00:00:00
CAIRNS,2006,4,30899,31554,62453,2006-04-01T00:00:00
CAIRNS,2006,5,28134,30388,58522,2006-05-01T00:00:00
CAIRNS,2006,6,31871,30797,62668,2006-06-01T00:00:00
CAIRNS,2006,7,31715,28879,60594,2006-07-01T00:00:00
CAIRNS,2006,8,33113,36214,69327,2006-08-01T00:00:00
CAIRNS,2006,9,33115,33425,66540,2006-09-01T00:00:00
CAIRNS,2006,10,35112,31890,67002,2006-10-01T00:00:00
CAIRNS,2006,11,32947,32541,65488,2006-11-01T00:00:00
CAIRNS,2006,12,32552,30225,62777,2006-12-01T00:00:00
CAIRNS,2007,1,31947,31554,63501,2007-01-01T00:00:00
CAIRNS,2007,2,31309,27251,58560,2007-02-01T00:00:00
CAIRNS,2007,3,30931,31172,62103,2007-03-01T00:00:00
CAIRNS,2007,4,24694,25400,50094,2007-04-01T00:00:00
CAIRNS,2007,5,23019,25929,48948,2007-05-01T00:00:00
CAIRNS,2007,6,28136,26594,54730,2007-06-01T00:00:00
CAIRNS,2007,7,32162,28765,60927,2007-07-01T00:00:00
CAIRNS,2007,8,32731,34249,66980,2007-08-01T00:00:00
CAIRNS,2007,9,28902,31021,59923,2007-09-01T00:00:00
CAIRNS,2007,10,32098,29828,61926,2007-10-01T00:00:00
CAIRNS,2007,11,30043,29487,59530,2007-11-01T00:00:00
CAIRNS,2007,12,27776,27050,54826,2007-12-01T00:00:00
CAIRNS,2008,1,27273,27304,54577,2008-01-01T00:00:00
CAIRNS,2008,2,27046,23068,50114,2008-02-01T00:00:00
CAIRNS,2008,3,27253,26655,53908,2008-03-01T00:00:00
CAIRNS,2008,4,21768,23184,44952,2008-04-01T00:00:00
CAIRNS,2008,5,22058,22571,44629,2008-05-01T00:00:00
CAIRNS,2008,6,21931,21696,43627,2008-06-01T00:00:00
CAIRNS,2008,7,26328,23019,49347,2008-07-01T00:00:00
CAIRNS,2008,8,28985,31144,60129,2008-08-01T00:00:00
CAIRNS,2008,9,24527,26023,50550,2008-09-01T00:00:00
CAIRNS,2008,10,28320,24734,53054,2008-10-01T00:00:00
CAIRNS,2008,11,24266,24527,48793,2008-11-01T00:00:00
CAIRNS,2008,12,20631,21150,41781,2008-12-01T00:00:00
CAIRNS,2009,1,18537,16984,35521,2009-01-01T00:00:00
CAIRNS,2009,2,15352,14234,29586,2009-02-01T00:00:00
CAIRNS,2009,3,18198,17539,35737,2009-03-01T00:00:00
CAIRNS,2009,4,16231,15879,32110,2009-04-01T00:00:00
CAIRNS,2009,5,14333,15001,29334,2009-05-01T00:00:00
CAIRNS,2009,6,14746,14498,29244,2009-06-01T00:00:00
CAIRNS,2009,7,17755,16377,34132,2009-07-01T00:00:00
CAIRNS,2009,8,18813,19954,38767,2009-08-01T00:00:00
CAIRNS,2009,9,18699,18824,37523,2009-09-01T00:00:00
CAIRNS,2009,10,18559,17194,35753,2009-10-01T00:00:00
CAIRNS,2009,11,16111,16589,32700,2009-11-01T00:00:00
CAIRNS,2009,12,18047,16349,34396,2009-12-01T00:00:00
CAIRNS,2010,1,16968,16811,33779,2010-01-01T00:00:00
CAIRNS,2010,2,18708,15744,34452,2010-02-01T00:00:00
CAIRNS,2010,3,18641,18119,36760,2010-03-01T00:00:00
CAIRNS,2010,4,19035,19013,38048,2010-04-01T00:00:00
CAIRNS,2010,5,16586,18067,34653,2010-05-01T00:00:00
CAIRNS,2010,6,17905,18512,36417,2010-06-01T00:00:00
CAIRNS,2010,7,24341,20546,44887,2010-07-01T00:00:00
CAIRNS,2010,8,24728,27474,52202,2010-08-01T00:00:00
CAIRNS,2010,9,24691,24656,49347,2010-09-01T00:00:00
CAIRNS,2010,10,23636,21613,45249,2010-10-01T00:00:00
CAIRNS,2010,11,22274,22039,44313,2010-11-01T00:00:00
CAIRNS,2010,12,22953,22813,45766,2010-12-01T00:00:00
CAIRNS,2011,1,22107,22050,44157,2011-01-01T00:00:00
CAIRNS,2011,2,18556,16331,34887,2011-02-01T00:00:00
CAIRNS,2011,3,19990,19163,39153,2011-03-01T00:00:00
CAIRNS,2011,4,18519,18859,37378,2011-04-01T00:00:00
CAIRNS,2011,5,17356,18504,35860,2011-05-01T00:00:00
CAIRNS,2011,6,19085,18693,37778,2011-06-01T00:00:00
CAIRNS,2011,7,26916,22192,49108,2011-07-01T00:00:00
CAIRNS,2011,8,25287,27519,52806,2011-08-01T00:00:00
CAIRNS,2011,9,23082,24708,47790,2011-09-01T00:00:00
CAIRNS,2011,10,23564,21727,45291,2011-10-01T00:00:00
CAIRNS,2011,11,19625,19528,39153,2011-11-01T00:00:00
CAIRNS,2011,12,20453,20258,40711,2011-12-01T00:00:00
CAIRNS,2012,1,20310,19523,39833,2012-01-01T00:00:00
CAIRNS,2012,2,19335,17247,36582,2012-02-01T00:00:00
CAIRNS,2012,3,20417,20853,41270,2012-03-01T00:00:00
CAIRNS,2012,4,19108,19012,38120,2012-04-01T00:00:00
CAIRNS,2012,5,17032,18281,35313,2012-05-01T00:00:00
CAIRNS,2012,6,18641,19582,38223,2012-06-01T00:00:00
CAIRNS,2012,7,24553,20007,44560,2012-07-01T00:00:00
CAIRNS,2012,8,25790,27104,52894,2012-08-01T00:00:00
CAIRNS,2012,9,22772,24224,46996,2012-09-01T00:00:00
CAIRNS,2012,10,23142,20398,43540,2012-10-01T00:00:00
CAIRNS,2012,11,23103,23068,46171,2012-11-01T00:00:00
CAIRNS,2012,12,23186,24671,47857,2012-12-01T00:00:00
CAIRNS,2013,1,23084,21479,44563,2013-01-01T00:00:00
CAIRNS,2013,2,21829,20189,42018,2013-02-01T00:00:00
CAIRNS,2013,3,21533,21190,42723,2013-03-01T00:00:00
CAIRNS,2013,4,18953,18806,37759,2013-04-01T00:00:00
CAIRNS,2013,5,15953,17390,33343,2013-05-01T00:00:00
CAIRNS,2013,6,16920,18395,35315,2013-06-01T00:00:00
CAIRNS,2013,7,24150,19409,43559,2013-07-01T00:00:00
CAIRNS,2013,8,24696,27564,52260,2013-08-01T00:00:00
CAIRNS,2013,9,20101,21374,41475,2013-09-01T00:00:00
CAIRNS,2013,10,22144,18929,41073,2013-10-01T00:00:00
CAIRNS,2013,11,17798,18220,36018,2013-11-01T00:00:00
CAIRNS,2013,12,20333,21652,41985,2013-12-01T00:00:00
CAIRNS,2014,1,23911,20221,44132,2014-01-01T00:00:00
CAIRNS,2014,2,20129,19117,39246,2014-02-01T00:00:00
CAIRNS,2014,3,19065,18792,37857,2014-03-01T00:00:00
CAIRNS,2014,4,14670,16394,31064,2014-04-01T00:00:00
CAIRNS,2014,5,13715,15252,28967,2014-05-01T00:00:00
CAIRNS,2014,6,15273,16675,31948,2014-06-01T00:00:00
CAIRNS,2014,7,23638,18074,41712,2014-07-01T00:00:00
CAIRNS,2014,8,23182,26286,49468,2014-08-01T00:00:00
CAIRNS,2014,9,19242,22088,41330,2014-09-01T00:00:00
CAIRNS,2014,10,21715,18589,40304,2014-10-01T00:00:00
CAIRNS,2014,11,16906,17259,34165,2014-11-01T00:00:00
CAIRNS,2014,12,19374,21343,40717,2014-12-01T00:00:00
CAIRNS,2015,1,22204,20752,42956,2015-01-01T00:00:00
CAIRNS,2015,2,24375,20661,45036,2015-02-01T00:00:00
CAIRNS,2015,3,19341,21334,40675,2015-03-01T00:00:00
CAIRNS,2015,4,18491,19824,38315,2015-04-01T00:00:00
CAIRNS,2015,5,17628,19137,36765,2015-05-01T00:00:00
CAIRNS,2015,6,17394,19542,36936,2015-06-01T00:00:00
CAIRNS,2015,7,28199,23289,51488,2015-07-01T00:00:00
CAIRNS,2015,8,27312,30336,57648,2015-08-01T00:00:00
CAIRNS,2015,9,23846,26196,50042,2015-09-01T00:00:00
CAIRNS,2015,10,25590,23096,48686,2015-10-01T00:00:00
CAIRNS,2015,11,21836,23067,44903,2015-11-01T00:00:00
CAIRNS,2015,12,24899,27384,52283,2015-12-01T00:00:00
CAIRNS,2016,1,28354,25600,53954,2016-01-01T00:00:00
CAIRNS,2016,2,29128,28700,57828,2016-02-01T00:00:00
CAIRNS,2016,3,26429,29816,56245,2016-03-01T00:00:00
CAIRNS,2016,4,25976,25867,51843,2016-04-01T00:00:00
CAIRNS,2016,5,18986,22772,41758,2016-05-01T00:00:00
CAIRNS,2016,6,20267,23078,43345,2016-06-01T00:00:00
CAIRNS,2016,7,28946,24878,53824,2016-07-01T00:00:00
CAIRNS,2016,8,28342,33282,61624,2016-08-01T00:00:00
CAIRNS,2016,9,27185,29632,56817,2016-09-01T00:00:00
CAIRNS,2016,10,27703,26910,54613,2016-10-01T00:00:00
CAIRNS,2016,11,23821,26864,50685,2016-11-01T00:00:00
CAIRNS,2016,12,28437,31320,59757,2016-12-01T00:00:00
CAIRNS,2017,1,31070,29762,60832,2017-01-01T00:00:00
CAIRNS,2017,2,24322,24762,49084,2017-02-01T00:00:00
CAIRNS,2017,3,27174,30646,57820,2017-03-01T00:00:00
CAIRNS,2017,4,24815,27684,52499,2017-04-01T00:00:00
CAIRNS,2017,5,19798,24128,43926,2017-05-01T00:00:00
CAIRNS,2017,6,22086,24497,46583,2017-06-01T00:00:00
CAIRNS,2017,7,31200,26249,57449,2017-07-01T00:00:00
CAIRNS,2017,8,30565,36935,67500,2017-08-01T00:00:00
CAIRNS,2017,9,27687,28833,56520,2017-09-01T00:00:00
CAIRNS,2017,10,27636,27173,54809,2017-10-01T00:00:00
CAIRNS,2017,11,24211,27170,51381,2017-11-01T00:00:00
CAIRNS,2017,12,29556,34214,63770,2017-12-01T00:00:00
CAIRNS,2018,1,33610,29869,63479,2018-01-01T00:00:00
CAIRNS,2018,2,29756,28672,58428,2018-02-01T00:00:00
CAIRNS,2018,3,28706,30677,59383,2018-03-01T00:00:00
CAIRNS,2018,4,24471,25518,49989,2018-04-01T00:00:00
CAIRNS,2018,5,20491,23509,44000,2018-05-01T00:00:00
CAIRNS,2018,6,22089,23370,45459,2018-06-01T00:00:00
CAIRNS,2018,7,32402,27031,59433,2018-07-01T00:00:00
CAIRNS,2018,8,33261,36904,70165,2018-08-01T00:00:00
CAIRNS,2018,9,26298,27264,53562,2018-09-01T00:00:00
CAIRNS,2018,10,28446,26124,54570,2018-10-01T00:00:00
CAIRNS,2018,11,22546,22310,44856,2018-11-01T00:00:00
CAIRNS,2018,12,28415,30812,59227,2018-12-01T00:00:00
CAIRNS,2019,1,35119,28466,63585,2019-01-01T00:00:00
CAIRNS,2019,2,30795,25815,56610,2019-02-01T00:00:00
CAIRNS,2019,3,27643,27018,54661,2019-03-01T00:00:00
CAIRNS,2019,4,26308,26781,53089,2019-04-01T00:00:00
CAIRNS,2019,5,21257,24427,45684,2019-05-01T00:00:00
CAIRNS,2019,6,22586,22671,45257,2019-06-01T00:00:00
CAIRNS,2019,7,32703,26768,59471,2019-07-01T00:00:00
CAIRNS,2019,8,31853,35300,67153,2019-08-01T00:00:00
CAIRNS,2019,9,27488,27903,55391,2019-09-01T00:00:00
CAIRNS,2019,10,29088,24945,54033,2019-10-01T00:00:00
CAIRNS,2019,11,21997,22149,44146,2019-11-01T00:00:00
CAIRNS,2019,12,25408,27336,52744,2019-12-01T00:00:00
CAIRNS,2020,1,28638,24465,53103,2020-01-01T00:00:00
CAIRNS,2020,2,24070,19120,43190,2020-02-01T00:00:00
CAIRNS,2020,3,10976,10079,21055,2020-03-01T00:00:00
CAIRNS,2020,4,30,24,54,2020-04-01T00:00:00
CAIRNS,2020,5,37,55,92,2020-05-01T00:00:00
CAIRNS,2020,6,102,144,246,2020-06-01T00:00:00
CAIRNS,2020,7,53,72,125,2020-07-01T00:00:00
CAIRNS,2020,8,79,58,137,2020-08-01T00:00:00
CAIRNS,2020,9,94,68,162,2020-09-01T00:00:00
CAIRNS,2020,10,130,108,238,2020-10-01T00:00:00
CAIRNS,2020,11,367,96,463,2020-11-01T00:00:00
CAIRNS,2020,12,250,106,356,2020-12-01T00:00:00
CAIRNS,2021,1,267,127,394,2021-01-01T00:00:00
CAIRNS,2021,2,184,104,288,2021-02-01T00:00:00
CAIRNS,2021,3,171,47,218,2021-03-01T00:00:00
CAIRNS,2021,4,0,0,0,2021-04-01T00:00:00
CAIRNS,2021,5,0,0,0,2021-05-01T00:00:00
CAIRNS,2021,6,283,275,558,2021-06-01T00:00:00
CAIRNS,2021,7,434,550,984,2021-07-01T00:00:00
CAIRNS,2021,8,0,0,0,2021-08-01T00:00:00
CAIRNS,2021,9,0,0,0,2021-09-01T00:00:00
CAIRNS,2021,10,0,3,3,2021-10-01T00:00:00
CAIRNS,2021,11,0,19,19,2021-11-01T00:00:00
CAIRNS,2021,12,0,26,26,2021-12-01T00:00:00
CAIRNS,2022,1,0,68,68,2022-01-01T00:00:00
CAIRNS,2022,2,0,111,111,2022-02-01T00:00:00
CAIRNS,2022,3,107,250,357,2022-03-01T00:00:00
CAIRNS,2022,4,1597,1374,2971,2022-04-01T00:00:00
CAIRNS,2022,5,2277,3020,5297,2022-05-01T00:00:00
CAIRNS,2022,6,4037,5344,9381,2022-06-01T00:00:00
CAIRNS,2022,7,10314,8022,18336,2022-07-01T00:00:00
CAIRNS,2022,8,11323,10614,21937,2022-08-01T00:00:00
CAIRNS,2022,9,7586,7664,15250,2022-09-01T00:00:00
CAIRNS,2022,10,10261,8440,18701,2022-10-01T00:00:00
CAIRNS,2022,11,7692,9456,17148,2022-11-01T00:00:00
CAIRNS,2022,12,11267,14438,25705,2022-12-01T00:00:00
CAIRNS,2023,1,15885,13920,29805,2023-01-01T00:00:00
CAIRNS,2023,2,15903,11957,27860,2023-02-01T00:00:00
CAIRNS,2023,3,15864,17120,32984,2023-03-01T00:00:00
CAIRNS,2023,4,18602,16245,34847,2023-04-01T00:00:00
CAIRNS,2023,5,16952,18037,34989,2023-05-01T00:00:00
CAIRNS,2023,6,18226,18794,37020,2023-06-01T00:00:00
CAIRNS,2023,7,28855,20136,48991,2023-07-01T00:00:00
CAIRNS,2023,8,27315,27939,55254,2023-08-01T00:00:00
CAIRNS,2023,9,25026,28228,53254,2023-09-01T00:00:00
CAIRNS,2023,10,27532,24665,52197,2023-10-01T00:00:00
CAIRNS,2023,11,24233,25047,49280,2023-11-01T00:00:00
CAIRNS,2023,12,23460,26852,50312,2023-12-01T00:00:00
CAIRNS,2024,1,29351,26377,55728,2024-01-01T00:00:00
CAIRNS,2024,2,25916,22413,48329,2024-02-01T00:00:00
CAIRNS,2024,3,24446,26343,50789,2024-03-01T00:00:00
CAIRNS,2024,4,23397,22580,45977,2024-04-01T00:00:00
CAIRNS,2024,5,20443,23586,44029,2024-05-01T00:00:00
CAIRNS,2024,6,22641,22635,45276,2024-06-01T00:00:00
CAIRNS,2024,7,27423,21350,48773,2024-07-01T00:00:00
CAIRNS,2024,8,27481,30285,57766,2024-08-01T00:00:00
CAIRNS,2024,9,27762,29529,57291,2024-09-01T00:00:00
CAIRNS,2024,10,30318,27470,57788,2024-10-01T00:00:00
CAIRNS,2024,11,25281,27624,52905,2024-11-01T00:00:00
CAIRNS,2024,12,29355,31908,61263,2024-12-01T00:00:00
CAIRNS,2025,1,35472,30729,66201,2025-01-01T00:00:00
CAIRNS,2025,2,28424,24675,53099,2025-02-01T00:00:00
CAIRNS,2025,3,24957,26231,51188,2025-03-01T00:00:00
CAIRNS,2025,4,26035,28149,54184,2025-04-01T00:00:00
CAIRNS,2025,5,25189,26296,51485,2025-05-01T00:00:00
CAIRNS,2025,6,26128,26882,53010,2025-06-01T00:00:00
CANBERRA,1985,1,0,0,0,1985-01-01T00:00:00
CANBERRA,1985,2,0,0,0,1985-02-01T00:00:00
CANBERRA,1985,3,0,0,0,1985-03-01T00:00:00
CANBERRA,1985,4,0,0,0,1985-04-01T00:00:00
CANBERRA,1985,5,0,0,0,1985-05-01T00:00:00
CANBERRA,1985,6,0,0,0,1985-06-01T00:00:00
CANBERRA,1985,7,0,0,0,1985-07-01T00:00:00
CANBERRA,1985,8,0,0,0,1985-08-01T00:00:00
CANBERRA,1985,9,0,0,0,1985-09-01T00:00:00
CANBERRA,1985,10,0,0,0,1985-10-01T00:00:00
CANBERRA,1985,11,0,0,0,1985-11-01T00:00:00
CANBERRA,1985,12,0,0,0,1985-12-01T00:00:00
CANBERRA,1986,1,0,0,0,1986-01-01T00:00:00
CANBERRA,1986,2,0,0,0,1986-02-01T00:00:00
CANBERRA,1986,3,0,0,0,1986-03-01T00:00:00
CANBERRA,1986,4,0,0,0,1986-04-01T00:00:00
CANBERRA,1986,5,0,0,0,1986-05-01T00:00:00
CANBERRA,1986,6,0,0,0,1986-06-01T00:00:00
CANBERRA,1986,7,0,0,0,1986-07-01T00:00:00
CANBERRA,1986,8,0,0,0,1986-08-01T00:00:00
CANBERRA,1986,9,0,0,0,1986-09-01T00:00:00
CANBERRA,1986,10,0,0,0,1986-10-01T00:00:00
CANBERRA,1986,11,0,0,0,1986-11-01T00:00:00
CANBERRA,1986,12,0,0,0,1986-12-01T00:00:00
CANBERRA,1987,1,0,0,0,1987-01-01T00:00:00
CANBERRA,1987,2,0,0,0,1987-02-01T00:00:00
CANBERRA,1987,3,0,0,0,1987-03-01T00:00:00
CANBERRA,1987,4,0,0,0,1987-04-01T00:00:00
CANBERRA,1987,5,0,0,0,1987-05-01T00:00:00
CANBERRA,1987,6,0,0,0,1987-06-01T00:00:00
CANBERRA,1987,7,0,0,0,1987-07-01T00:00:00
CANBERRA,1987,8,0,0,0,1987-08-01T00:00:00
CANBERRA,1987,9,0,0,0,1987-09-01T00:00:00
CANBERRA,1987,10,0,0,0,1987-10-01T00:00:00
CANBERRA,1987,11,0,0,0,1987-11-01T00:00:00
CANBERRA,1987,12,0,0,0,1987-12-01T00:00:00
CANBERRA,1988,1,0,0,0,1988-01-01T00:00:00
CANBERRA,1988,2,0,0,0,1988-02-01T00:00:00
CANBERRA,1988,3,0,0,0,1988-03-01T00:00:00
CANBERRA,1988,4,0,0,0,1988-04-01T00:00:00
CANBERRA,1988,5,0,0,0,1988-05-01T00:00:00
CANBERRA,1988,6,0,0,0,1988-06-01T00:00:00
CANBERRA,1988,7,0,0,0,1988-07-01T00:00:00
CANBERRA,1988,8,0,0,0,1988-08-01T00:00:00
CANBERRA,1988,9,0,0,0,1988-09-01T00:00:00
CANBERRA,1988,10,0,0,0,1988-10-01T00:00:00
CANBERRA,1988,11,0,0,0,1988-11-01T00:00:00
CANBERRA,1988,12,0,0,0,1988-12-01T00:00:00
CANBERRA,1989,1,0,0,0,1989-01-01T00:00:00
CANBERRA,1989,2,0,0,0,1989-02-01T00:00:00
CANBERRA,1989,3,0,0,0,1989-03-01T00:00:00
CANBERRA,1989,4,0,0,0,1989-04-01T00:00:00
CANBERRA,1989,5,0,0,0,1989-05-01T00:00:00
CANBERRA,1989,6,0,0,0,1989-06-01T00:00:00
CANBERRA,1989,7,0,0,0,1989-07-01T00:00:00
CANBERRA,1989,8,0,0,0,1989-08-01T00:00:00
CANBERRA,1989,9,0,0,0,1989-09-01T00:00:00
CANBERRA,1989,10,0,0,0,1989-10-01T00:00:00
CANBERRA,1989,11,0,0,0,1989-11-01T00:00:00
CANBERRA,1989,12,0,0,0,1989-12-01T00:00:00
CANBERRA,1990,1,0,0,0,1990-01-01T00:00:00
CANBERRA,1990,2,0,0,0,1990-02-01T00:00:00
CANBERRA,1990,3,0,0,0,1990-03-01T00:00:00
CANBERRA,1990,4,0,0,0,1990-04-01T00:00:00
CANBERRA,1990,5,0,0,0,1990-05-01T00:00:00
CANBERRA,1990,6,0,0,0,1990-06-01T00:00:00
CANBERRA,1990,7,0,0,0,1990-07-01T00:00:00
CANBERRA,1990,8,0,0,0,1990-08-01T00:00:00
CANBERRA,1990,9,0,0,0,1990-09-01T00:00:00
CANBERRA,1990,10,0,0,0,1990-10-01T00:00:00
CANBERRA,1990,11,0,0,0,1990-11-01T00:00:00
CANBERRA,1990,12,0,0,0,1990-12-01T00:00:00
CANBERRA,1991,1,0,0,0,1991-01-01T00:00:00
CANBERRA,1991,2,0,0,0,1991-02-01T00:00:00
CANBERRA,1991,3,0,0,0,1991-03-01T00:00:00
CANBERRA,1991,4,0,0,0,1991-04-01T00:00:00
CANBERRA,1991,5,0,0,0,1991-05-01T00:00:00
CANBERRA,1991,6,0,0,0,1991-06-01T00:00:00
CANBERRA,1991,7,0,0,0,1991-07-01T00:00:00
CANBERRA,1991,8,0,0,0,1991-08-01T00:00:00
CANBERRA,1991,9,0,0,0,1991-09-01T00:00:00
CANBERRA,1991,10,0,0,0,1991-10-01T00:00:00
CANBERRA,1991,11,0,0,0,1991-11-01T00:00:00
CANBERRA,1991,12,0,0,0,1991-12-01T00:00:00
CANBERRA,1992,1,0,0,0,1992-01-01T00:00:00
CANBERRA,1992,2,0,0,0,1992-02-01T00:00:00
CANBERRA,1992,3,0,0,0,1992-03-01T00:00:00
CANBERRA,1992,4,0,0,0,1992-04-01T00:00:00
CANBERRA,1992,5,0,0,0,1992-05-01T00:00:00
CANBERRA,1992,6,0,0,0,1992-06-01T00:00:00
CANBERRA,1992,7,0,0,0,1992-07-01T00:00:00
CANBERRA,1992,8,0,0,0,1992-08-01T00:00:00
CANBERRA,1992,9,0,0,0,1992-09-01T00:00:00
CANBERRA,1992,10,0,0,0,1992-10-01T00:00:00
CANBERRA,1992,11,0,0,0,1992-11-01T00:00:00
CANBERRA,1992,12,0,0,0,1992-12-01T00:00:00
CANBERRA,1993,1,0,0,0,1993-01-01T00:00:00
CANBERRA,1993,2,0,0,0,1993-02-01T00:00:00
CANBERRA,1993,3,0,0,0,1993-03-01T00:00:00
CANBERRA,1993,4,0,0,0,1993-04-01T00:00:00
CANBERRA,1993,5,0,0,0,1993-05-01T00:00:00
CANBERRA,1993,6,0,0,0,1993-06-01T00:00:00
CANBERRA,1993,7,0,0,0,1993-07-01T00:00:00
CANBERRA,1993,8,0,0,0,1993-08-01T00:00:00
CANBERRA,1993,9,0,0,0,1993-09-01T00:00:00
CANBERRA,1993,10,0,0,0,1993-10-01T00:00:00
CANBERRA,1993,11,0,0,0,1993-11-01T00:00:00
CANBERRA,1993,12,0,0,0,1993-12-01T00:00:00
CANBERRA,1994,1,0,0,0,1994-01-01T00:00:00
CANBERRA,1994,2,0,0,0,1994-02-01T00:00:00
CANBERRA,1994,3,0,0,0,1994-03-01T00:00:00
CANBERRA,1994,4,0,0,0,1994-04-01T00:00:00
CANBERRA,1994,5,0,0,0,1994-05-01T00:00:00
CANBERRA,1994,6,0,0,0,1994-06-01T00:00:00
CANBERRA,1994,7,0,0,0,1994-07-01T00:00:00
CANBERRA,1994,8,0,0,0,1994-08-01T00:00:00
CANBERRA,1994,9,0,0,0,1994-09-01T00:00:00
CANBERRA,1994,10,0,0,0,1994-10-01T00:00:00
CANBERRA,1994,11,0,0,0,1994-11-01T00:00:00
CANBERRA,1994,12,0,0,0,1994-12-01T00:00:00
CANBERRA,1995,1,0,0,0,1995-01-01T00:00:00
CANBERRA,1995,2,0,0,0,1995-02-01T00:00:00
CANBERRA,1995,3,0,0,0,1995-03-01T00:00:00
CANBERRA,1995,4,0,0,0,1995-04-01T00:00:00
CANBERRA,1995,5,0,0,0,1995-05-01T00:00:00
CANBERRA,1995,6,0,0,0,1995-06-01T00:00:00
CANBERRA,1995,7,0,0,0,1995-07-01T00:00:00
CANBERRA,1995,8,0,0,0,1995-08-01T00:00:00
CANBERRA,1995,9,0,0,0,1995-09-01T00:00:00
CANBERRA,1995,10,0,0,0,1995-10-01T00:00:00
CANBERRA,1995,11,0,0,0,1995-11-01T00:00:00
CANBERRA,1995,12,0,0,0,1995-12-01T00:00:00
CANBERRA,1996,1,0,0,0,1996-01-01T00:00:00
CANBERRA,1996,2,0,0,0,1996-02-01T00:00:00
CANBERRA,1996,3,0,0,0,1996-03-01T00:00:00
CANBERRA,1996,4,0,0,0,1996-04-01T00:00:00
CANBERRA,1996,5,0,0,0,1996-05-01T00:00:00
CANBERRA,1996,6,0,0,0,1996-06-01T00:00:00
CANBERRA,1996,7,0,0,0,1996-07-01T00:00:00
CANBERRA,1996,8,0,0,0,1996-08-01T00:00:00
CANBERRA,1996,9,0,0,0,1996-09-01T00:00:00
CANBERRA,1996,10,0,0,0,1996-10-01T00:00:00
CANBERRA,1996,11,0,0,0,1996-11-01T00:00:00
CANBERRA,1996,12,0,0,0,1996-12-01T00:00:00
CANBERRA,1997,1,0,0,0,1997-01-01T00:00:00
CANBERRA,1997,2,0,0,0,1997-02-01T00:00:00
CANBERRA,1997,3,0,0,0,1997-03-01T00:00:00
CANBERRA,1997,4,0,0,0,1997-04-01T00:00:00
CANBERRA,1997,5,0,0,0,1997-05-01T00:00:00
CANBERRA,1997,6,0,0,0,1997-06-01T00:00:00
CANBERRA,1997,7,0,0,0,1997-07-01T00:00:00
CANBERRA,1997,8,0,0,0,1997-08-01T00:00:00
CANBERRA,1997,9,0,0,0,1997-09-01T00:00:00
CANBERRA,1997,10,0,0,0,1997-10-01T00:00:00
CANBERRA,1997,11,0,0,0,1997-11-01T00:00:00
CANBERRA,1997,12,0,0,0,1997-12-01T00:00:00
CANBERRA,1998,1,0,0,0,1998-01-01T00:00:00
CANBERRA,1998,2,0,0,0,1998-02-01T00:00:00
CANBERRA,1998,3,0,0,0,1998-03-01T00:00:00
CANBERRA,1998,4,0,0,0,1998-04-01T00:00:00
CANBERRA,1998,5,0,0,0,1998-05-01T00:00:00
CANBERRA,1998,6,0,0,0,1998-06-01T00:00:00
CANBERRA,1998,7,0,0,0,1998-07-01T00:00:00
CANBERRA,1998,8,0,0,0,1998-08-01T00:00:00
CANBERRA,1998,9,0,0,0,1998-09-01T00:00:00
CANBERRA,1998,10,0,0,0,1998-10-01T00:00:00
CANBERRA,1998,11,0,0,0,1998-11-01T00:00:00
CANBERRA,1998,12,0,0,0,1998-12-01T00:00:00
CANBERRA,1999,1,0,0,0,1999-01-01T00:00:00
CANBERRA,1999,2,0,0,0,1999-02-01T00:00:00
CANBERRA,1999,3,0,0,0,1999-03-01T00:00:00
CANBERRA,1999,4,0,0,0,1999-04-01T00:00:00
CANBERRA,1999,5,0,0,0,1999-05-01T00:00:00
CANBERRA,1999,6,0,0,0,1999-06-01T00:00:00
CANBERRA,1999,7,0,0,0,1999-07-01T00:00:00
CANBERRA,1999,8,0,0,0,1999-08-01T00:00:00
CANBERRA,1999,9,0,0,0,1999-09-01T00:00:00
CANBERRA,1999,10,0,0,0,1999-10-01T00:00:00
CANBERRA,1999,11,0,0,0,1999-11-01T00:00:00
CANBERRA,1999,12,0,0,0,1999-12-01T00:00:00
CANBERRA,2000,1,0,0,0,2000-01-01T00:00:00
CANBERRA,2000,2,0,0,0,2000-02-01T00:00:00
CANBERRA,2000,3,0,0,0,2000-03-01T00:00:00
CANBERRA,2000,4,0,0,0,2000-04-01T00:00:00
CANBERRA,2000,5,0,0,0,2000-05-01T00:00:00
CANBERRA,2000,6,0,0,0,2000-06-01T00:00:00
CANBERRA,2000,7,0,0,0,2000-07-01T00:00:00
CANBERRA,2000,8,0,0,0,2000-08-01T00:00:00
CANBERRA,2000,9,0,0,0,2000-09-01T00:00:00
CANBERRA,2000,10,0,0,0,2000-10-01T00:00:00
CANBERRA,2000,11,0,0,0,2000-11-01T00:00:00
CANBERRA,2000,12,0,0,0,2000-12-01T00:00:00
CANBERRA,2001,1,0,0,0,2001-01-01T00:00:00
CANBERRA,2001,2,0,0,0,2001-02-01T00:00:00
CANBERRA,2001,3,0,0,0,2001-03-01T00:00:00
CANBERRA,2001,4,0,0,0,2001-04-01T00:00:00
CANBERRA,2001,5,0,0,0,2001-05-01T00:00:00
CANBERRA,2001,6,0,0,0,2001-06-01T00:00:00
CANBERRA,2001,7,0,0,0,2001-07-01T00:00:00
CANBERRA,2001,8,0,0,0,2001-08-01T00:00:00
CANBERRA,2001,9,0,0,0,2001-09-01T00:00:00
CANBERRA,2001,10,0,0,0,2001-10-01T00:00:00
CANBERRA,2001,11,0,0,0,2001-11-01T00:00:00
CANBERRA,2001,12,0,0,0,2001-12-01T00:00:00
CANBERRA,2002,1,0,0,0,2002-01-01T00:00:00
CANBERRA,2002,2,0,0,0,2002-02-01T00:00:00
CANBERRA,2002,3,0,0,0,2002-03-01T00:00:00
CANBERRA,2002,4,0,0,0,2002-04-01T00:00:00
CANBERRA,2002,5,0,0,0,2002-05-01T00:00:00
CANBERRA,2002,6,0,0,0,2002-06-01T00:00:00
CANBERRA,2002,7,0,0,0,2002-07-01T00:00:00
CANBERRA,2002,8,0,0,0,2002-08-01T00:00:00
CANBERRA,2002,9,0,0,0,2002-09-01T00:00:00
CANBERRA,2002,10,0,0,0,2002-10-01T00:00:00
CANBERRA,2002,11,0,0,0,2002-11-01T00:00:00
CANBERRA,2002,12,0,0,0,2002-12-01T00:00:00
CANBERRA,2003,1,0,0,0,2003-01-01T00:00:00
CANBERRA,2003,2,0,0,0,2003-02-01T00:00:00
CANBERRA,2003,3,0,0,0,2003-03-01T00:00:00
CANBERRA,2003,4,0,0,0,2003-04-01T00:00:00
CANBERRA,2003,5,0,0,0,2003-05-01T00:00:00
CANBERRA,2003,6,0,0,0,2003-06-01T00:00:00
CANBERRA,2003,7,0,0,0,2003-07-01T00:00:00
CANBERRA,2003,8,0,0,0,2003-08-01T00:00:00
CANBERRA,2003,9,0,0,0,2003-09-01T00:00:00
CANBERRA,2003,10,0,0,0,2003-10-01T00:00:00
CANBERRA,2003,11,0,0,0,2003-11-01T00:00:00
CANBERRA,2003,12,0,0,0,2003-12-01T00:00:00
CANBERRA,2004,1,0,0,0,2004-01-01T00:00:00
CANBERRA,2004,2,0,0,0,2004-02-01T00:00:00
CANBERRA,2004,3,0,0,0,2004-03-01T00:00:00
CANBERRA,2004,4,0,0,0,2004-04-01T00:00:00
CANBERRA,2004,5,0,0,0,2004-05-01T00:00:00
CANBERRA,2004,6,0,0,0,2004-06-01T00:00:00
CANBERRA,2004,7,379,417,796,2004-07-01T00:00:00
CANBERRA,2004,8,415,392,807,2004-08-01T00:00:00
CANBERRA,2004,9,200,193,393,2004-09-01T00:00:00
CANBERRA,2004,10,0,0,0,2004-10-01T00:00:00
CANBERRA,2004,11,0,0,0,2004-11-01T00:00:00
CANBERRA,2004,12,0,0,0,2004-12-01T00:00:00
CANBERRA,2005,1,0,0,0,2005-01-01T00:00:00
CANBERRA,2005,2,0,0,0,2005-02-01T00:00:00
CANBERRA,2005,3,0,0,0,2005-03-01T00:00:00
CANBERRA,2005,4,0,0,0,2005-04-01T00:00:00
CANBERRA,2005,5,0,0,0,2005-05-01T00:00:00
CANBERRA,2005,6,0,0,0,2005-06-01T00:00:00
CANBERRA,2005,7,0,0,0,2005-07-01T00:00:00
CANBERRA,2005,8,0,0,0,2005-08-01T00:00:00
CANBERRA,2005,9,0,0,0,2005-09-01T00:00:00
CANBERRA,2005,10,0,0,0,2005-10-01T00:00:00
CANBERRA,2005,11,0,0,0,2005-11-01T00:00:00
CANBERRA,2005,12,0,0,0,2005-12-01T00:00:00
CANBERRA,2006,1,0,0,0,2006-01-01T00:00:00
CANBERRA,2006,2,0,0,0,2006-02-01T00:00:00
CANBERRA,2006,3,0,0,0,2006-03-01T00:00:00
CANBERRA,2006,4,0,0,0,2006-04-01T00:00:00
CANBERRA,2006,5,0,0,0,2006-05-01T00:00:00
CANBERRA,2006,6,0,0,0,2006-06-01T00:00:00
CANBERRA,2006,7,0,0,0,2006-07-01T00:00:00
CANBERRA,2006,8,0,0,0,2006-08-01T00:00:00
CANBERRA,2006,9,0,0,0,2006-09-01T00:00:00
CANBERRA,2006,10,0,0,0,2006-10-01T00:00:00
CANBERRA,2006,11,0,0,0,2006-11-01T00:00:00
CANBERRA,2006,12,0,0,0,2006-12-01T00:00:00
CANBERRA,2007,1,0,0,0,2007-01-01T00:00:00
CANBERRA,2007,2,0,0,0,2007-02-01T00:00:00
CANBERRA,2007,3,0,0,0,2007-03-01T00:00:00
CANBERRA,2007,4,0,0,0,2007-04-01T00:00:00
CANBERRA,2007,5,0,0,0,2007-05-01T00:00:00
CANBERRA,2007,6,0,0,0,2007-06-01T00:00:00
CANBERRA,2007,7,0,0,0,2007-07-01T00:00:00
CANBERRA,2007,8,0,0,0,2007-08-01T00:00:00
CANBERRA,2007,9,0,0,0,2007-09-01T00:00:00
CANBERRA,2007,10,0,0,0,2007-10-01T00:00:00
CANBERRA,2007,11,0,0,0,2007-11-01T00:00:00
CANBERRA,2007,12,0,0,0,2007-12-01T00:00:00
CANBERRA,2008,1,0,0,0,2008-01-01T00:00:00
CANBERRA,2008,2,0,0,0,2008-02-01T00:00:00
CANBERRA,2008,3,0,0,0,2008-03-01T00:00:00
CANBERRA,2008,4,0,0,0,2008-04-01T00:00:00
CANBERRA,2008,5,0,0,0,2008-05-01T00:00:00
CANBERRA,2008,6,0,0,0,2008-06-01T00:00:00
CANBERRA,2008,7,0,0,0,2008-07-01T00:00:00
CANBERRA,2008,8,0,0,0,2008-08-01T00:00:00
CANBERRA,2008,9,0,0,0,2008-09-01T00:00:00
CANBERRA,2008,10,0,0,0,2008-10-01T00:00:00
CANBERRA,2008,11,0,0,0,2008-11-01T00:00:00
CANBERRA,2008,12,0,0,0,2008-12-01T00:00:00
CANBERRA,2009,1,0,0,0,2009-01-01T00:00:00
CANBERRA,2009,2,0,0,0,2009-02-01T00:00:00
CANBERRA,2009,3,0,0,0,2009-03-01T00:00:00
CANBERRA,2009,4,0,0,0,2009-04-01T00:00:00
CANBERRA,2009,5,0,0,0,2009-05-01T00:00:00
CANBERRA,2009,6,0,0,0,2009-06-01T00:00:00
CANBERRA,2009,7,0,0,0,2009-07-01T00:00:00
CANBERRA,2009,8,0,0,0,2009-08-01T00:00:00
CANBERRA,2009,9,0,0,0,2009-09-01T00:00:00
CANBERRA,2009,10,0,0,0,2009-10-01T00:00:00
CANBERRA,2009,11,0,0,0,2009-11-01T00:00:00
CANBERRA,2009,12,0,0,0,2009-12-01T00:00:00
CANBERRA,2010,1,0,0,0,2010-01-01T00:00:00
CANBERRA,2010,2,0,0,0,2010-02-01T00:00:00
CANBERRA,2010,3,0,0,0,2010-03-01T00:00:00
CANBERRA,2010,4,0,0,0,2010-04-01T00:00:00
CANBERRA,2010,5,0,0,0,2010-05-01T00:00:00
CANBERRA,2010,6,0,0,0,2010-06-01T00:00:00
CANBERRA,2010,7,0,0,0,2010-07-01T00:00:00
CANBERRA,2010,8,0,0,0,2010-08-01T00:00:00
CANBERRA,2010,9,0,0,0,2010-09-01T00:00:00
CANBERRA,2010,10,0,0,0,2010-10-01T00:00:00
CANBERRA,2010,11,0,0,0,2010-11-01T00:00:00
CANBERRA,2010,12,0,0,0,2010-12-01T00:00:00
CANBERRA,2011,1,0,0,0,2011-01-01T00:00:00
CANBERRA,2011,2,0,0,0,2011-02-01T00:00:00
CANBERRA,2011,3,0,0,0,2011-03-01T00:00:00
CANBERRA,2011,4,0,0,0,2011-04-01T00:00:00
CANBERRA,2011,5,0,0,0,2011-05-01T00:00:00
CANBERRA,2011,6,0,0,0,2011-06-01T00:00:00
CANBERRA,2011,7,0,0,0,2011-07-01T00:00:00
CANBERRA,2011,8,0,0,0,2011-08-01T00:00:00
CANBERRA,2011,9,0,0,0,2011-09-01T00:00:00
CANBERRA,2011,10,0,0,0,2011-10-01T00:00:00
CANBERRA,2011,11,0,0,0,2011-11-01T00:00:00
CANBERRA,2011,12,0,0,0,2011-12-01T00:00:00
CANBERRA,2012,1,0,0,0,2012-01-01T00:00:00
CANBERRA,2012,2,0,0,0,2012-02-01T00:00:00
CANBERRA,2012,3,0,0,0,2012-03-01T00:00:00
CANBERRA,2012,4,0,0,0,2012-04-01T00:00:00
CANBERRA,2012,5,0,0,0,2012-05-01T00:00:00
CANBERRA,2012,6,0,0,0,2012-06-01T00:00:00
CANBERRA,2012,7,0,0,0,2012-07-01T00:00:00
CANBERRA,2012,8,0,0,0,2012-08-01T00:00:00
CANBERRA,2012,9,0,0,0,2012-09-01T00:00:00
CANBERRA,2012,10,0,0,0,2012-10-01T00:00:00
CANBERRA,2012,11,0,0,0,2012-11-01T00:00:00
CANBERRA,2012,12,0,0,0,2012-12-01T00:00:00
CANBERRA,2013,1,0,0,0,2013-01-01T00:00:00
CANBERRA,2013,2,0,0,0,2013-02-01T00:00:00
CANBERRA,2013,3,0,0,0,2013-03-01T00:00:00
CANBERRA,2013,4,0,0,0,2013-04-01T00:00:00
CANBERRA,2013,5,0,0,0,2013-05-01T00:00:00
CANBERRA,2013,6,0,0,0,2013-06-01T00:00:00
CANBERRA,2013,7,0,0,0,2013-07-01T00:00:00
CANBERRA,2013,8,0,0,0,2013-08-01T00:00:00
CANBERRA,2013,9,0,0,0,2013-09-01T00:00:00
CANBERRA,2013,10,0,0,0,2013-10-01T00:00:00
CANBERRA,2013,11,0,0,0,2013-11-01T00:00:00
CANBERRA,2013,12,0,0,0,2013-12-01T00:00:00
CANBERRA,2014,1,0,0,0,2014-01-01T00:00:00
CANBERRA,2014,2,0,0,0,2014-02-01T00:00:00
CANBERRA,2014,3,0,0,0,2014-03-01T00:00:00
CANBERRA,2014,4,0,0,0,2014-04-01T00:00:00
CANBERRA,2014,5,0,0,0,2014-05-01T00:00:00
CANBERRA,2014,6,0,0,0,2014-06-01T00:00:00
CANBERRA,2014,7,0,0,0,2014-07-01T00:00:00
CANBERRA,2014,8,0,0,0,2014-08-01T00:00:00
CANBERRA,2014,9,0,0,0,2014-09-01T00:00:00
CANBERRA,2014,10,0,0,0,2014-10-01T00:00:00
CANBERRA,2014,11,0,0,0,2014-11-01T00:00:00
CANBERRA,2014,12,0,0,0,2014-12-01T00:00:00
CANBERRA,2015,1,0,0,0,2015-01-01T00:00:00
CANBERRA,2015,2,0,0,0,2015-02-01T00:00:00
CANBERRA,2015,3,0,0,0,2015-03-01T00:00:00
CANBERRA,2015,4,0,0,0,2015-04-01T00:00:00
CANBERRA,2015,5,0,0,0,2015-05-01T00:00:00
CANBERRA,2015,6,0,0,0,2015-06-01T00:00:00
CANBERRA,2015,7,0,0,0,2015-07-01T00:00:00
CANBERRA,2015,8,0,0,0,2015-08-01T00:00:00
CANBERRA,2015,9,0,0,0,2015-09-01T00:00:00
CANBERRA,2015,10,0,0,0,2015-10-01T00:00:00
CANBERRA,2015,11,0,0,0,2015-11-01T00:00:00
CANBERRA,2015,12,0,0,0,2015-12-01T00:00:00
CANBERRA,2016,1,0,0,0,2016-01-01T00:00:00
CANBERRA,2016,2,0,0,0,2016-02-01T00:00:00
CANBERRA,2016,3,0,0,0,2016-03-01T00:00:00
CANBERRA,2016,4,0,0,0,2016-04-01T00:00:00
CANBERRA,2016,5,0,0,0,2016-05-01T00:00:00
CANBERRA,2016,6,0,0,0,2016-06-01T00:00:00
CANBERRA,2016,7,0,0,0,2016-07-01T00:00:00
CANBERRA,2016,8,0,0,0,2016-08-01T00:00:00
CANBERRA,2016,9,1421,1784,3205,2016-09-01T00:00:00
CANBERRA,2016,10,3821,3174,6995,2016-10-01T00:00:00
CANBERRA,2016,11,3393,3274,6667,2016-11-01T00:00:00
CANBERRA,2016,12,2743,4161,6904,2016-12-01T00:00:00
CANBERRA,2017,1,4665,3403,8068,2017-01-01T00:00:00
CANBERRA,2017,2,3255,2652,5907,2017-02-01T00:00:00
CANBERRA,2017,3,3369,3140,6509,2017-03-01T00:00:00
CANBERRA,2017,4,3961,3427,7388,2017-04-01T00:00:00
CANBERRA,2017,5,2794,2737,5531,2017-05-01T00:00:00
CANBERRA,2017,6,3031,3727,6758,2017-06-01T00:00:00
CANBERRA,2017,7,3918,2969,6887,2017-07-01T00:00:00
CANBERRA,2017,8,3477,3076,6553,2017-08-01T00:00:00
CANBERRA,2017,9,3582,3692,7274,2017-09-01T00:00:00
CANBERRA,2017,10,4306,3250,7556,2017-10-01T00:00:00
CANBERRA,2017,11,3759,3404,7163,2017-11-01T00:00:00
CANBERRA,2017,12,3747,5094,8841,2017-12-01T00:00:00
CANBERRA,2018,1,5278,3714,8992,2018-01-01T00:00:00
CANBERRA,2018,2,3841,3174,7015,2018-02-01T00:00:00
CANBERRA,2018,3,3975,3737,7712,2018-03-01T00:00:00
CANBERRA,2018,4,4859,4717,9576,2018-04-01T00:00:00
CANBERRA,2018,5,2930,4225,7155,2018-05-01T00:00:00
CANBERRA,2018,6,3422,4773,8195,2018-06-01T00:00:00
CANBERRA,2018,7,4197,4585,8782,2018-07-01T00:00:00
CANBERRA,2018,8,3593,4245,7838,2018-08-01T00:00:00
CANBERRA,2018,9,3749,4719,8468,2018-09-01T00:00:00
CANBERRA,2018,10,3923,3360,7283,2018-10-01T00:00:00
CANBERRA,2018,11,3035,3992,7027,2018-11-01T00:00:00
CANBERRA,2018,12,2230,4649,6879,2018-12-01T00:00:00
CANBERRA,2019,1,3290,3445,6735,2019-01-01T00:00:00
CANBERRA,2019,2,2839,2678,5517,2019-02-01T00:00:00
CANBERRA,2019,3,2592,3492,6084,2019-03-01T00:00:00
CANBERRA,2019,4,2811,4239,7050,2019-04-01T00:00:00
CANBERRA,2019,5,2984,4365,7349,2019-05-01T00:00:00
CANBERRA,2019,6,3333,4545,7878,2019-06-01T00:00:00
CANBERRA,2019,7,4168,4227,8395,2019-07-01T00:00:00
CANBERRA,2019,8,3174,4067,7241,2019-08-01T00:00:00
CANBERRA,2019,9,3471,4559,8030,2019-09-01T00:00:00
CANBERRA,2019,10,3777,3557,7334,2019-10-01T00:00:00
CANBERRA,2019,11,2813,3718,6531,2019-11-01T00:00:00
CANBERRA,2019,12,2478,4447,6925,2019-12-01T00:00:00
CANBERRA,2020,1,2617,3087,5704,2020-01-01T00:00:00
CANBERRA,2020,2,2265,2279,4544,2020-02-01T00:00:00
CANBERRA,2020,3,1471,1174,2645,2020-03-01T00:00:00
CANBERRA,2020,4,0,0,0,2020-04-01T00:00:00
CANBERRA,2020,5,0,0,0,2020-05-01T00:00:00
CANBERRA,2020,6,0,0,0,2020-06-01T00:00:00
CANBERRA,2020,7,0,0,0,2020-07-01T00:00:00
CANBERRA,2020,8,0,0,0,2020-08-01T00:00:00
CANBERRA,2020,9,0,0,0,2020-09-01T00:00:00
CANBERRA,2020,10,0,0,0,2020-10-01T00:00:00
CANBERRA,2020,11,118,0,118,2020-11-01T00:00:00
CANBERRA,2020,12,0,0,0,2020-12-01T00:00:00
CANBERRA,2021,1,0,0,0,2021-01-01T00:00:00
CANBERRA,2021,2,0,0,0,2021-02-01T00:00:00
CANBERRA,2021,3,137,0,137,2021-03-01T00:00:00
CANBERRA,2021,4,0,0,0,2021-04-01T00:00:00
CANBERRA,2021,5,0,0,0,2021-05-01T00:00:00
CANBERRA,2021,6,0,0,0,2021-06-01T00:00:00
CANBERRA,2021,7,0,0,0,2021-07-01T00:00:00
CANBERRA,2021,8,0,0,0,2021-08-01T00:00:00
CANBERRA,2021,9,0,0,0,2021-09-01T00:00:00
CANBERRA,2021,10,0,0,0,2021-10-01T00:00:00
CANBERRA,2021,11,0,0,0,2021-11-01T00:00:00
CANBERRA,2021,12,0,0,0,2021-12-01T00:00:00
CANBERRA,2022,1,0,0,0,2022-01-01T00:00:00
CANBERRA,2022,2,0,0,0,2022-02-01T00:00:00
CANBERRA,2022,3,0,0,0,2022-03-01T00:00:00
CANBERRA,2022,4,0,0,0,2022-04-01T00:00:00
CANBERRA,2022,5,0,0,0,2022-05-01T00:00:00
CANBERRA,2022,6,0,0,0,2022-06-01T00:00:00
CANBERRA,2022,7,0,0,0,2022-07-01T00:00:00
CANBERRA,2022,8,0,0,0,2022-08-01T00:00:00
CANBERRA,2022,9,0,0,0,2022-09-01T00:00:00
CANBERRA,2022,10,0,0,0,2022-10-01T00:00:00
CANBERRA,2022,11,0,0,0,2022-11-01T00:00:00
CANBERRA,2022,12,0,0,0,2022-12-01T00:00:00
CANBERRA,2023,1,0,0,0,2023-01-01T00:00:00
CANBERRA,2023,2,0,0,0,2023-02-01T00:00:00
CANBERRA,2023,3,0,0,0,2023-03-01T00:00:00
CANBERRA,2023,4,105,72,177,2023-04-01T00:00:00
CANBERRA,2023,5,0,0,0,2023-05-01T00:00:00
CANBERRA,2023,6,0,0,0,2023-06-01T00:00:00
CANBERRA,2023,7,318,203,521,2023-07-01T00:00:00
CANBERRA,2023,8,802,874,1676,2023-08-01T00:00:00
CANBERRA,2023,9,940,1059,1999,2023-09-01T00:00:00
CANBERRA,2023,10,1234,1379,2613,2023-10-01T00:00:00
CANBERRA,2023,11,983,1183,2166,2023-11-01T00:00:00
CANBERRA,2023,12,1568,1360,2928,2023-12-01T00:00:00
CANBERRA,2024,1,1235,1767,3002,2024-01-01T00:00:00
CANBERRA,2024,2,544,707,1251,2024-02-01T00:00:00
CANBERRA,2024,3,1001,927,1928,2024-03-01T00:00:00
CANBERRA,2024,4,1140,1177,2317,2024-04-01T00:00:00
CANBERRA,2024,5,1048,1085,2133,2024-05-01T00:00:00
CANBERRA,2024,6,1750,1911,3661,2024-06-01T00:00:00
CANBERRA,2024,7,2857,2623,5480,2024-07-01T00:00:00
CANBERRA,2024,8,1950,2057,4007,2024-08-01T00:00:00
CANBERRA,2024,9,1776,1939,3715,2024-09-01T00:00:00
CANBERRA,2024,10,1928,1845,3773,2024-10-01T00:00:00
CANBERRA,2024,11,1092,1123,2215,2024-11-01T00:00:00
CANBERRA,2024,12,1800,2008,3808,2024-12-01T00:00:00
CANBERRA,2025,1,1448,2005,3453,2025-01-01T00:00:00
CANBERRA,2025,2,816,860,1676,2025-02-01T00:00:00
CANBERRA,2025,3,1030,1090,2120,2025-03-01T00:00:00
CANBERRA,2025,4,1405,1337,2742,2025-04-01T00:00:00
CANBERRA,2025,5,1337,1280,2617,2025-05-01T00:00:00
CANBERRA,2025,6,1462,1303,2765,2025-06-01T00:00:00
DARWIN,1985,1,2942,1837,4779,1985-01-01T00:00:00
DARWIN,1985,2,1646,1391,3037,1985-02-01T00:00:00
DARWIN,1985,3,1459,1738,3197,1985-03-01T00:00:00
DARWIN,1985,4,1795,1653,3448,1985-04-01T00:00:00
DARWIN,1985,5,1508,1616,3124,1985-05-01T00:00:00
DARWIN,1985,6,1783,2538,4321,1985-06-01T00:00:00
DARWIN,1985,7,3113,2611,5724,1985-07-01T00:00:00
DARWIN,1985,8,1945,1997,3942,1985-08-01T00:00:00
DARWIN,1985,9,1901,1916,3817,1985-09-01T00:00:00
DARWIN,1985,10,1940,1743,3683,1985-10-01T00:00:00
DARWIN,1985,11,1418,1679,3097,1985-11-01T00:00:00
DARWIN,1985,12,1735,2935,4670,1985-12-01T00:00:00
DARWIN,1986,1,3082,1905,4987,1986-01-01T00:00:00
DARWIN,1986,2,1593,1194,2787,1986-02-01T00:00:00
DARWIN,1986,3,1374,1605,2979,1986-03-01T00:00:00
DARWIN,1986,4,2195,1980,4175,1986-04-01T00:00:00
DARWIN,1986,5,1566,1474,3040,1986-05-01T00:00:00
DARWIN,1986,6,1699,1951,3650,1986-06-01T00:00:00
DARWIN,1986,7,2827,3143,5970,1986-07-01T00:00:00
DARWIN,1986,8,2564,2177,4741,1986-08-01T00:00:00
DARWIN,1986,9,1928,1718,3646,1986-09-01T00:00:00
DARWIN,1986,10,2288,2115,4403,1986-10-01T00:00:00
DARWIN,1986,11,1748,1994,3742,1986-11-01T00:00:00
DARWIN,1986,12,1822,2769,4591,1986-12-01T00:00:00
DARWIN,1987,1,3346,2077,5423,1987-01-01T00:00:00
DARWIN,1987,2,1784,1409,3193,1987-02-01T00:00:00
DARWIN,1987,3,1744,1810,3554,1987-03-01T00:00:00
DARWIN,1987,4,2284,2467,4751,1987-04-01T00:00:00
DARWIN,1987,5,2229,2306,4535,1987-05-01T00:00:00
DARWIN,1987,6,2216,3120,5336,1987-06-01T00:00:00
DARWIN,1987,7,4117,3419,7536,1987-07-01T00:00:00
DARWIN,1987,8,2807,2951,5758,1987-08-01T00:00:00
DARWIN,1987,9,2270,2415,4685,1987-09-01T00:00:00
DARWIN,1987,10,3312,2496,5808,1987-10-01T00:00:00
DARWIN,1987,11,2560,2590,5150,1987-11-01T00:00:00
DARWIN,1987,12,2765,3492,6257,1987-12-01T00:00:00
DARWIN,1988,1,3978,2800,6778,1988-01-01T00:00:00
DARWIN,1988,2,2456,2018,4474,1988-02-01T00:00:00
DARWIN,1988,3,2383,2463,4846,1988-03-01T00:00:00
DARWIN,1988,4,2754,3057,5811,1988-04-01T00:00:00
DARWIN,1988,5,2800,2890,5690,1988-05-01T00:00:00
DARWIN,1988,6,3041,3653,6694,1988-06-01T00:00:00
DARWIN,1988,7,4802,4297,9099,1988-07-01T00:00:00
DARWIN,1988,8,3637,3631,7268,1988-08-01T00:00:00
DARWIN,1988,9,3275,3114,6389,1988-09-01T00:00:00
DARWIN,1988,10,4600,3120,7720,1988-10-01T00:00:00
DARWIN,1988,11,3075,3176,6251,1988-11-01T00:00:00
DARWIN,1988,12,3384,4921,8305,1988-12-01T00:00:00
DARWIN,1989,1,5015,3135,8150,1989-01-01T00:00:00
DARWIN,1989,2,3061,2493,5554,1989-02-01T00:00:00
DARWIN,1989,3,2805,3462,6267,1989-03-01T00:00:00
DARWIN,1989,4,3304,3651,6955,1989-04-01T00:00:00
DARWIN,1989,5,2740,3128,5868,1989-05-01T00:00:00
DARWIN,1989,6,3308,4641,7949,1989-06-01T00:00:00
DARWIN,1989,7,5952,4722,10674,1989-07-01T00:00:00
DARWIN,1989,8,3867,4393,8260,1989-08-01T00:00:00
DARWIN,1989,9,3913,4235,8148,1989-09-01T00:00:00
DARWIN,1989,10,5093,4171,9264,1989-10-01T00:00:00
DARWIN,1989,11,3465,3379,6844,1989-11-01T00:00:00
DARWIN,1989,12,3423,5413,8836,1989-12-01T00:00:00
DARWIN,1990,1,4995,3482,8477,1990-01-01T00:00:00
DARWIN,1990,2,3574,2764,6338,1990-02-01T00:00:00
DARWIN,1990,3,2936,3517,6453,1990-03-01T00:00:00
DARWIN,1990,4,3548,3864,7412,1990-04-01T00:00:00
DARWIN,1990,5,3015,3669,6684,1990-05-01T00:00:00
DARWIN,1990,6,3439,4908,8347,1990-06-01T00:00:00
DARWIN,1990,7,5800,4718,10518,1990-07-01T00:00:00
DARWIN,1990,8,4412,4591,9003,1990-08-01T00:00:00
DARWIN,1990,9,3903,3844,7747,1990-09-01T00:00:00
DARWIN,1990,10,4266,3162,7428,1990-10-01T00:00:00
DARWIN,1990,11,4198,3683,7881,1990-11-01T00:00:00
DARWIN,1990,12,3139,4862,8001,1990-12-01T00:00:00
DARWIN,1991,1,5024,3184,8208,1991-01-01T00:00:00
DARWIN,1991,2,2882,2574,5456,1991-02-01T00:00:00
DARWIN,1991,3,2734,3279,6013,1991-03-01T00:00:00
DARWIN,1991,4,2871,3337,6208,1991-04-01T00:00:00
DARWIN,1991,5,3225,3996,7221,1991-05-01T00:00:00
DARWIN,1991,6,3632,4903,8535,1991-06-01T00:00:00
DARWIN,1991,7,5772,4439,10211,1991-07-01T00:00:00
DARWIN,1991,8,4088,4601,8689,1991-08-01T00:00:00
DARWIN,1991,9,3779,3822,7601,1991-09-01T00:00:00
DARWIN,1991,10,4182,3035,7217,1991-10-01T00:00:00
DARWIN,1991,11,3355,3296,6651,1991-11-01T00:00:00
DARWIN,1991,12,2844,4371,7215,1991-12-01T00:00:00
DARWIN,1992,1,4445,2754,7199,1992-01-01T00:00:00
DARWIN,1992,2,2981,2436,5417,1992-02-01T00:00:00
DARWIN,1992,3,2461,2770,5231,1992-03-01T00:00:00
DARWIN,1992,4,3422,3552,6974,1992-04-01T00:00:00
DARWIN,1992,5,3229,3679,6908,1992-05-01T00:00:00
DARWIN,1992,6,3671,4908,8579,1992-06-01T00:00:00
DARWIN,1992,7,6068,4309,10377,1992-07-01T00:00:00
DARWIN,1992,8,4041,4716,8757,1992-08-01T00:00:00
DARWIN,1992,9,3582,4123,7705,1992-09-01T00:00:00
DARWIN,1992,10,4798,3646,8444,1992-10-01T00:00:00
DARWIN,1992,11,3317,3760,7077,1992-11-01T00:00:00
DARWIN,1992,12,3603,4537,8140,1992-12-01T00:00:00
DARWIN,1993,1,4678,3006,7684,1993-01-01T00:00:00
DARWIN,1993,2,3035,2510,5545,1993-02-01T00:00:00
DARWIN,1993,3,3324,3671,6995,1993-03-01T00:00:00
DARWIN,1993,4,4406,3966,8372,1993-04-01T00:00:00
DARWIN,1993,5,3748,5093,8841,1993-05-01T00:00:00
DARWIN,1993,6,3617,4905,8522,1993-06-01T00:00:00
DARWIN,1993,7,6244,4710,10954,1993-07-01T00:00:00
DARWIN,1993,8,4178,4975,9153,1993-08-01T00:00:00
DARWIN,1993,9,4384,4162,8546,1993-09-01T00:00:00
DARWIN,1993,10,6136,4216,10352,1993-10-01T00:00:00
DARWIN,1993,11,4144,4523,8667,1993-11-01T00:00:00
DARWIN,1993,12,4138,5293,9431,1993-12-01T00:00:00
DARWIN,1994,1,5739,4157,9896,1994-01-01T00:00:00
DARWIN,1994,2,3719,3524,7243,1994-02-01T00:00:00
DARWIN,1994,3,4466,4647,9113,1994-03-01T00:00:00
DARWIN,1994,4,4827,4735,9562,1994-04-01T00:00:00
DARWIN,1994,5,4275,5252,9527,1994-05-01T00:00:00
DARWIN,1994,6,5339,6106,11445,1994-06-01T00:00:00
DARWIN,1994,7,9265,6737,16002,1994-07-01T00:00:00
DARWIN,1994,8,6002,6160,12162,1994-08-01T00:00:00
DARWIN,1994,9,6656,5657,12313,1994-09-01T00:00:00
DARWIN,1994,10,7844,5312,13156,1994-10-01T00:00:00
DARWIN,1994,11,5239,4999,10238,1994-11-01T00:00:00
DARWIN,1994,12,4935,6389,11324,1994-12-01T00:00:00
DARWIN,1995,1,6577,4999,11576,1995-01-01T00:00:00
DARWIN,1995,2,4507,3675,8182,1995-02-01T00:00:00
DARWIN,1995,3,4518,5061,9579,1995-03-01T00:00:00
DARWIN,1995,4,5262,5140,10402,1995-04-01T00:00:00
DARWIN,1995,5,5434,6081,11515,1995-05-01T00:00:00
DARWIN,1995,6,5685,6264,11949,1995-06-01T00:00:00
DARWIN,1995,7,9227,7049,16276,1995-07-01T00:00:00
DARWIN,1995,8,6840,6716,13556,1995-08-01T00:00:00
DARWIN,1995,9,6926,5676,12602,1995-09-01T00:00:00
DARWIN,1995,10,8257,4946,13203,1995-10-01T00:00:00
DARWIN,1995,11,5248,5084,10332,1995-11-01T00:00:00
DARWIN,1995,12,4552,5913,10465,1995-12-01T00:00:00
DARWIN,1996,1,6490,4978,11468,1996-01-01T00:00:00
DARWIN,1996,2,5082,3814,8896,1996-02-01T00:00:00
DARWIN,1996,3,4565,5297,9862,1996-03-01T00:00:00
DARWIN,1996,4,5085,5561,10646,1996-04-01T00:00:00
DARWIN,1996,5,4855,5919,10774,1996-05-01T00:00:00
DARWIN,1996,6,6561,7062,13623,1996-06-01T00:00:00
DARWIN,1996,7,9164,7347,16511,1996-07-01T00:00:00
DARWIN,1996,8,6883,6830,13713,1996-08-01T00:00:00
DARWIN,1996,9,7525,6563,14088,1996-09-01T00:00:00
DARWIN,1996,10,9473,5901,15374,1996-10-01T00:00:00
DARWIN,1996,11,5723,5607,11330,1996-11-01T00:00:00
DARWIN,1996,12,5314,6289,11603,1996-12-01T00:00:00
DARWIN,1997,1,7370,4915,12285,1997-01-01T00:00:00
DARWIN,1997,2,5862,4474,10336,1997-02-01T00:00:00
DARWIN,1997,3,5300,5084,10384,1997-03-01T00:00:00
DARWIN,1997,4,5553,6492,12045,1997-04-01T00:00:00
DARWIN,1997,5,6220,6906,13126,1997-05-01T00:00:00
DARWIN,1997,6,7396,8376,15772,1997-06-01T00:00:00
DARWIN,1997,7,10262,8091,18353,1997-07-01T00:00:00
DARWIN,1997,8,7594,8421,16015,1997-08-01T00:00:00
DARWIN,1997,9,9043,7457,16500,1997-09-01T00:00:00
DARWIN,1997,10,10056,7613,17669,1997-10-01T00:00:00
DARWIN,1997,11,8166,6874,15040,1997-11-01T00:00:00
DARWIN,1997,12,6232,7562,13794,1997-12-01T00:00:00
DARWIN,1998,1,8208,5963,14171,1998-01-01T00:00:00
DARWIN,1998,2,6326,5503,11829,1998-02-01T00:00:00
DARWIN,1998,3,6402,6792,13194,1998-03-01T00:00:00
DARWIN,1998,4,6409,6701,13110,1998-04-01T00:00:00
DARWIN,1998,5,5698,6820,12518,1998-05-01T00:00:00
DARWIN,1998,6,6687,7827,14514,1998-06-01T00:00:00
DARWIN,1998,7,10596,8064,18660,1998-07-01T00:00:00
DARWIN,1998,8,8462,9191,17653,1998-08-01T00:00:00
DARWIN,1998,9,8828,7915,16743,1998-09-01T00:00:00
DARWIN,1998,10,10497,7673,18170,1998-10-01T00:00:00
DARWIN,1998,11,7448,7103,14551,1998-11-01T00:00:00
DARWIN,1998,12,5714,6946,12660,1998-12-01T00:00:00
DARWIN,1999,1,7705,6506,14211,1999-01-01T00:00:00
DARWIN,1999,2,5860,4406,10266,1999-02-01T00:00:00
DARWIN,1999,3,5492,5892,11384,1999-03-01T00:00:00
DARWIN,1999,4,5940,5948,11888,1999-04-01T00:00:00
DARWIN,1999,5,5648,6227,11875,1999-05-01T00:00:00
DARWIN,1999,6,6244,6851,13095,1999-06-01T00:00:00
DARWIN,1999,7,10354,7397,17751,1999-07-01T00:00:00
DARWIN,1999,8,7217,7412,14629,1999-08-01T00:00:00
DARWIN,1999,9,8364,6846,15210,1999-09-01T00:00:00
DARWIN,1999,10,8489,5766,14255,1999-10-01T00:00:00
DARWIN,1999,11,5787,5228,11015,1999-11-01T00:00:00
DARWIN,1999,12,4613,5866,10479,1999-12-01T00:00:00
DARWIN,2000,1,6403,4728,11131,2000-01-01T00:00:00
DARWIN,2000,2,5025,4114,9139,2000-02-01T00:00:00
DARWIN,2000,3,4930,5206,10136,2000-03-01T00:00:00
DARWIN,2000,4,5888,6080,11968,2000-04-01T00:00:00
DARWIN,2000,5,5909,6255,12164,2000-05-01T00:00:00
DARWIN,2000,6,7096,8097,15193,2000-06-01T00:00:00
DARWIN,2000,7,10825,7917,18742,2000-07-01T00:00:00
DARWIN,2000,8,8668,8945,17613,2000-08-01T00:00:00
DARWIN,2000,9,8258,7395,15653,2000-09-01T00:00:00
DARWIN,2000,10,10237,7477,17714,2000-10-01T00:00:00
DARWIN,2000,11,8042,7437,15479,2000-11-01T00:00:00
DARWIN,2000,12,6632,7932,14564,2000-12-01T00:00:00
DARWIN,2001,1,7579,6309,13888,2001-01-01T00:00:00
DARWIN,2001,2,5208,4100,9308,2001-02-01T00:00:00
DARWIN,2001,3,5582,5356,10938,2001-03-01T00:00:00
DARWIN,2001,4,5812,5973,11785,2001-04-01T00:00:00
DARWIN,2001,5,6369,6841,13210,2001-05-01T00:00:00
DARWIN,2001,6,6381,7015,13396,2001-06-01T00:00:00
DARWIN,2001,7,9376,7228,16604,2001-07-01T00:00:00
DARWIN,2001,8,7589,8294,15883,2001-08-01T00:00:00
DARWIN,2001,9,8149,6220,14369,2001-09-01T00:00:00
DARWIN,2001,10,8206,5546,13752,2001-10-01T00:00:00
DARWIN,2001,11,5417,5026,10443,2001-11-01T00:00:00
DARWIN,2001,12,3401,4646,8047,2001-12-01T00:00:00
DARWIN,2002,1,4841,3710,8551,2002-01-01T00:00:00
DARWIN,2002,2,3298,3043,6341,2002-02-01T00:00:00
DARWIN,2002,3,3936,4230,8166,2002-03-01T00:00:00
DARWIN,2002,4,3825,3657,7482,2002-04-01T00:00:00
DARWIN,2002,5,3866,4931,8797,2002-05-01T00:00:00
DARWIN,2002,6,4271,5062,9333,2002-06-01T00:00:00
DARWIN,2002,7,5864,5302,11166,2002-07-01T00:00:00
DARWIN,2002,8,5132,5933,11065,2002-08-01T00:00:00
DARWIN,2002,9,5459,5258,10717,2002-09-01T00:00:00
DARWIN,2002,10,5671,3997,9668,2002-10-01T00:00:00
DARWIN,2002,11,2954,3133,6087,2002-11-01T00:00:00
DARWIN,2002,12,2446,3392,5838,2002-12-01T00:00:00
DARWIN,2003,1,3367,2482,5849,2003-01-01T00:00:00
DARWIN,2003,2,2511,2268,4779,2003-02-01T00:00:00
DARWIN,2003,3,2755,2796,5551,2003-03-01T00:00:00
DARWIN,2003,4,2549,2836,5385,2003-04-01T00:00:00
DARWIN,2003,5,2599,3649,6248,2003-05-01T00:00:00
DARWIN,2003,6,3097,3856,6953,2003-06-01T00:00:00
DARWIN,2003,7,4310,3979,8289,2003-07-01T00:00:00
DARWIN,2003,8,3928,4483,8411,2003-08-01T00:00:00
DARWIN,2003,9,3360,3171,6531,2003-09-01T00:00:00
DARWIN,2003,10,3840,3054,6894,2003-10-01T00:00:00
DARWIN,2003,11,3071,2846,5917,2003-11-01T00:00:00
DARWIN,2003,12,2889,3994,6883,2003-12-01T00:00:00
DARWIN,2004,1,4087,2935,7022,2004-01-01T00:00:00
DARWIN,2004,2,2839,2606,5445,2004-02-01T00:00:00
DARWIN,2004,3,2851,3260,6111,2004-03-01T00:00:00
DARWIN,2004,4,3083,3398,6481,2004-04-01T00:00:00
DARWIN,2004,5,3283,3682,6965,2004-05-01T00:00:00
DARWIN,2004,6,4205,4952,9157,2004-06-01T00:00:00
DARWIN,2004,7,6569,4862,11431,2004-07-01T00:00:00
DARWIN,2004,8,4802,5659,10461,2004-08-01T00:00:00
DARWIN,2004,9,5459,4725,10184,2004-09-01T00:00:00
DARWIN,2004,10,5647,4072,9719,2004-10-01T00:00:00
DARWIN,2004,11,3858,3634,7492,2004-11-01T00:00:00
DARWIN,2004,12,3202,4704,7906,2004-12-01T00:00:00
DARWIN,2005,1,4964,3344,8308,2005-01-01T00:00:00
DARWIN,2005,2,3032,2589,5621,2005-02-01T00:00:00
DARWIN,2005,3,3167,3603,6770,2005-03-01T00:00:00
DARWIN,2005,4,3230,4079,7309,2005-04-01T00:00:00
DARWIN,2005,5,4021,4948,8969,2005-05-01T00:00:00
DARWIN,2005,6,4080,4965,9045,2005-06-01T00:00:00
DARWIN,2005,7,6845,5062,11907,2005-07-01T00:00:00
DARWIN,2005,8,5051,6294,11345,2005-08-01T00:00:00
DARWIN,2005,9,4992,4440,9432,2005-09-01T00:00:00
DARWIN,2005,10,5451,3809,9260,2005-10-01T00:00:00
DARWIN,2005,11,3753,3360,7113,2005-11-01T00:00:00
DARWIN,2005,12,3850,5453,9303,2005-12-01T00:00:00
DARWIN,2006,1,6099,4253,10352,2006-01-01T00:00:00
DARWIN,2006,2,3998,3292,7290,2006-02-01T00:00:00
DARWIN,2006,3,3935,4330,8265,2006-03-01T00:00:00
DARWIN,2006,4,5186,6019,11205,2006-04-01T00:00:00
DARWIN,2006,5,4108,5056,9164,2006-05-01T00:00:00
DARWIN,2006,6,5072,6746,11818,2006-06-01T00:00:00
DARWIN,2006,7,8020,6217,14237,2006-07-01T00:00:00
DARWIN,2006,8,5282,6814,12096,2006-08-01T00:00:00
DARWIN,2006,9,5412,5265,10677,2006-09-01T00:00:00
DARWIN,2006,10,5778,5050,10828,2006-10-01T00:00:00
DARWIN,2006,11,4526,4662,9188,2006-11-01T00:00:00
DARWIN,2006,12,4081,7627,11708,2006-12-01T00:00:00
DARWIN,2007,1,7515,5243,12758,2007-01-01T00:00:00
DARWIN,2007,2,4642,3953,8595,2007-02-01T00:00:00
DARWIN,2007,3,4423,4765,9188,2007-03-01T00:00:00
DARWIN,2007,4,5298,5447,10745,2007-04-01T00:00:00
DARWIN,2007,5,5250,5930,11180,2007-05-01T00:00:00
DARWIN,2007,6,5435,7582,13017,2007-06-01T00:00:00
DARWIN,2007,7,8937,7175,16112,2007-07-01T00:00:00
DARWIN,2007,8,6583,7052,13635,2007-08-01T00:00:00
DARWIN,2007,9,6963,7056,14019,2007-09-01T00:00:00
DARWIN,2007,10,7989,6389,14378,2007-10-01T00:00:00
DARWIN,2007,11,5480,5716,11196,2007-11-01T00:00:00
DARWIN,2007,12,6344,10152,16496,2007-12-01T00:00:00
DARWIN,2008,1,9631,7481,17112,2008-01-01T00:00:00
DARWIN,2008,2,7371,5540,12911,2008-02-01T00:00:00
DARWIN,2008,3,6686,6378,13064,2008-03-01T00:00:00
DARWIN,2008,4,6612,6826,13438,2008-04-01T00:00:00
DARWIN,2008,5,6588,7263,13851,2008-05-01T00:00:00
DARWIN,2008,6,7624,9407,17031,2008-06-01T00:00:00
DARWIN,2008,7,11910,9344,21254,2008-07-01T00:00:00
DARWIN,2008,8,8349,8808,17157,2008-08-01T00:00:00
DARWIN,2008,9,8733,8474,17207,2008-09-01T00:00:00
DARWIN,2008,10,10344,8187,18531,2008-10-01T00:00:00
DARWIN,2008,11,5820,5246,11066,2008-11-01T00:00:00
DARWIN,2008,12,5677,9538,15215,2008-12-01T00:00:00
DARWIN,2009,1,10356,6373,16729,2009-01-01T00:00:00
DARWIN,2009,2,6589,4231,10820,2009-02-01T00:00:00
DARWIN,2009,3,5113,5276,10389,2009-03-01T00:00:00
DARWIN,2009,4,7744,7085,14829,2009-04-01T00:00:00
DARWIN,2009,5,8422,8485,16907,2009-05-01T00:00:00
DARWIN,2009,6,8809,9617,18426,2009-06-01T00:00:00
DARWIN,2009,7,11331,8167,19498,2009-07-01T00:00:00
DARWIN,2009,8,9252,9866,19118,2009-08-01T00:00:00
DARWIN,2009,9,9437,8716,18153,2009-09-01T00:00:00
DARWIN,2009,10,9885,7547,17432,2009-10-01T00:00:00
DARWIN,2009,11,8305,7371,15676,2009-11-01T00:00:00
DARWIN,2009,12,6700,11065,17765,2009-12-01T00:00:00
DARWIN,2010,1,12438,7021,19459,2010-01-01T00:00:00
DARWIN,2010,2,7671,5946,13617,2010-02-01T00:00:00
DARWIN,2010,3,7223,6848,14071,2010-03-01T00:00:00
DARWIN,2010,4,8722,8067,16789,2010-04-01T00:00:00
DARWIN,2010,5,8980,8182,17162,2010-05-01T00:00:00
DARWIN,2010,6,9032,10053,19085,2010-06-01T00:00:00
DARWIN,2010,7,12432,10236,22668,2010-07-01T00:00:00
DARWIN,2010,8,9930,10517,20447,2010-08-01T00:00:00
DARWIN,2010,9,10104,9608,19712,2010-09-01T00:00:00
DARWIN,2010,10,10326,7948,18274,2010-10-01T00:00:00
DARWIN,2010,11,8202,7770,15972,2010-11-01T00:00:00
DARWIN,2010,12,7376,12373,19749,2010-12-01T00:00:00
DARWIN,2011,1,15893,9594,25487,2011-01-01T00:00:00
DARWIN,2011,2,9685,8793,18478,2011-02-01T00:00:00
DARWIN,2011,3,10698,9766,20464,2011-03-01T00:00:00
DARWIN,2011,4,11843,11649,23492,2011-04-01T00:00:00
DARWIN,2011,5,12126,10980,23106,2011-05-01T00:00:00
DARWIN,2011,6,11490,12875,24365,2011-06-01T00:00:00
DARWIN,2011,7,17228,16951,34179,2011-07-01T00:00:00
DARWIN,2011,8,14244,16475,30719,2011-08-01T00:00:00
DARWIN,2011,9,14384,16426,30810,2011-09-01T00:00:00
DARWIN,2011,10,16324,16065,32389,2011-10-01T00:00:00
DARWIN,2011,11,14519,16635,31154,2011-11-01T00:00:00
DARWIN,2011,12,12214,20078,32292,2011-12-01T00:00:00
DARWIN,2012,1,19497,14371,33868,2012-01-01T00:00:00
DARWIN,2012,2,13713,12071,25784,2012-02-01T00:00:00
DARWIN,2012,3,12657,13290,25947,2012-03-01T00:00:00
DARWIN,2012,4,13086,14062,27148,2012-04-01T00:00:00
DARWIN,2012,5,12099,12321,24420,2012-05-01T00:00:00
DARWIN,2012,6,12603,15897,28500,2012-06-01T00:00:00
DARWIN,2012,7,17574,15555,33129,2012-07-01T00:00:00
DARWIN,2012,8,13355,14200,27555,2012-08-01T00:00:00
DARWIN,2012,9,12534,12692,25226,2012-09-01T00:00:00
DARWIN,2012,10,14405,12751,27156,2012-10-01T00:00:00
DARWIN,2012,11,11167,12510,23677,2012-11-01T00:00:00
DARWIN,2012,12,9045,17259,26304,2012-12-01T00:00:00
DARWIN,2013,1,15897,12096,27993,2013-01-01T00:00:00
DARWIN,2013,2,11276,10209,21485,2013-02-01T00:00:00
DARWIN,2013,3,11665,12739,24404,2013-03-01T00:00:00
DARWIN,2013,4,13150,13090,26240,2013-04-01T00:00:00
DARWIN,2013,5,11902,12238,24140,2013-05-01T00:00:00
DARWIN,2013,6,11490,14233,25723,2013-06-01T00:00:00
DARWIN,2013,7,17711,15892,33603,2013-07-01T00:00:00
DARWIN,2013,8,14709,16044,30753,2013-08-01T00:00:00
DARWIN,2013,9,15175,14947,30122,2013-09-01T00:00:00
DARWIN,2013,10,16029,14077,30106,2013-10-01T00:00:00
DARWIN,2013,11,12889,13846,26735,2013-11-01T00:00:00
DARWIN,2013,12,10761,21152,31913,2013-12-01T00:00:00
DARWIN,2014,1,20907,13760,34667,2014-01-01T00:00:00
DARWIN,2014,2,12288,10867,23155,2014-02-01T00:00:00
DARWIN,2014,3,12264,11944,24208,2014-03-01T00:00:00
DARWIN,2014,4,10904,11950,22854,2014-04-01T00:00:00
DARWIN,2014,5,11129,12017,23146,2014-05-01T00:00:00
DARWIN,2014,6,12073,15491,27564,2014-06-01T00:00:00
DARWIN,2014,7,16732,14403,31135,2014-07-01T00:00:00
DARWIN,2014,8,14429,15917,30346,2014-08-01T00:00:00
DARWIN,2014,9,13861,13879,27740,2014-09-01T00:00:00
DARWIN,2014,10,14688,12566,27254,2014-10-01T00:00:00
DARWIN,2014,11,10563,11258,21821,2014-11-01T00:00:00
DARWIN,2014,12,8816,15964,24780,2014-12-01T00:00:00
DARWIN,2015,1,15839,9890,25729,2015-01-01T00:00:00
DARWIN,2015,2,10012,8779,18791,2015-02-01T00:00:00
DARWIN,2015,3,9928,10166,20094,2015-03-01T00:00:00
DARWIN,2015,4,10371,9647,20018,2015-04-01T00:00:00
DARWIN,2015,5,10489,10953,21442,2015-05-01T00:00:00
DARWIN,2015,6,10295,12773,23068,2015-06-01T00:00:00
DARWIN,2015,7,14992,12248,27240,2015-07-01T00:00:00
DARWIN,2015,8,11491,12008,23499,2015-08-01T00:00:00
DARWIN,2015,9,10797,10482,21279,2015-09-01T00:00:00
DARWIN,2015,10,11222,9569,20791,2015-10-01T00:00:00
DARWIN,2015,11,9269,9372,18641,2015-11-01T00:00:00
DARWIN,2015,12,8199,13996,22195,2015-12-01T00:00:00
DARWIN,2016,1,14691,10021,24712,2016-01-01T00:00:00
DARWIN,2016,2,9106,7612,16718,2016-02-01T00:00:00
DARWIN,2016,3,8824,9100,17924,2016-03-01T00:00:00
DARWIN,2016,4,9808,10021,19829,2016-04-01T00:00:00
DARWIN,2016,5,10481,11275,21756,2016-05-01T00:00:00
DARWIN,2016,6,10734,13149,23883,2016-06-01T00:00:00
DARWIN,2016,7,15791,13694,29485,2016-07-01T00:00:00
DARWIN,2016,8,12553,12772,25325,2016-08-01T00:00:00
DARWIN,2016,9,11777,12080,23857,2016-09-01T00:00:00
DARWIN,2016,10,12234,11149,23383,2016-10-01T00:00:00
DARWIN,2016,11,9560,9637,19197,2016-11-01T00:00:00
DARWIN,2016,12,8924,17076,26000,2016-12-01T00:00:00
DARWIN,2017,1,17466,11510,28976,2017-01-01T00:00:00
DARWIN,2017,2,10799,7972,18771,2017-02-01T00:00:00
DARWIN,2017,3,9524,9890,19414,2017-03-01T00:00:00
DARWIN,2017,4,11407,11660,23067,2017-04-01T00:00:00
DARWIN,2017,5,10377,10756,21133,2017-05-01T00:00:00
DARWIN,2017,6,11386,14142,25528,2017-06-01T00:00:00
DARWIN,2017,7,14671,13244,27915,2017-07-01T00:00:00
DARWIN,2017,8,11606,12589,24195,2017-08-01T00:00:00
DARWIN,2017,9,11525,10651,22176,2017-09-01T00:00:00
DARWIN,2017,10,11330,10565,21895,2017-10-01T00:00:00
DARWIN,2017,11,9446,9662,19108,2017-11-01T00:00:00
DARWIN,2017,12,8449,14230,22679,2017-12-01T00:00:00
DARWIN,2018,1,15625,10304,25929,2018-01-01T00:00:00
DARWIN,2018,2,8919,7364,16283,2018-02-01T00:00:00
DARWIN,2018,3,7718,8106,15824,2018-03-01T00:00:00
DARWIN,2018,4,9102,9005,18107,2018-04-01T00:00:00
DARWIN,2018,5,7979,8184,16163,2018-05-01T00:00:00
DARWIN,2018,6,9976,10931,20907,2018-06-01T00:00:00
DARWIN,2018,7,10465,9930,20395,2018-07-01T00:00:00
DARWIN,2018,8,10085,10455,20540,2018-08-01T00:00:00
DARWIN,2018,9,9327,9011,18338,2018-09-01T00:00:00
DARWIN,2018,10,9424,8537,17961,2018-10-01T00:00:00
DARWIN,2018,11,8426,8618,17044,2018-11-01T00:00:00
DARWIN,2018,12,7985,13115,21100,2018-12-01T00:00:00
DARWIN,2019,1,13501,9880,23381,2019-01-01T00:00:00
DARWIN,2019,2,9136,6754,15890,2019-02-01T00:00:00
DARWIN,2019,3,7932,7402,15334,2019-03-01T00:00:00
DARWIN,2019,4,10018,10067,20085,2019-04-01T00:00:00
DARWIN,2019,5,10481,11013,21494,2019-05-01T00:00:00
DARWIN,2019,6,10830,12907,23737,2019-06-01T00:00:00
DARWIN,2019,7,14178,11800,25978,2019-07-01T00:00:00
DARWIN,2019,8,12323,12564,24887,2019-08-01T00:00:00
DARWIN,2019,9,11655,11409,23064,2019-09-01T00:00:00
DARWIN,2019,10,11996,9762,21758,2019-10-01T00:00:00
DARWIN,2019,11,9006,9238,18244,2019-11-01T00:00:00
DARWIN,2019,12,7543,14635,22178,2019-12-01T00:00:00
DARWIN,2020,1,15026,10712,25738,2020-01-01T00:00:00
DARWIN,2020,2,8685,5674,14359,2020-02-01T00:00:00
DARWIN,2020,3,4342,2910,7252,2020-03-01T00:00:00
DARWIN,2020,4,0,0,0,2020-04-01T00:00:00
DARWIN,2020,5,0,0,0,2020-05-01T00:00:00
DARWIN,2020,6,0,0,0,2020-06-01T00:00:00
DARWIN,2020,7,0,0,0,2020-07-01T00:00:00
DARWIN,2020,8,0,0,0,2020-08-01T00:00:00
DARWIN,2020,9,0,0,0,2020-09-01T00:00:00
DARWIN,2020,10,0,0,0,2020-10-01T00:00:00
DARWIN,2020,11,63,4,67,2020-11-01T00:00:00
DARWIN,2020,12,8,0,8,2020-12-01T00:00:00
DARWIN,2021,1,0,0,0,2021-01-01T00:00:00
DARWIN,2021,2,0,0,0,2021-02-01T00:00:00
DARWIN,2021,3,0,0,0,2021-03-01T00:00:00
DARWIN,2021,4,0,0,0,2021-04-01T00:00:00
DARWIN,2021,5,0,0,0,2021-05-01T00:00:00
DARWIN,2021,6,0,0,0,2021-06-01T00:00:00
DARWIN,2021,7,0,0,0,2021-07-01T00:00:00
DARWIN,2021,8,0,0,0,2021-08-01T00:00:00
DARWIN,2021,9,0,0,0,2021-09-01T00:00:00
DARWIN,2021,10,0,0,0,2021-10-01T00:00:00
DARWIN,2021,11,887,181,1068,2021-11-01T00:00:00
DARWIN,2021,12,1003,679,1682,2021-12-01T00:00:00
DARWIN,2022,1,1128,672,1800,2022-01-01T00:00:00
DARWIN,2022,2,1800,858,2658,2022-02-01T00:00:00
DARWIN,2022,3,2796,1979,4775,2022-03-01T00:00:00
DARWIN,2022,4,4633,4999,9632,2022-04-01T00:00:00
DARWIN,2022,5,5768,6601,12369,2022-05-01T00:00:00
DARWIN,2022,6,6072,7727,13799,2022-06-01T00:00:00
DARWIN,2022,7,8642,7711,16353,2022-07-01T00:00:00
DARWIN,2022,8,7483,6757,14240,2022-08-01T00:00:00
DARWIN,2022,9,6289,6134,12423,2022-09-01T00:00:00
DARWIN,2022,10,6707,5765,12472,2022-10-01T00:00:00
DARWIN,2022,11,7064,6823,13887,2022-11-01T00:00:00
DARWIN,2022,12,5409,7952,13361,2022-12-01T00:00:00
DARWIN,2023,1,7777,6134,13911,2023-01-01T00:00:00
DARWIN,2023,2,6650,5164,11814,2023-02-01T00:00:00
DARWIN,2023,3,6237,5577,11814,2023-03-01T00:00:00
DARWIN,2023,4,6319,6734,13053,2023-04-01T00:00:00
DARWIN,2023,5,6474,6504,12978,2023-05-01T00:00:00
DARWIN,2023,6,6842,7183,14025,2023-06-01T00:00:00
DARWIN,2023,7,8697,8406,17103,2023-07-01T00:00:00
DARWIN,2023,8,8403,8207,16610,2023-08-01T00:00:00
DARWIN,2023,9,8317,7713,16030,2023-09-01T00:00:00
DARWIN,2023,10,5792,4943,10735,2023-10-01T00:00:00
DARWIN,2023,11,7317,7608,14925,2023-11-01T00:00:00
DARWIN,2023,12,6170,8556,14726,2023-12-01T00:00:00
DARWIN,2024,1,8647,6677,15324,2024-01-01T00:00:00
DARWIN,2024,2,7541,6586,14127,2024-02-01T00:00:00
DARWIN,2024,3,7612,7730,15342,2024-03-01T00:00:00
DARWIN,2024,4,8507,8090,16597,2024-04-01T00:00:00
DARWIN,2024,5,8842,8847,17689,2024-05-01T00:00:00
DARWIN,2024,6,9222,9922,19144,2024-06-01T00:00:00
DARWIN,2024,7,10073,9450,19523,2024-07-01T00:00:00
DARWIN,2024,8,9476,9866,19342,2024-08-01T00:00:00
DARWIN,2024,9,9871,9937,19808,2024-09-01T00:00:00
DARWIN,2024,10,10125,9267,19392,2024-10-01T00:00:00
DARWIN,2024,11,8689,8647,17336,2024-11-01T00:00:00
DARWIN,2024,12,7328,10288,17616,2024-12-01T00:00:00
DARWIN,2025,1,9862,8335,18197,2025-01-01T00:00:00
DARWIN,2025,2,8538,7227,15765,2025-02-01T00:00:00
DARWIN,2025,3,8542,7834,16376,2025-03-01T00:00:00
DARWIN,2025,4,11429,12184,23613,2025-04-01T00:00:00
DARWIN,2025,5,11170,11190,22360,2025-05-01T00:00:00
DARWIN,2025,6,12034,13469,25503,2025-06-01T00:00:00
GOLD COAST,1985,1,0,0,0,1985-01-01T00:00:00
GOLD COAST,1985,2,0,0,0,1985-02-01T00:00:00
GOLD COAST,1985,3,0,0,0,1985-03-01T00:00:00
GOLD COAST,1985,4,0,0,0,1985-04-01T00:00:00
GOLD COAST,1985,5,0,0,0,1985-05-01T00:00:00
GOLD COAST,1985,6,0,0,0,1985-06-01T00:00:00
GOLD COAST,1985,7,0,0,0,1985-07-01T00:00:00
GOLD COAST,1985,8,0,0,0,1985-08-01T00:00:00
GOLD COAST,1985,9,0,0,0,1985-09-01T00:00:00
GOLD COAST,1985,10,0,0,0,1985-10-01T00:00:00
GOLD COAST,1985,11,0,0,0,1985-11-01T00:00:00
GOLD COAST,1985,12,0,0,0,1985-12-01T00:00:00
GOLD COAST,1986,1,0,0,0,1986-01-01T00:00:00
GOLD COAST,1986,2,0,0,0,1986-02-01T00:00:00
GOLD COAST,1986,3,0,0,0,1986-03-01T00:00:00
GOLD COAST,1986,4,0,0,0,1986-04-01T00:00:00
GOLD COAST,1986,5,0,0,0,1986-05-01T00:00:00
GOLD COAST,1986,6,0,0,0,1986-06-01T00:00:00
GOLD COAST,1986,7,0,0,0,1986-07-01T00:00:00
GOLD COAST,1986,8,0,0,0,1986-08-01T00:00:00
GOLD COAST,1986,9,0,0,0,1986-09-01T00:00:00
GOLD COAST,1986,10,0,0,0,1986-10-01T00:00:00
GOLD COAST,1986,11,0,0,0,1986-11-01T00:00:00
GOLD COAST,1986,12,0,0,0,1986-12-01T00:00:00
GOLD COAST,1987,1,0,0,0,1987-01-01T00:00:00
GOLD COAST,1987,2,0,0,0,1987-02-01T00:00:00
GOLD COAST,1987,3,0,0,0,1987-03-01T00:00:00
GOLD COAST,1987,4,0,0,0,1987-04-01T00:00:00
GOLD COAST,1987,5,0,0,0,1987-05-01T00:00:00
GOLD COAST,1987,6,0,0,0,1987-06-01T00:00:00
GOLD COAST,1987,7,0,0,0,1987-07-01T00:00:00
GOLD COAST,1987,8,0,0,0,1987-08-01T00:00:00
GOLD COAST,1987,9,0,0,0,1987-09-01T00:00:00
GOLD COAST,1987,10,0,0,0,1987-10-01T00:00:00
GOLD COAST,1987,11,0,0,0,1987-11-01T00:00:00
GOLD COAST,1987,12,0,0,0,1987-12-01T00:00:00
GOLD COAST,1988,1,0,0,0,1988-01-01T00:00:00
GOLD COAST,1988,2,0,0,0,1988-02-01T00:00:00
GOLD COAST,1988,3,0,0,0,1988-03-01T00:00:00
GOLD COAST,1988,4,0,0,0,1988-04-01T00:00:00
GOLD COAST,1988,5,0,0,0,1988-05-01T00:00:00
GOLD COAST,1988,6,0,0,0,1988-06-01T00:00:00
GOLD COAST,1988,7,0,0,0,1988-07-01T00:00:00
GOLD COAST,1988,8,0,0,0,1988-08-01T00:00:00
GOLD COAST,1988,9,0,0,0,1988-09-01T00:00:00
GOLD COAST,1988,10,0,0,0,1988-10-01T00:00:00
GOLD COAST,1988,11,0,0,0,1988-11-01T00:00:00
GOLD COAST,1988,12,0,0,0,1988-12-01T00:00:00
GOLD COAST,1989,1,0,0,0,1989-01-01T00:00:00
GOLD COAST,1989,2,0,0,0,1989-02-01T00:00:00
GOLD COAST,1989,3,0,0,0,1989-03-01T00:00:00
GOLD COAST,1989,4,0,0,0,1989-04-01T00:00:00
GOLD COAST,1989,5,0,0,0,1989-05-01T00:00:00
GOLD COAST,1989,6,0,0,0,1989-06-01T00:00:00
GOLD COAST,1989,7,0,0,0,1989-07-01T00:00:00
GOLD COAST,1989,8,0,0,0,1989-08-01T00:00:00
GOLD COAST,1989,9,0,0,0,1989-09-01T00:00:00
GOLD COAST,1989,10,0,0,0,1989-10-01T00:00:00
GOLD COAST,1989,11,0,0,0,1989-11-01T00:00:00
GOLD COAST,1989,12,0,0,0,1989-12-01T00:00:00
GOLD COAST,1990,1,0,0,0,1990-01-01T00:00:00
GOLD COAST,1990,2,0,0,0,1990-02-01T00:00:00
GOLD COAST,1990,3,0,0,0,1990-03-01T00:00:00
GOLD COAST,1990,4,0,0,0,1990-04-01T00:00:00
GOLD COAST,1990,5,0,0,0,1990-05-01T00:00:00
GOLD COAST,1990,6,0,0,0,1990-06-01T00:00:00
GOLD COAST,1990,7,0,0,0,1990-07-01T00:00:00
GOLD COAST,1990,8,0,0,0,1990-08-01T00:00:00
GOLD COAST,1990,9,0,0,0,1990-09-01T00:00:00
GOLD COAST,1990,10,0,0,0,1990-10-01T00:00:00
GOLD COAST,1990,11,0,0,0,1990-11-01T00:00:00
GOLD COAST,1990,12,0,0,0,1990-12-01T00:00:00
GOLD COAST,1991,1,0,0,0,1991-01-01T00:00:00
GOLD COAST,1991,2,0,0,0,1991-02-01T00:00:00
GOLD COAST,1991,3,0,0,0,1991-03-01T00:00:00
GOLD COAST,1991,4,0,0,0,1991-04-01T00:00:00
GOLD COAST,1991,5,0,0,0,1991-05-01T00:00:00
GOLD COAST,1991,6,0,0,0,1991-06-01T00:00:00
GOLD COAST,1991,7,0,0,0,1991-07-01T00:00:00
GOLD COAST,1991,8,0,0,0,1991-08-01T00:00:00
GOLD COAST,1991,9,0,0,0,1991-09-01T00:00:00
GOLD COAST,1991,10,0,0,0,1991-10-01T00:00:00
GOLD COAST,1991,11,0,0,0,1991-11-01T00:00:00
GOLD COAST,1991,12,0,0,0,1991-12-01T00:00:00
GOLD COAST,1992,1,0,0,0,1992-01-01T00:00:00
GOLD COAST,1992,2,0,0,0,1992-02-01T00:00:00
GOLD COAST,1992,3,0,0,0,1992-03-01T00:00:00
GOLD COAST,1992,4,0,0,0,1992-04-01T00:00:00
GOLD COAST,1992,5,0,0,0,1992-05-01T00:00:00
GOLD COAST,1992,6,0,0,0,1992-06-01T00:00:00
GOLD COAST,1992,7,0,0,0,1992-07-01T00:00:00
GOLD COAST,1992,8,0,0,0,1992-08-01T00:00:00
GOLD COAST,1992,9,0,0,0,1992-09-01T00:00:00
GOLD COAST,1992,10,0,0,0,1992-10-01T00:00:00
GOLD COAST,1992,11,0,0,0,1992-11-01T00:00:00
GOLD COAST,1992,12,0,0,0,1992-12-01T00:00:00
GOLD COAST,1993,1,0,0,0,1993-01-01T00:00:00
GOLD COAST,1993,2,0,0,0,1993-02-01T00:00:00
GOLD COAST,1993,3,0,0,0,1993-03-01T00:00:00
GOLD COAST,1993,4,0,0,0,1993-04-01T00:00:00
GOLD COAST,1993,5,0,0,0,1993-05-01T00:00:00
GOLD COAST,1993,6,0,0,0,1993-06-01T00:00:00
GOLD COAST,1993,7,0,0,0,1993-07-01T00:00:00
GOLD COAST,1993,8,0,0,0,1993-08-01T00:00:00
GOLD COAST,1993,9,0,0,0,1993-09-01T00:00:00
GOLD COAST,1993,10,0,0,0,1993-10-01T00:00:00
GOLD COAST,1993,11,0,0,0,1993-11-01T00:00:00
GOLD COAST,1993,12,0,0,0,1993-12-01T00:00:00
GOLD COAST,1994,1,0,0,0,1994-01-01T00:00:00
GOLD COAST,1994,2,0,0,0,1994-02-01T00:00:00
GOLD COAST,1994,3,0,0,0,1994-03-01T00:00:00
GOLD COAST,1994,4,0,0,0,1994-04-01T00:00:00
GOLD COAST,1994,5,0,0,0,1994-05-01T00:00:00
GOLD COAST,1994,6,0,0,0,1994-06-01T00:00:00
GOLD COAST,1994,7,0,0,0,1994-07-01T00:00:00
GOLD COAST,1994,8,0,0,0,1994-08-01T00:00:00
GOLD COAST,1994,9,0,0,0,1994-09-01T00:00:00
GOLD COAST,1994,10,0,0,0,1994-10-01T00:00:00
GOLD COAST,1994,11,0,0,0,1994-11-01T00:00:00
GOLD COAST,1994,12,0,0,0,1994-12-01T00:00:00
GOLD COAST,1995,1,0,0,0,1995-01-01T00:00:00
GOLD COAST,1995,2,0,0,0,1995-02-01T00:00:00
GOLD COAST,1995,3,0,0,0,1995-03-01T00:00:00
GOLD COAST,1995,4,0,0,0,1995-04-01T00:00:00
GOLD COAST,1995,5,0,0,0,1995-05-01T00:00:00
GOLD COAST,1995,6,0,0,0,1995-06-01T00:00:00
GOLD COAST,1995,7,0,0,0,1995-07-01T00:00:00
GOLD COAST,1995,8,0,0,0,1995-08-01T00:00:00
GOLD COAST,1995,9,0,0,0,1995-09-01T00:00:00
GOLD COAST,1995,10,0,0,0,1995-10-01T00:00:00
GOLD COAST,1995,11,0,0,0,1995-11-01T00:00:00
GOLD COAST,1995,12,0,0,0,1995-12-01T00:00:00
GOLD COAST,1996,1,0,0,0,1996-01-01T00:00:00
GOLD COAST,1996,2,0,0,0,1996-02-01T00:00:00
GOLD COAST,1996,3,0,0,0,1996-03-01T00:00:00
GOLD COAST,1996,4,0,0,0,1996-04-01T00:00:00
GOLD COAST,1996,5,0,0,0,1996-05-01T00:00:00
GOLD COAST,1996,6,0,0,0,1996-06-01T00:00:00
GOLD COAST,1996,7,0,0,0,1996-07-01T00:00:00
GOLD COAST,1996,8,0,0,0,1996-08-01T00:00:00
GOLD COAST,1996,9,0,0,0,1996-09-01T00:00:00
GOLD COAST,1996,10,0,0,0,1996-10-01T00:00:00
GOLD COAST,1996,11,0,0,0,1996-11-01T00:00:00
GOLD COAST,1996,12,214,249,463,1996-12-01T00:00:00
GOLD COAST,1997,1,325,259,584,1997-01-01T00:00:00
GOLD COAST,1997,2,0,0,0,1997-02-01T00:00:00
GOLD COAST,1997,3,185,161,346,1997-03-01T00:00:00
GOLD COAST,1997,4,449,373,822,1997-04-01T00:00:00
GOLD COAST,1997,5,574,472,1046,1997-05-01T00:00:00
GOLD COAST,1997,6,615,403,1018,1997-06-01T00:00:00
GOLD COAST,1997,7,978,796,1774,1997-07-01T00:00:00
GOLD COAST,1997,8,947,1052,1999,1997-08-01T00:00:00
GOLD COAST,1997,9,993,1132,2125,1997-09-01T00:00:00
GOLD COAST,1997,10,683,1005,1688,1997-10-01T00:00:00
GOLD COAST,1997,11,519,680,1199,1997-11-01T00:00:00
GOLD COAST,1997,12,501,720,1221,1997-12-01T00:00:00
GOLD COAST,1998,1,738,620,1358,1998-01-01T00:00:00
GOLD COAST,1998,2,410,371,781,1998-02-01T00:00:00
GOLD COAST,1998,3,551,484,1035,1998-03-01T00:00:00
GOLD COAST,1998,4,790,673,1463,1998-04-01T00:00:00
GOLD COAST,1998,5,544,439,983,1998-05-01T00:00:00
GOLD COAST,1998,6,482,357,839,1998-06-01T00:00:00
GOLD COAST,1998,7,574,611,1185,1998-07-01T00:00:00
GOLD COAST,1998,8,1087,785,1872,1998-08-01T00:00:00
GOLD COAST,1998,9,930,855,1785,1998-09-01T00:00:00
GOLD COAST,1998,10,692,879,1571,1998-10-01T00:00:00
GOLD COAST,1998,11,405,462,867,1998-11-01T00:00:00
GOLD COAST,1998,12,331,449,780,1998-12-01T00:00:00
GOLD COAST,1999,1,498,440,938,1999-01-01T00:00:00
GOLD COAST,1999,2,419,334,753,1999-02-01T00:00:00
GOLD COAST,1999,3,630,539,1169,1999-03-01T00:00:00
GOLD COAST,1999,4,964,685,1649,1999-04-01T00:00:00
GOLD COAST,1999,5,588,537,1125,1999-05-01T00:00:00
GOLD COAST,1999,6,820,669,1489,1999-06-01T00:00:00
GOLD COAST,1999,7,1059,914,1973,1999-07-01T00:00:00
GOLD COAST,1999,8,835,780,1615,1999-08-01T00:00:00
GOLD COAST,1999,9,1071,1140,2211,1999-09-01T00:00:00
GOLD COAST,1999,10,956,1116,2072,1999-10-01T00:00:00
GOLD COAST,1999,11,427,489,916,1999-11-01T00:00:00
GOLD COAST,1999,12,455,558,1013,1999-12-01T00:00:00
GOLD COAST,2000,1,701,602,1303,2000-01-01T00:00:00
GOLD COAST,2000,2,641,565,1206,2000-02-01T00:00:00
GOLD COAST,2000,3,862,656,1518,2000-03-01T00:00:00
GOLD COAST,2000,4,1422,1287,2709,2000-04-01T00:00:00
GOLD COAST,2000,5,1040,812,1852,2000-05-01T00:00:00
GOLD COAST,2000,6,1616,1252,2868,2000-06-01T00:00:00
GOLD COAST,2000,7,1513,1428,2941,2000-07-01T00:00:00
GOLD COAST,2000,8,1552,1422,2974,2000-08-01T00:00:00
GOLD COAST,2000,9,1771,1552,3323,2000-09-01T00:00:00
GOLD COAST,2000,10,1525,1662,3187,2000-10-01T00:00:00
GOLD COAST,2000,11,815,882,1697,2000-11-01T00:00:00
GOLD COAST,2000,12,1140,1420,2560,2000-12-01T00:00:00
GOLD COAST,2001,1,1916,1456,3372,2001-01-01T00:00:00
GOLD COAST,2001,2,925,1358,2283,2001-02-01T00:00:00
GOLD COAST,2001,3,1250,1028,2278,2001-03-01T00:00:00
GOLD COAST,2001,4,1652,1624,3276,2001-04-01T00:00:00
GOLD COAST,2001,5,1597,1243,2840,2001-05-01T00:00:00
GOLD COAST,2001,6,1674,1394,3068,2001-06-01T00:00:00
GOLD COAST,2001,7,1725,1702,3427,2001-07-01T00:00:00
GOLD COAST,2001,8,1506,1567,3073,2001-08-01T00:00:00
GOLD COAST,2001,9,1932,1925,3857,2001-09-01T00:00:00
GOLD COAST,2001,10,1599,1855,3454,2001-10-01T00:00:00
GOLD COAST,2001,11,2024,2030,4054,2001-11-01T00:00:00
GOLD COAST,2001,12,3131,3468,6599,2001-12-01T00:00:00
GOLD COAST,2002,1,3720,3810,7530,2002-01-01T00:00:00
GOLD COAST,2002,2,2875,2736,5611,2002-02-01T00:00:00
GOLD COAST,2002,3,4248,3690,7938,2002-03-01T00:00:00
GOLD COAST,2002,4,3681,3512,7193,2002-04-01T00:00:00
GOLD COAST,2002,5,3808,3370,7178,2002-05-01T00:00:00
GOLD COAST,2002,6,3773,3146,6919,2002-06-01T00:00:00
GOLD COAST,2002,7,4771,4547,9318,2002-07-01T00:00:00
GOLD COAST,2002,8,4422,4619,9041,2002-08-01T00:00:00
GOLD COAST,2002,9,4888,5130,10018,2002-09-01T00:00:00
GOLD COAST,2002,10,5058,5222,10280,2002-10-01T00:00:00
GOLD COAST,2002,11,7588,7171,14759,2002-11-01T00:00:00
GOLD COAST,2002,12,7984,9358,17342,2002-12-01T00:00:00
GOLD COAST,2003,1,5116,5388,10504,2003-01-01T00:00:00
GOLD COAST,2003,2,4336,4215,8551,2003-02-01T00:00:00
GOLD COAST,2003,3,6050,5250,11300,2003-03-01T00:00:00
GOLD COAST,2003,4,5969,5881,11850,2003-04-01T00:00:00
GOLD COAST,2003,5,5646,5157,10803,2003-05-01T00:00:00
GOLD COAST,2003,6,6428,5836,12264,2003-06-01T00:00:00
GOLD COAST,2003,7,7563,6282,13845,2003-07-01T00:00:00
GOLD COAST,2003,8,6372,6545,12917,2003-08-01T00:00:00
GOLD COAST,2003,9,7102,6895,13997,2003-09-01T00:00:00
GOLD COAST,2003,10,6142,6443,12585,2003-10-01T00:00:00
GOLD COAST,2003,11,4488,5372,9860,2003-11-01T00:00:00
GOLD COAST,2003,12,4795,5667,10462,2003-12-01T00:00:00
GOLD COAST,2004,1,5066,4704,9770,2004-01-01T00:00:00
GOLD COAST,2004,2,4569,4838,9407,2004-02-01T00:00:00
GOLD COAST,2004,3,5519,5198,10717,2004-03-01T00:00:00
GOLD COAST,2004,4,5665,5521,11186,2004-04-01T00:00:00
GOLD COAST,2004,5,5667,5405,11072,2004-05-01T00:00:00
GOLD COAST,2004,6,5870,5691,11561,2004-06-01T00:00:00
GOLD COAST,2004,7,6390,5798,12188,2004-07-01T00:00:00
GOLD COAST,2004,8,6273,6618,12891,2004-08-01T00:00:00
GOLD COAST,2004,9,6353,6948,13301,2004-09-01T00:00:00
GOLD COAST,2004,10,6392,6373,12765,2004-10-01T00:00:00
GOLD COAST,2004,11,4389,5269,9658,2004-11-01T00:00:00
GOLD COAST,2004,12,5401,6491,11892,2004-12-01T00:00:00
GOLD COAST,2005,1,6037,5999,12036,2005-01-01T00:00:00
GOLD COAST,2005,2,6263,6064,12327,2005-02-01T00:00:00
GOLD COAST,2005,3,7424,8000,15424,2005-03-01T00:00:00
GOLD COAST,2005,4,7717,7048,14765,2005-04-01T00:00:00
GOLD COAST,2005,5,7901,7419,15320,2005-05-01T00:00:00
GOLD COAST,2005,6,8528,8349,16877,2005-06-01T00:00:00
GOLD COAST,2005,7,10997,10163,21160,2005-07-01T00:00:00
GOLD COAST,2005,8,10430,10914,21344,2005-08-01T00:00:00
GOLD COAST,2005,9,10735,10773,21508,2005-09-01T00:00:00
GOLD COAST,2005,10,9899,11501,21400,2005-10-01T00:00:00
GOLD COAST,2005,11,5985,6939,12924,2005-11-01T00:00:00
GOLD COAST,2005,12,8875,9563,18438,2005-12-01T00:00:00
GOLD COAST,2006,1,9751,9457,19208,2006-01-01T00:00:00
GOLD COAST,2006,2,7273,8160,15433,2006-02-01T00:00:00
GOLD COAST,2006,3,8435,8245,16680,2006-03-01T00:00:00
GOLD COAST,2006,4,8022,7866,15888,2006-04-01T00:00:00
GOLD COAST,2006,5,6573,6558,13131,2006-05-01T00:00:00
GOLD COAST,2006,6,7122,6259,13381,2006-06-01T00:00:00
GOLD COAST,2006,7,9502,8701,18203,2006-07-01T00:00:00
GOLD COAST,2006,8,8496,8619,17115,2006-08-01T00:00:00
GOLD COAST,2006,9,9361,9849,19210,2006-09-01T00:00:00
GOLD COAST,2006,10,7412,8162,15574,2006-10-01T00:00:00
GOLD COAST,2006,11,6352,6957,13309,2006-11-01T00:00:00
GOLD COAST,2006,12,7837,8472,16309,2006-12-01T00:00:00
GOLD COAST,2007,1,9915,9226,19141,2007-01-01T00:00:00
GOLD COAST,2007,2,6084,6774,12858,2007-02-01T00:00:00
GOLD COAST,2007,3,7704,6928,14632,2007-03-01T00:00:00
GOLD COAST,2007,4,8079,7897,15976,2007-04-01T00:00:00
GOLD COAST,2007,5,7312,6950,14262,2007-05-01T00:00:00
GOLD COAST,2007,6,8579,7652,16231,2007-06-01T00:00:00
GOLD COAST,2007,7,9202,9031,18233,2007-07-01T00:00:00
GOLD COAST,2007,8,8932,8905,17837,2007-08-01T00:00:00
GOLD COAST,2007,9,9567,9740,19307,2007-09-01T00:00:00
GOLD COAST,2007,10,7915,8658,16573,2007-10-01T00:00:00
GOLD COAST,2007,11,9607,9760,19367,2007-11-01T00:00:00
GOLD COAST,2007,12,11860,14485,26345,2007-12-01T00:00:00
GOLD COAST,2008,1,14999,13704,28703,2008-01-01T00:00:00
GOLD COAST,2008,2,10812,10019,20831,2008-02-01T00:00:00
GOLD COAST,2008,3,11725,10663,22388,2008-03-01T00:00:00
GOLD COAST,2008,4,12113,10886,22999,2008-04-01T00:00:00
GOLD COAST,2008,5,12431,11993,24424,2008-05-01T00:00:00
GOLD COAST,2008,6,12092,11993,24085,2008-06-01T00:00:00
GOLD COAST,2008,7,15357,14199,29556,2008-07-01T00:00:00
GOLD COAST,2008,8,13320,13258,26578,2008-08-01T00:00:00
GOLD COAST,2008,9,14060,13564,27624,2008-09-01T00:00:00
GOLD COAST,2008,10,18505,16423,34928,2008-10-01T00:00:00
GOLD COAST,2008,11,16681,16336,33017,2008-11-01T00:00:00
GOLD COAST,2008,12,20801,23210,44011,2008-12-01T00:00:00
GOLD COAST,2009,1,27096,24424,51520,2009-01-01T00:00:00
GOLD COAST,2009,2,22327,20925,43252,2009-02-01T00:00:00
GOLD COAST,2009,3,24079,23976,48055,2009-03-01T00:00:00
GOLD COAST,2009,4,23212,22039,45251,2009-04-01T00:00:00
GOLD COAST,2009,5,23809,25504,49313,2009-05-01T00:00:00
GOLD COAST,2009,6,20573,21830,42403,2009-06-01T00:00:00
GOLD COAST,2009,7,25121,23157,48278,2009-07-01T00:00:00
GOLD COAST,2009,8,27415,29116,56531,2009-08-01T00:00:00
GOLD COAST,2009,9,30521,31368,61889,2009-09-01T00:00:00
GOLD COAST,2009,10,30399,31251,61650,2009-10-01T00:00:00
GOLD COAST,2009,11,30037,32235,62272,2009-11-01T00:00:00
GOLD COAST,2009,12,31049,34869,65918,2009-12-01T00:00:00
GOLD COAST,2010,1,34977,33841,68818,2010-01-01T00:00:00
GOLD COAST,2010,2,31244,31266,62510,2010-02-01T00:00:00
GOLD COAST,2010,3,35150,36218,71368,2010-03-01T00:00:00
GOLD COAST,2010,4,31212,29531,60743,2010-04-01T00:00:00
GOLD COAST,2010,5,26191,28175,54366,2010-05-01T00:00:00
GOLD COAST,2010,6,27027,28564,55591,2010-06-01T00:00:00
GOLD COAST,2010,7,33974,29982,63956,2010-07-01T00:00:00
GOLD COAST,2010,8,34085,37628,71713,2010-08-01T00:00:00
GOLD COAST,2010,9,32551,35732,68283,2010-09-01T00:00:00
GOLD COAST,2010,10,33635,33355,66990,2010-10-01T00:00:00
GOLD COAST,2010,11,30669,35394,66063,2010-11-01T00:00:00
GOLD COAST,2010,12,34186,42082,76268,2010-12-01T00:00:00
GOLD COAST,2011,1,41804,37522,79326,2011-01-01T00:00:00
GOLD COAST,2011,2,32924,31144,64068,2011-02-01T00:00:00
GOLD COAST,2011,3,32255,30531,62786,2011-03-01T00:00:00
GOLD COAST,2011,4,27558,26353,53911,2011-04-01T00:00:00
GOLD COAST,2011,5,26231,27520,53751,2011-05-01T00:00:00
GOLD COAST,2011,6,21118,23467,44585,2011-06-01T00:00:00
GOLD COAST,2011,7,28041,25173,53214,2011-07-01T00:00:00
GOLD COAST,2011,8,30677,31499,62176,2011-08-01T00:00:00
GOLD COAST,2011,9,24972,28808,53780,2011-09-01T00:00:00
GOLD COAST,2011,10,31390,28441,59831,2011-10-01T00:00:00
GOLD COAST,2011,11,28281,30597,58878,2011-11-01T00:00:00
GOLD COAST,2011,12,31054,38503,69557,2011-12-01T00:00:00
GOLD COAST,2012,1,37778,34394,72172,2012-01-01T00:00:00
GOLD COAST,2012,2,31505,29558,61063,2012-02-01T00:00:00
GOLD COAST,2012,3,31081,32987,64068,2012-03-01T00:00:00
GOLD COAST,2012,4,30159,28698,58857,2012-04-01T00:00:00
GOLD COAST,2012,5,24579,24653,49232,2012-05-01T00:00:00
GOLD COAST,2012,6,29426,32750,62176,2012-06-01T00:00:00
GOLD COAST,2012,7,40614,34658,75272,2012-07-01T00:00:00
GOLD COAST,2012,8,36010,37046,73056,2012-08-01T00:00:00
GOLD COAST,2012,9,33105,38179,71284,2012-09-01T00:00:00
GOLD COAST,2012,10,39394,36229,75623,2012-10-01T00:00:00
GOLD COAST,2012,11,35806,36323,72129,2012-11-01T00:00:00
GOLD COAST,2012,12,39944,49548,89492,2012-12-01T00:00:00
GOLD COAST,2013,1,46240,41993,88233,2013-01-01T00:00:00
GOLD COAST,2013,2,37372,33017,70389,2013-02-01T00:00:00
GOLD COAST,2013,3,37409,39839,77248,2013-03-01T00:00:00
GOLD COAST,2013,4,34455,31352,65807,2013-04-01T00:00:00
GOLD COAST,2013,5,30224,30757,60981,2013-05-01T00:00:00
GOLD COAST,2013,6,29774,33248,63022,2013-06-01T00:00:00
GOLD COAST,2013,7,38532,32125,70657,2013-07-01T00:00:00
GOLD COAST,2013,8,35168,36545,71713,2013-08-01T00:00:00
GOLD COAST,2013,9,32323,36023,68346,2013-09-01T00:00:00
GOLD COAST,2013,10,38248,34129,72377,2013-10-01T00:00:00
GOLD COAST,2013,11,33713,34421,68134,2013-11-01T00:00:00
GOLD COAST,2013,12,39707,48291,87998,2013-12-01T00:00:00
GOLD COAST,2014,1,49373,43639,93012,2014-01-01T00:00:00
GOLD COAST,2014,2,38138,35156,73294,2014-02-01T00:00:00
GOLD COAST,2014,3,37933,37464,75397,2014-03-01T00:00:00
GOLD COAST,2014,4,35779,32787,68566,2014-04-01T00:00:00
GOLD COAST,2014,5,31216,29173,60389,2014-05-01T00:00:00
GOLD COAST,2014,6,31391,34036,65427,2014-06-01T00:00:00
GOLD COAST,2014,7,41936,35206,77142,2014-07-01T00:00:00
GOLD COAST,2014,8,35563,37014,72577,2014-08-01T00:00:00
GOLD COAST,2014,9,33293,35862,69155,2014-09-01T00:00:00
GOLD COAST,2014,10,38397,34072,72469,2014-10-01T00:00:00
GOLD COAST,2014,11,33719,35565,69284,2014-11-01T00:00:00
GOLD COAST,2014,12,38278,45981,84259,2014-12-01T00:00:00
GOLD COAST,2015,1,47430,40477,87907,2015-01-01T00:00:00
GOLD COAST,2015,2,35098,32950,68048,2015-02-01T00:00:00
GOLD COAST,2015,3,37413,35449,72862,2015-03-01T00:00:00
GOLD COAST,2015,4,37202,34068,71270,2015-04-01T00:00:00
GOLD COAST,2015,5,34086,31677,65763,2015-05-01T00:00:00
GOLD COAST,2015,6,32051,36170,68221,2015-06-01T00:00:00
GOLD COAST,2015,7,49303,40515,89818,2015-07-01T00:00:00
GOLD COAST,2015,8,37253,37977,75230,2015-08-01T00:00:00
GOLD COAST,2015,9,40579,42342,82921,2015-09-01T00:00:00
GOLD COAST,2015,10,45123,40934,86057,2015-10-01T00:00:00
GOLD COAST,2015,11,38050,40108,78158,2015-11-01T00:00:00
GOLD COAST,2015,12,45218,51494,96712,2015-12-01T00:00:00
GOLD COAST,2016,1,52344,43905,96249,2016-01-01T00:00:00
GOLD COAST,2016,2,42775,36302,79077,2016-02-01T00:00:00
GOLD COAST,2016,3,46336,44337,90673,2016-03-01T00:00:00
GOLD COAST,2016,4,45883,39557,85440,2016-04-01T00:00:00
GOLD COAST,2016,5,40725,37346,78071,2016-05-01T00:00:00
GOLD COAST,2016,6,40144,43653,83797,2016-06-01T00:00:00
GOLD COAST,2016,7,59466,47514,106980,2016-07-01T00:00:00
GOLD COAST,2016,8,47794,48410,96204,2016-08-01T00:00:00
GOLD COAST,2016,9,48322,48558,96880,2016-09-01T00:00:00
GOLD COAST,2016,10,48289,44655,92944,2016-10-01T00:00:00
GOLD COAST,2016,11,41995,42664,84659,2016-11-01T00:00:00
GOLD COAST,2016,12,48627,53957,102584,2016-12-01T00:00:00
GOLD COAST,2017,1,57691,46200,103891,2017-01-01T00:00:00
GOLD COAST,2017,2,42614,36458,79072,2017-02-01T00:00:00
GOLD COAST,2017,3,44795,42345,87140,2017-03-01T00:00:00
GOLD COAST,2017,4,48791,45433,94224,2017-04-01T00:00:00
GOLD COAST,2017,5,40980,37658,78638,2017-05-01T00:00:00
GOLD COAST,2017,6,39900,41871,81771,2017-06-01T00:00:00
GOLD COAST,2017,7,53245,42828,96073,2017-07-01T00:00:00
GOLD COAST,2017,8,45310,44960,90270,2017-08-01T00:00:00
GOLD COAST,2017,9,43479,44284,87763,2017-09-01T00:00:00
GOLD COAST,2017,10,49333,44902,94235,2017-10-01T00:00:00
GOLD COAST,2017,11,41391,43142,84533,2017-11-01T00:00:00
GOLD COAST,2017,12,48111,54377,102488,2017-12-01T00:00:00
GOLD COAST,2018,1,55665,47400,103065,2018-01-01T00:00:00
GOLD COAST,2018,2,41025,37190,78215,2018-02-01T00:00:00
GOLD COAST,2018,3,44258,44035,88293,2018-03-01T00:00:00
GOLD COAST,2018,4,48166,42169,90335,2018-04-01T00:00:00
GOLD COAST,2018,5,38091,36695,74786,2018-05-01T00:00:00
GOLD COAST,2018,6,39070,41285,80355,2018-06-01T00:00:00
GOLD COAST,2018,7,50439,43182,93621,2018-07-01T00:00:00
GOLD COAST,2018,8,43070,42826,85896,2018-08-01T00:00:00
GOLD COAST,2018,9,38337,40845,79182,2018-09-01T00:00:00
GOLD COAST,2018,10,44146,42429,86575,2018-10-01T00:00:00
GOLD COAST,2018,11,35905,37921,73826,2018-11-01T00:00:00
GOLD COAST,2018,12,41245,49804,91049,2018-12-01T00:00:00
GOLD COAST,2019,1,50028,45595,95623,2019-01-01T00:00:00
GOLD COAST,2019,2,37158,33065,70223,2019-02-01T00:00:00
GOLD COAST,2019,3,37533,36254,73787,2019-03-01T00:00:00
GOLD COAST,2019,4,41791,39330,81121,2019-04-01T00:00:00
GOLD COAST,2019,5,33718,31341,65059,2019-05-01T00:00:00
GOLD COAST,2019,6,34422,37429,71851,2019-06-01T00:00:00
GOLD COAST,2019,7,46702,39113,85815,2019-07-01T00:00:00
GOLD COAST,2019,8,38835,39005,77840,2019-08-01T00:00:00
GOLD COAST,2019,9,36132,37885,74017,2019-09-01T00:00:00
GOLD COAST,2019,10,40033,37218,77251,2019-10-01T00:00:00
GOLD COAST,2019,11,34509,35596,70105,2019-11-01T00:00:00
GOLD COAST,2019,12,45674,52629,98303,2019-12-01T00:00:00
GOLD COAST,2020,1,52235,47115,99350,2020-01-01T00:00:00
GOLD COAST,2020,2,36789,32871,69660,2020-02-01T00:00:00
GOLD COAST,2020,3,20412,18038,38450,2020-03-01T00:00:00
GOLD COAST,2020,4,0,0,0,2020-04-01T00:00:00
GOLD COAST,2020,5,0,0,0,2020-05-01T00:00:00
GOLD COAST,2020,6,0,0,0,2020-06-01T00:00:00
GOLD COAST,2020,7,0,0,0,2020-07-01T00:00:00
GOLD COAST,2020,8,0,0,0,2020-08-01T00:00:00
GOLD COAST,2020,9,0,284,284,2020-09-01T00:00:00
GOLD COAST,2020,10,0,0,0,2020-10-01T00:00:00
GOLD COAST,2020,11,0,0,0,2020-11-01T00:00:00
GOLD COAST,2020,12,0,0,0,2020-12-01T00:00:00
GOLD COAST,2021,1,0,0,0,2021-01-01T00:00:00
GOLD COAST,2021,2,0,0,0,2021-02-01T00:00:00
GOLD COAST,2021,3,0,0,0,2021-03-01T00:00:00
GOLD COAST,2021,4,1797,2603,4400,2021-04-01T00:00:00
GOLD COAST,2021,5,7460,6807,14267,2021-05-01T00:00:00
GOLD COAST,2021,6,8198,7736,15934,2021-06-01T00:00:00
GOLD COAST,2021,7,4205,5438,9643,2021-07-01T00:00:00
GOLD COAST,2021,8,0,0,0,2021-08-01T00:00:00
GOLD COAST,2021,9,0,0,0,2021-09-01T00:00:00
GOLD COAST,2021,10,0,0,0,2021-10-01T00:00:00
GOLD COAST,2021,11,0,0,0,2021-11-01T00:00:00
GOLD COAST,2021,12,0,0,0,2021-12-01T00:00:00
GOLD COAST,2022,1,0,0,0,2022-01-01T00:00:00
GOLD COAST,2022,2,301,124,425,2022-02-01T00:00:00
GOLD COAST,2022,3,2983,3031,6014,2022-03-01T00:00:00
GOLD COAST,2022,4,8060,7695,15755,2022-04-01T00:00:00
GOLD COAST,2022,5,9571,8649,18220,2022-05-01T00:00:00
GOLD COAST,2022,6,15210,16385,31595,2022-06-01T00:00:00
GOLD COAST,2022,7,26229,22633,48862,2022-07-01T00:00:00
GOLD COAST,2022,8,25503,25076,50579,2022-08-01T00:00:00
GOLD COAST,2022,9,26255,26290,52545,2022-09-01T00:00:00
GOLD COAST,2022,10,27812,26387,54199,2022-10-01T00:00:00
GOLD COAST,2022,11,28108,29278,57386,2022-11-01T00:00:00
GOLD COAST,2022,12,27094,28518,55612,2022-12-01T00:00:00
GOLD COAST,2023,1,32363,28659,61022,2023-01-01T00:00:00
GOLD COAST,2023,2,28225,26802,55027,2023-02-01T00:00:00
GOLD COAST,2023,3,30936,30210,61146,2023-03-01T00:00:00
GOLD COAST,2023,4,39214,36705,75919,2023-04-01T00:00:00
GOLD COAST,2023,5,32887,30946,63833,2023-05-01T00:00:00
GOLD COAST,2023,6,35099,37464,72563,2023-06-01T00:00:00
GOLD COAST,2023,7,43785,36661,80446,2023-07-01T00:00:00
GOLD COAST,2023,8,34098,33112,67210,2023-08-01T00:00:00
GOLD COAST,2023,9,36804,37399,74203,2023-09-01T00:00:00
GOLD COAST,2023,10,36152,33809,69961,2023-10-01T00:00:00
GOLD COAST,2023,11,25198,26729,51927,2023-11-01T00:00:00
GOLD COAST,2023,12,26944,30423,57367,2023-12-01T00:00:00
GOLD COAST,2024,1,32659,29658,62317,2024-01-01T00:00:00
GOLD COAST,2024,2,23412,22061,45473,2024-02-01T00:00:00
GOLD COAST,2024,3,23851,23870,47721,2024-03-01T00:00:00
GOLD COAST,2024,4,30213,26508,56721,2024-04-01T00:00:00
GOLD COAST,2024,5,22701,21933,44634,2024-05-01T00:00:00
GOLD COAST,2024,6,24777,25347,50124,2024-06-01T00:00:00
GOLD COAST,2024,7,31207,28850,60057,2024-07-01T00:00:00
GOLD COAST,2024,8,26083,25433,51516,2024-08-01T00:00:00
GOLD COAST,2024,9,28290,27285,55575,2024-09-01T00:00:00
GOLD COAST,2024,10,27448,27488,54936,2024-10-01T00:00:00
GOLD COAST,2024,11,20316,21375,41691,2024-11-01T00:00:00
GOLD COAST,2024,12,27212,30357,57569,2024-12-01T00:00:00
GOLD COAST,2025,1,36425,31551,67976,2025-01-01T00:00:00
GOLD COAST,2025,2,19297,19400,38697,2025-02-01T00:00:00
GOLD COAST,2025,3,19224,18138,37362,2025-03-01T00:00:00
GOLD COAST,2025,4,31192,30080,61272,2025-04-01T00:00:00
GOLD COAST,2025,5,23636,22040,45676,2025-05-01T00:00:00
GOLD COAST,2025,6,26419,25524,51943,2025-06-01T00:00:00
HAMILTON ISLAND,1985,1,0,0,0,1985-01-01T00:00:00
HAMILTON ISLAND,1985,2,0,0,0,1985-02-01T00:00:00
HAMILTON ISLAND,1985,3,0,0,0,1985-03-01T00:00:00
HAMILTON ISLAND,1985,4,0,0,0,1985-04-01T00:00:00
HAMILTON ISLAND,1985,5,0,0,0,1985-05-01T00:00:00
HAMILTON ISLAND,1985,6,0,0,0,1985-06-01T00:00:00
HAMILTON ISLAND,1985,7,0,0,0,1985-07-01T00:00:00
HAMILTON ISLAND,1985,8,0,0,0,1985-08-01T00:00:00
HAMILTON ISLAND,1985,9,0,0,0,1985-09-01T00:00:00
HAMILTON ISLAND,1985,10,0,0,0,1985-10-01T00:00:00
HAMILTON ISLAND,1985,11,0,0,0,1985-11-01T00:00:00
HAMILTON ISLAND,1985,12,0,0,0,1985-12-01T00:00:00
HAMILTON ISLAND,1986,1,0,0,0,1986-01-01T00:00:00
HAMILTON ISLAND,1986,2,0,0,0,1986-02-01T00:00:00
HAMILTON ISLAND,1986,3,0,0,0,1986-03-01T00:00:00
HAMILTON ISLAND,1986,4,0,0,0,1986-04-01T00:00:00
HAMILTON ISLAND,1986,5,0,0,0,1986-05-01T00:00:00
HAMILTON ISLAND,1986,6,0,0,0,1986-06-01T00:00:00
HAMILTON ISLAND,1986,7,0,0,0,1986-07-01T00:00:00
HAMILTON ISLAND,1986,8,0,0,0,1986-08-01T00:00:00
HAMILTON ISLAND,1986,9,0,0,0,1986-09-01T00:00:00
HAMILTON ISLAND,1986,10,0,0,0,1986-10-01T00:00:00
HAMILTON ISLAND,1986,11,0,0,0,1986-11-01T00:00:00
HAMILTON ISLAND,1986,12,0,0,0,1986-12-01T00:00:00
HAMILTON ISLAND,1987,1,0,0,0,1987-01-01T00:00:00
HAMILTON ISLAND,1987,2,0,0,0,1987-02-01T00:00:00
HAMILTON ISLAND,1987,3,0,0,0,1987-03-01T00:00:00
HAMILTON ISLAND,1987,4,0,0,0,1987-04-01T00:00:00
HAMILTON ISLAND,1987,5,0,0,0,1987-05-01T00:00:00
HAMILTON ISLAND,1987,6,0,0,0,1987-06-01T00:00:00
HAMILTON ISLAND,1987,7,0,0,0,1987-07-01T00:00:00
HAMILTON ISLAND,1987,8,0,0,0,1987-08-01T00:00:00
HAMILTON ISLAND,1987,9,0,0,0,1987-09-01T00:00:00
HAMILTON ISLAND,1987,10,0,0,0,1987-10-01T00:00:00
HAMILTON ISLAND,1987,11,0,0,0,1987-11-01T00:00:00
HAMILTON ISLAND,1987,12,0,0,0,1987-12-01T00:00:00
HAMILTON ISLAND,1988,1,0,0,0,1988-01-01T00:00:00
HAMILTON ISLAND,1988,2,0,0,0,1988-02-01T00:00:00
HAMILTON ISLAND,1988,3,0,0,0,1988-03-01T00:00:00
HAMILTON ISLAND,1988,4,0,0,0,1988-04-01T00:00:00
HAMILTON ISLAND,1988,5,0,0,0,1988-05-01T00:00:00
HAMILTON ISLAND,1988,6,0,0,0,1988-06-01T00:00:00
HAMILTON ISLAND,1988,7,0,0,0,1988-07-01T00:00:00
HAMILTON ISLAND,1988,8,0,0,0,1988-08-01T00:00:00
HAMILTON ISLAND,1988,9,0,0,0,1988-09-01T00:00:00
HAMILTON ISLAND,1988,10,0,0,0,1988-10-01T00:00:00
HAMILTON ISLAND,1988,11,0,0,0,1988-11-01T00:00:00
HAMILTON ISLAND,1988,12,0,0,0,1988-12-01T00:00:00
HAMILTON ISLAND,1989,1,0,0,0,1989-01-01T00:00:00
HAMILTON ISLAND,1989,2,0,0,0,1989-02-01T00:00:00
HAMILTON ISLAND,1989,3,0,0,0,1989-03-01T00:00:00
HAMILTON ISLAND,1989,4,0,0,0,1989-04-01T00:00:00
HAMILTON ISLAND,1989,5,0,0,0,1989-05-01T00:00:00
HAMILTON ISLAND,1989,6,0,0,0,1989-06-01T00:00:00
HAMILTON ISLAND,1989,7,0,0,0,1989-07-01T00:00:00
HAMILTON ISLAND,1989,8,0,0,0,1989-08-01T00:00:00
HAMILTON ISLAND,1989,9,0,0,0,1989-09-01T00:00:00
HAMILTON ISLAND,1989,10,0,0,0,1989-10-01T00:00:00
HAMILTON ISLAND,1989,11,0,0,0,1989-11-01T00:00:00
HAMILTON ISLAND,1989,12,0,0,0,1989-12-01T00:00:00
HAMILTON ISLAND,1990,1,0,0,0,1990-01-01T00:00:00
HAMILTON ISLAND,1990,2,0,0,0,1990-02-01T00:00:00
HAMILTON ISLAND,1990,3,0,0,0,1990-03-01T00:00:00
HAMILTON ISLAND,1990,4,0,0,0,1990-04-01T00:00:00
HAMILTON ISLAND,1990,5,0,0,0,1990-05-01T00:00:00
HAMILTON ISLAND,1990,6,0,0,0,1990-06-01T00:00:00
HAMILTON ISLAND,1990,7,0,0,0,1990-07-01T00:00:00
HAMILTON ISLAND,1990,8,0,0,0,1990-08-01T00:00:00
HAMILTON ISLAND,1990,9,0,0,0,1990-09-01T00:00:00
HAMILTON ISLAND,1990,10,0,0,0,1990-10-01T00:00:00
HAMILTON ISLAND,1990,11,0,0,0,1990-11-01T00:00:00
HAMILTON ISLAND,1990,12,0,0,0,1990-12-01T00:00:00
HAMILTON ISLAND,1991,1,0,0,0,1991-01-01T00:00:00
HAMILTON ISLAND,1991,2,0,0,0,1991-02-01T00:00:00
HAMILTON ISLAND,1991,3,0,0,0,1991-03-01T00:00:00
HAMILTON ISLAND,1991,4,0,0,0,1991-04-01T00:00:00
HAMILTON ISLAND,1991,5,0,0,0,1991-05-01T00:00:00
HAMILTON ISLAND,1991,6,0,0,0,1991-06-01T00:00:00
HAMILTON ISLAND,1991,7,0,0,0,1991-07-01T00:00:00
HAMILTON ISLAND,1991,8,0,0,0,1991-08-01T00:00:00
HAMILTON ISLAND,1991,9,0,0,0,1991-09-01T00:00:00
HAMILTON ISLAND,1991,10,0,0,0,1991-10-01T00:00:00
HAMILTON ISLAND,1991,11,0,0,0,1991-11-01T00:00:00
HAMILTON ISLAND,1991,12,0,0,0,1991-12-01T00:00:00
HAMILTON ISLAND,1992,1,0,0,0,1992-01-01T00:00:00
HAMILTON ISLAND,1992,2,0,0,0,1992-02-01T00:00:00
HAMILTON ISLAND,1992,3,0,0,0,1992-03-01T00:00:00
HAMILTON ISLAND,1992,4,0,0,0,1992-04-01T00:00:00
HAMILTON ISLAND,1992,5,0,0,0,1992-05-01T00:00:00
HAMILTON ISLAND,1992,6,0,0,0,1992-06-01T00:00:00
HAMILTON ISLAND,1992,7,0,0,0,1992-07-01T00:00:00
HAMILTON ISLAND,1992,8,0,0,0,1992-08-01T00:00:00
HAMILTON ISLAND,1992,9,0,0,0,1992-09-01T00:00:00
HAMILTON ISLAND,1992,10,0,0,0,1992-10-01T00:00:00
HAMILTON ISLAND,1992,11,0,0,0,1992-11-01T00:00:00
HAMILTON ISLAND,1992,12,0,0,0,1992-12-01T00:00:00
HAMILTON ISLAND,1993,1,0,0,0,1993-01-01T00:00:00
HAMILTON ISLAND,1993,2,0,0,0,1993-02-01T00:00:00
HAMILTON ISLAND,1993,3,0,0,0,1993-03-01T00:00:00
HAMILTON ISLAND,1993,4,0,0,0,1993-04-01T00:00:00
HAMILTON ISLAND,1993,5,0,0,0,1993-05-01T00:00:00
HAMILTON ISLAND,1993,6,0,0,0,1993-06-01T00:00:00
HAMILTON ISLAND,1993,7,0,0,0,1993-07-01T00:00:00
HAMILTON ISLAND,1993,8,0,0,0,1993-08-01T00:00:00
HAMILTON ISLAND,1993,9,0,0,0,1993-09-01T00:00:00
HAMILTON ISLAND,1993,10,0,0,0,1993-10-01T00:00:00
HAMILTON ISLAND,1993,11,0,0,0,1993-11-01T00:00:00
HAMILTON ISLAND,1993,12,0,0,0,1993-12-01T00:00:00
HAMILTON ISLAND,1994,1,0,0,0,1994-01-01T00:00:00
HAMILTON ISLAND,1994,2,0,0,0,1994-02-01T00:00:00
HAMILTON ISLAND,1994,3,0,0,0,1994-03-01T00:00:00
HAMILTON ISLAND,1994,4,0,0,0,1994-04-01T00:00:00
HAMILTON ISLAND,1994,5,0,0,0,1994-05-01T00:00:00
HAMILTON ISLAND,1994,6,0,0,0,1994-06-01T00:00:00
HAMILTON ISLAND,1994,7,0,0,0,1994-07-01T00:00:00
HAMILTON ISLAND,1994,8,0,0,0,1994-08-01T00:00:00
HAMILTON ISLAND,1994,9,0,0,0,1994-09-01T00:00:00
HAMILTON ISLAND,1994,10,0,0,0,1994-10-01T00:00:00
HAMILTON ISLAND,1994,11,0,0,0,1994-11-01T00:00:00
HAMILTON ISLAND,1994,12,0,0,0,1994-12-01T00:00:00
HAMILTON ISLAND,1995,1,0,0,0,1995-01-01T00:00:00
HAMILTON ISLAND,1995,2,0,0,0,1995-02-01T00:00:00
HAMILTON ISLAND,1995,3,0,0,0,1995-03-01T00:00:00
HAMILTON ISLAND,1995,4,0,0,0,1995-04-01T00:00:00
HAMILTON ISLAND,1995,5,0,0,0,1995-05-01T00:00:00
HAMILTON ISLAND,1995,6,0,0,0,1995-06-01T00:00:00
HAMILTON ISLAND,1995,7,0,0,0,1995-07-01T00:00:00
HAMILTON ISLAND,1995,8,0,0,0,1995-08-01T00:00:00
HAMILTON ISLAND,1995,9,0,0,0,1995-09-01T00:00:00
HAMILTON ISLAND,1995,10,0,0,0,1995-10-01T00:00:00
HAMILTON ISLAND,1995,11,0,0,0,1995-11-01T00:00:00
HAMILTON ISLAND,1995,12,0,0,0,1995-12-01T00:00:00
HAMILTON ISLAND,1996,1,0,0,0,1996-01-01T00:00:00
HAMILTON ISLAND,1996,2,0,0,0,1996-02-01T00:00:00
HAMILTON ISLAND,1996,3,0,0,0,1996-03-01T00:00:00
HAMILTON ISLAND,1996,4,0,0,0,1996-04-01T00:00:00
HAMILTON ISLAND,1996,5,0,0,0,1996-05-01T00:00:00
HAMILTON ISLAND,1996,6,0,0,0,1996-06-01T00:00:00
HAMILTON ISLAND,1996,7,0,0,0,1996-07-01T00:00:00
HAMILTON ISLAND,1996,8,0,0,0,1996-08-01T00:00:00
HAMILTON ISLAND,1996,9,0,0,0,1996-09-01T00:00:00
HAMILTON ISLAND,1996,10,0,0,0,1996-10-01T00:00:00
HAMILTON ISLAND,1996,11,0,0,0,1996-11-01T00:00:00
HAMILTON ISLAND,1996,12,0,0,0,1996-12-01T00:00:00
HAMILTON ISLAND,1997,1,0,0,0,1997-01-01T00:00:00
HAMILTON ISLAND,1997,2,0,0,0,1997-02-01T00:00:00
HAMILTON ISLAND,1997,3,0,0,0,1997-03-01T00:00:00
HAMILTON ISLAND,1997,4,0,0,0,1997-04-01T00:00:00
HAMILTON ISLAND,1997,5,0,0,0,1997-05-01T00:00:00
HAMILTON ISLAND,1997,6,0,0,0,1997-06-01T00:00:00
HAMILTON ISLAND,1997,7,0,0,0,1997-07-01T00:00:00
HAMILTON ISLAND,1997,8,0,0,0,1997-08-01T00:00:00
HAMILTON ISLAND,1997,9,0,0,0,1997-09-01T00:00:00
HAMILTON ISLAND,1997,10,0,0,0,1997-10-01T00:00:00
HAMILTON ISLAND,1997,11,0,0,0,1997-11-01T00:00:00
HAMILTON ISLAND,1997,12,0,0,0,1997-12-01T00:00:00
HAMILTON ISLAND,1998,1,0,0,0,1998-01-01T00:00:00
HAMILTON ISLAND,1998,2,0,0,0,1998-02-01T00:00:00
HAMILTON ISLAND,1998,3,0,0,0,1998-03-01T00:00:00
HAMILTON ISLAND,1998,4,0,0,0,1998-04-01T00:00:00
HAMILTON ISLAND,1998,5,0,0,0,1998-05-01T00:00:00
HAMILTON ISLAND,1998,6,0,0,0,1998-06-01T00:00:00
HAMILTON ISLAND,1998,7,0,0,0,1998-07-01T00:00:00
HAMILTON ISLAND,1998,8,0,0,0,1998-08-01T00:00:00
HAMILTON ISLAND,1998,9,0,0,0,1998-09-01T00:00:00
HAMILTON ISLAND,1998,10,0,0,0,1998-10-01T00:00:00
HAMILTON ISLAND,1998,11,0,0,0,1998-11-01T00:00:00
HAMILTON ISLAND,1998,12,0,0,0,1998-12-01T00:00:00
HAMILTON ISLAND,1999,1,0,0,0,1999-01-01T00:00:00
HAMILTON ISLAND,1999,2,0,0,0,1999-02-01T00:00:00
HAMILTON ISLAND,1999,3,0,0,0,1999-03-01T00:00:00
HAMILTON ISLAND,1999,4,0,0,0,1999-04-01T00:00:00
HAMILTON ISLAND,1999,5,0,0,0,1999-05-01T00:00:00
HAMILTON ISLAND,1999,6,0,0,0,1999-06-01T00:00:00
HAMILTON ISLAND,1999,7,0,0,0,1999-07-01T00:00:00
HAMILTON ISLAND,1999,8,0,0,0,1999-08-01T00:00:00
HAMILTON ISLAND,1999,9,0,0,0,1999-09-01T00:00:00
HAMILTON ISLAND,1999,10,0,0,0,1999-10-01T00:00:00
HAMILTON ISLAND,1999,11,0,0,0,1999-11-01T00:00:00
HAMILTON ISLAND,1999,12,0,0,0,1999-12-01T00:00:00
HAMILTON ISLAND,2000,1,0,0,0,2000-01-01T00:00:00
HAMILTON ISLAND,2000,2,0,0,0,2000-02-01T00:00:00
HAMILTON ISLAND,2000,3,0,0,0,2000-03-01T00:00:00
HAMILTON ISLAND,2000,4,0,0,0,2000-04-01T00:00:00
HAMILTON ISLAND,2000,5,0,0,0,2000-05-01T00:00:00
HAMILTON ISLAND,2000,6,0,0,0,2000-06-01T00:00:00
HAMILTON ISLAND,2000,7,0,0,0,2000-07-01T00:00:00
HAMILTON ISLAND,2000,8,0,0,0,2000-08-01T00:00:00
HAMILTON ISLAND,2000,9,0,0,0,2000-09-01T00:00:00
HAMILTON ISLAND,2000,10,0,0,0,2000-10-01T00:00:00
HAMILTON ISLAND,2000,11,0,0,0,2000-11-01T00:00:00
HAMILTON ISLAND,2000,12,0,0,0,2000-12-01T00:00:00
HAMILTON ISLAND,2001,1,0,0,0,2001-01-01T00:00:00
HAMILTON ISLAND,2001,2,0,0,0,2001-02-01T00:00:00
HAMILTON ISLAND,2001,3,0,0,0,2001-03-01T00:00:00
HAMILTON ISLAND,2001,4,0,0,0,2001-04-01T00:00:00
HAMILTON ISLAND,2001,5,0,0,0,2001-05-01T00:00:00
HAMILTON ISLAND,2001,6,0,0,0,2001-06-01T00:00:00
HAMILTON ISLAND,2001,7,0,0,0,2001-07-01T00:00:00
HAMILTON ISLAND,2001,8,0,0,0,2001-08-01T00:00:00
HAMILTON ISLAND,2001,9,0,0,0,2001-09-01T00:00:00
HAMILTON ISLAND,2001,10,0,0,0,2001-10-01T00:00:00
HAMILTON ISLAND,2001,11,0,0,0,2001-11-01T00:00:00
HAMILTON ISLAND,2001,12,0,0,0,2001-12-01T00:00:00
HAMILTON ISLAND,2002,1,0,0,0,2002-01-01T00:00:00
HAMILTON ISLAND,2002,2,0,0,0,2002-02-01T00:00:00
HAMILTON ISLAND,2002,3,0,0,0,2002-03-01T00:00:00
HAMILTON ISLAND,2002,4,0,0,0,2002-04-01T00:00:00
HAMILTON ISLAND,2002,5,0,0,0,2002-05-01T00:00:00
HAMILTON ISLAND,2002,6,0,0,0,2002-06-01T00:00:00
HAMILTON ISLAND,2002,7,0,0,0,2002-07-01T00:00:00
HAMILTON ISLAND,2002,8,0,0,0,2002-08-01T00:00:00
HAMILTON ISLAND,2002,9,0,0,0,2002-09-01T00:00:00
HAMILTON ISLAND,2002,10,0,0,0,2002-10-01T00:00:00
HAMILTON ISLAND,2002,11,0,0,0,2002-11-01T00:00:00
HAMILTON ISLAND,2002,12,0,0,0,2002-12-01T00:00:00
HAMILTON ISLAND,2003,1,0,0,0,2003-01-01T00:00:00
HAMILTON ISLAND,2003,2,0,0,0,2003-02-01T00:00:00
HAMILTON ISLAND,2003,3,0,0,0,2003-03-01T00:00:00
HAMILTON ISLAND,2003,4,0,0,0,2003-04-01T00:00:00
HAMILTON ISLAND,2003,5,0,0,0,2003-05-01T00:00:00
HAMILTON ISLAND,2003,6,0,0,0,2003-06-01T00:00:00
HAMILTON ISLAND,2003,7,0,0,0,2003-07-01T00:00:00
HAMILTON ISLAND,2003,8,0,0,0,2003-08-01T00:00:00
HAMILTON ISLAND,2003,9,0,0,0,2003-09-01T00:00:00
HAMILTON ISLAND,2003,10,0,0,0,2003-10-01T00:00:00
HAMILTON ISLAND,2003,11,0,0,0,2003-11-01T00:00:00
HAMILTON ISLAND,2003,12,0,0,0,2003-12-01T00:00:00
HAMILTON ISLAND,2004,1,0,0,0,2004-01-01T00:00:00
HAMILTON ISLAND,2004,2,0,0,0,2004-02-01T00:00:00
HAMILTON ISLAND,2004,3,0,0,0,2004-03-01T00:00:00
HAMILTON ISLAND,2004,4,0,0,0,2004-04-01T00:00:00
HAMILTON ISLAND,2004,5,0,0,0,2004-05-01T00:00:00
HAMILTON ISLAND,2004,6,0,0,0,2004-06-01T00:00:00
HAMILTON ISLAND,2004,7,0,0,0,2004-07-01T00:00:00
HAMILTON ISLAND,2004,8,0,0,0,2004-08-01T00:00:00
HAMILTON ISLAND,2004,9,0,0,0,2004-09-01T00:00:00
HAMILTON ISLAND,2004,10,0,0,0,2004-10-01T00:00:00
HAMILTON ISLAND,2004,11,0,0,0,2004-11-01T00:00:00
HAMILTON ISLAND,2004,12,0,0,0,2004-12-01T00:00:00
HAMILTON ISLAND,2005,1,0,0,0,2005-01-01T00:00:00
HAMILTON ISLAND,2005,2,0,0,0,2005-02-01T00:00:00
HAMILTON ISLAND,2005,3,0,0,0,2005-03-01T00:00:00
HAMILTON ISLAND,2005,4,0,0,0,2005-04-01T00:00:00
HAMILTON ISLAND,2005,5,0,0,0,2005-05-01T00:00:00
HAMILTON ISLAND,2005,6,0,0,0,2005-06-01T00:00:00
HAMILTON ISLAND,2005,7,0,0,0,2005-07-01T00:00:00
HAMILTON ISLAND,2005,8,0,0,0,2005-08-01T00:00:00
HAMILTON ISLAND,2005,9,0,0,0,2005-09-01T00:00:00
HAMILTON ISLAND,2005,10,0,0,0,2005-10-01T00:00:00
HAMILTON ISLAND,2005,11,0,0,0,2005-11-01T00:00:00
HAMILTON ISLAND,2005,12,0,0,0,2005-12-01T00:00:00
HAMILTON ISLAND,2006,1,0,0,0,2006-01-01T00:00:00
HAMILTON ISLAND,2006,2,0,0,0,2006-02-01T00:00:00
HAMILTON ISLAND,2006,3,0,0,0,2006-03-01T00:00:00
HAMILTON ISLAND,2006,4,0,0,0,2006-04-01T00:00:00
HAMILTON ISLAND,2006,5,0,0,0,2006-05-01T00:00:00
HAMILTON ISLAND,2006,6,0,0,0,2006-06-01T00:00:00
HAMILTON ISLAND,2006,7,0,0,0,2006-07-01T00:00:00
HAMILTON ISLAND,2006,8,0,0,0,2006-08-01T00:00:00
HAMILTON ISLAND,2006,9,0,0,0,2006-09-01T00:00:00
HAMILTON ISLAND,2006,10,0,0,0,2006-10-01T00:00:00
HAMILTON ISLAND,2006,11,0,0,0,2006-11-01T00:00:00
HAMILTON ISLAND,2006,12,0,0,0,2006-12-01T00:00:00
HAMILTON ISLAND,2007,1,0,0,0,2007-01-01T00:00:00
HAMILTON ISLAND,2007,2,0,0,0,2007-02-01T00:00:00
HAMILTON ISLAND,2007,3,0,0,0,2007-03-01T00:00:00
HAMILTON ISLAND,2007,4,0,0,0,2007-04-01T00:00:00
HAMILTON ISLAND,2007,5,0,0,0,2007-05-01T00:00:00
HAMILTON ISLAND,2007,6,0,0,0,2007-06-01T00:00:00
HAMILTON ISLAND,2007,7,0,0,0,2007-07-01T00:00:00
HAMILTON ISLAND,2007,8,0,0,0,2007-08-01T00:00:00
HAMILTON ISLAND,2007,9,0,0,0,2007-09-01T00:00:00
HAMILTON ISLAND,2007,10,0,0,0,2007-10-01T00:00:00
HAMILTON ISLAND,2007,11,0,0,0,2007-11-01T00:00:00
HAMILTON ISLAND,2007,12,0,0,0,2007-12-01T00:00:00
HAMILTON ISLAND,2008,1,0,0,0,2008-01-01T00:00:00
HAMILTON ISLAND,2008,2,0,0,0,2008-02-01T00:00:00
HAMILTON ISLAND,2008,3,0,0,0,2008-03-01T00:00:00
HAMILTON ISLAND,2008,4,0,0,0,2008-04-01T00:00:00
HAMILTON ISLAND,2008,5,0,0,0,2008-05-01T00:00:00
HAMILTON ISLAND,2008,6,0,0,0,2008-06-01T00:00:00
HAMILTON ISLAND,2008,7,0,0,0,2008-07-01T00:00:00
HAMILTON ISLAND,2008,8,0,0,0,2008-08-01T00:00:00
HAMILTON ISLAND,2008,9,0,0,0,2008-09-01T00:00:00
HAMILTON ISLAND,2008,10,0,0,0,2008-10-01T00:00:00
HAMILTON ISLAND,2008,11,0,0,0,2008-11-01T00:00:00
HAMILTON ISLAND,2008,12,0,0,0,2008-12-01T00:00:00
HAMILTON ISLAND,2009,1,0,0,0,2009-01-01T00:00:00
HAMILTON ISLAND,2009,2,0,0,0,2009-02-01T00:00:00
HAMILTON ISLAND,2009,3,0,0,0,2009-03-01T00:00:00
HAMILTON ISLAND,2009,4,0,0,0,2009-04-01T00:00:00
HAMILTON ISLAND,2009,5,0,0,0,2009-05-01T00:00:00
HAMILTON ISLAND,2009,6,0,0,0,2009-06-01T00:00:00
HAMILTON ISLAND,2009,7,0,0,0,2009-07-01T00:00:00
HAMILTON ISLAND,2009,8,0,0,0,2009-08-01T00:00:00
HAMILTON ISLAND,2009,9,0,0,0,2009-09-01T00:00:00
HAMILTON ISLAND,2009,10,0,0,0,2009-10-01T00:00:00
HAMILTON ISLAND,2009,11,0,0,0,2009-11-01T00:00:00
HAMILTON ISLAND,2009,12,0,0,0,2009-12-01T00:00:00
HAMILTON ISLAND,2010,1,0,0,0,2010-01-01T00:00:00
HAMILTON ISLAND,2010,2,0,0,0,2010-02-01T00:00:00
HAMILTON ISLAND,2010,3,0,0,0,2010-03-01T00:00:00
HAMILTON ISLAND,2010,4,0,0,0,2010-04-01T00:00:00
HAMILTON ISLAND,2010,5,0,0,0,2010-05-01T00:00:00
HAMILTON ISLAND,2010,6,0,0,0,2010-06-01T00:00:00
HAMILTON ISLAND,2010,7,0,0,0,2010-07-01T00:00:00
HAMILTON ISLAND,2010,8,0,0,0,2010-08-01T00:00:00
HAMILTON ISLAND,2010,9,0,0,0,2010-09-01T00:00:00
HAMILTON ISLAND,2010,10,0,0,0,2010-10-01T00:00:00
HAMILTON ISLAND,2010,11,0,0,0,2010-11-01T00:00:00
HAMILTON ISLAND,2010,12,0,0,0,2010-12-01T00:00:00
HAMILTON ISLAND,2011,1,0,0,0,2011-01-01T00:00:00
HAMILTON ISLAND,2011,2,0,0,0,2011-02-01T00:00:00
HAMILTON ISLAND,2011,3,0,0,0,2011-03-01T00:00:00
HAMILTON ISLAND,2011,4,0,0,0,2011-04-01T00:00:00
HAMILTON ISLAND,2011,5,0,0,0,2011-05-01T00:00:00
HAMILTON ISLAND,2011,6,0,0,0,2011-06-01T00:00:00
HAMILTON ISLAND,2011,7,0,0,0,2011-07-01T00:00:00
HAMILTON ISLAND,2011,8,0,0,0,2011-08-01T00:00:00
HAMILTON ISLAND,2011,9,0,0,0,2011-09-01T00:00:00
HAMILTON ISLAND,2011,10,0,0,0,2011-10-01T00:00:00
HAMILTON ISLAND,2011,11,0,0,0,2011-11-01T00:00:00
HAMILTON ISLAND,2011,12,0,0,0,2011-12-01T00:00:00
HAMILTON ISLAND,2012,1,0,0,0,2012-01-01T00:00:00
HAMILTON ISLAND,2012,2,0,0,0,2012-02-01T00:00:00
HAMILTON ISLAND,2012,3,0,0,0,2012-03-01T00:00:00
HAMILTON ISLAND,2012,4,0,0,0,2012-04-01T00:00:00
HAMILTON ISLAND,2012,5,0,0,0,2012-05-01T00:00:00
HAMILTON ISLAND,2012,6,0,0,0,2012-06-01T00:00:00
HAMILTON ISLAND,2012,7,0,0,0,2012-07-01T00:00:00
HAMILTON ISLAND,2012,8,0,0,0,2012-08-01T00:00:00
HAMILTON ISLAND,2012,9,0,0,0,2012-09-01T00:00:00
HAMILTON ISLAND,2012,10,0,0,0,2012-10-01T00:00:00
HAMILTON ISLAND,2012,11,0,0,0,2012-11-01T00:00:00
HAMILTON ISLAND,2012,12,0,0,0,2012-12-01T00:00:00
HAMILTON ISLAND,2013,1,0,0,0,2013-01-01T00:00:00
HAMILTON ISLAND,2013,2,0,0,0,2013-02-01T00:00:00
HAMILTON ISLAND,2013,3,0,0,0,2013-03-01T00:00:00
HAMILTON ISLAND,2013,4,0,0,0,2013-04-01T00:00:00
HAMILTON ISLAND,2013,5,0,0,0,2013-05-01T00:00:00
HAMILTON ISLAND,2013,6,0,0,0,2013-06-01T00:00:00
HAMILTON ISLAND,2013,7,0,0,0,2013-07-01T00:00:00
HAMILTON ISLAND,2013,8,0,0,0,2013-08-01T00:00:00
HAMILTON ISLAND,2013,9,0,0,0,2013-09-01T00:00:00
HAMILTON ISLAND,2013,10,0,0,0,2013-10-01T00:00:00
HAMILTON ISLAND,2013,11,0,0,0,2013-11-01T00:00:00
HAMILTON ISLAND,2013,12,0,0,0,2013-12-01T00:00:00
HAMILTON ISLAND,2014,1,0,0,0,2014-01-01T00:00:00
HAMILTON ISLAND,2014,2,0,0,0,2014-02-01T00:00:00
HAMILTON ISLAND,2014,3,0,0,0,2014-03-01T00:00:00
HAMILTON ISLAND,2014,4,0,0,0,2014-04-01T00:00:00
HAMILTON ISLAND,2014,5,0,0,0,2014-05-01T00:00:00
HAMILTON ISLAND,2014,6,0,0,0,2014-06-01T00:00:00
HAMILTON ISLAND,2014,7,0,0,0,2014-07-01T00:00:00
HAMILTON ISLAND,2014,8,0,0,0,2014-08-01T00:00:00
HAMILTON ISLAND,2014,9,0,0,0,2014-09-01T00:00:00
HAMILTON ISLAND,2014,10,0,0,0,2014-10-01T00:00:00
HAMILTON ISLAND,2014,11,0,0,0,2014-11-01T00:00:00
HAMILTON ISLAND,2014,12,0,0,0,2014-12-01T00:00:00
HAMILTON ISLAND,2015,1,0,0,0,2015-01-01T00:00:00
HAMILTON ISLAND,2015,2,0,0,0,2015-02-01T00:00:00
HAMILTON ISLAND,2015,3,0,0,0,2015-03-01T00:00:00
HAMILTON ISLAND,2015,4,0,0,0,2015-04-01T00:00:00
HAMILTON ISLAND,2015,5,0,0,0,2015-05-01T00:00:00
HAMILTON ISLAND,2015,6,0,0,0,2015-06-01T00:00:00
HAMILTON ISLAND,2015,7,0,0,0,2015-07-01T00:00:00
HAMILTON ISLAND,2015,8,0,0,0,2015-08-01T00:00:00
HAMILTON ISLAND,2015,9,0,0,0,2015-09-01T00:00:00
HAMILTON ISLAND,2015,10,0,0,0,2015-10-01T00:00:00
HAMILTON ISLAND,2015,11,0,0,0,2015-11-01T00:00:00
HAMILTON ISLAND,2015,12,0,0,0,2015-12-01T00:00:00
HAMILTON ISLAND,2016,1,0,0,0,2016-01-01T00:00:00
HAMILTON ISLAND,2016,2,0,0,0,2016-02-01T00:00:00
HAMILTON ISLAND,2016,3,0,0,0,2016-03-01T00:00:00
HAMILTON ISLAND,2016,4,0,0,0,2016-04-01T00:00:00
HAMILTON ISLAND,2016,5,0,0,0,2016-05-01T00:00:00
HAMILTON ISLAND,2016,6,0,0,0,2016-06-01T00:00:00
HAMILTON ISLAND,2016,7,0,0,0,2016-07-01T00:00:00
HAMILTON ISLAND,2016,8,0,0,0,2016-08-01T00:00:00
HAMILTON ISLAND,2016,9,0,0,0,2016-09-01T00:00:00
HAMILTON ISLAND,2016,10,0,0,0,2016-10-01T00:00:00
HAMILTON ISLAND,2016,11,0,0,0,2016-11-01T00:00:00
HAMILTON ISLAND,2016,12,0,0,0,2016-12-01T00:00:00
HAMILTON ISLAND,2017,1,0,0,0,2017-01-01T00:00:00
HAMILTON ISLAND,2017,2,0,0,0,2017-02-01T00:00:00
HAMILTON ISLAND,2017,3,0,0,0,2017-03-01T00:00:00
HAMILTON ISLAND,2017,4,0,0,0,2017-04-01T00:00:00
HAMILTON ISLAND,2017,5,0,0,0,2017-05-01T00:00:00
HAMILTON ISLAND,2017,6,0,0,0,2017-06-01T00:00:00
HAMILTON ISLAND,2017,7,0,0,0,2017-07-01T00:00:00
HAMILTON ISLAND,2017,8,0,0,0,2017-08-01T00:00:00
HAMILTON ISLAND,2017,9,0,0,0,2017-09-01T00:00:00
HAMILTON ISLAND,2017,10,0,0,0,2017-10-01T00:00:00
HAMILTON ISLAND,2017,11,0,0,0,2017-11-01T00:00:00
HAMILTON ISLAND,2017,12,0,0,0,2017-12-01T00:00:00
HAMILTON ISLAND,2018,1,0,0,0,2018-01-01T00:00:00
HAMILTON ISLAND,2018,2,0,0,0,2018-02-01T00:00:00
HAMILTON ISLAND,2018,3,0,0,0,2018-03-01T00:00:00
HAMILTON ISLAND,2018,4,0,0,0,2018-04-01T00:00:00
HAMILTON ISLAND,2018,5,0,0,0,2018-05-01T00:00:00
HAMILTON ISLAND,2018,6,0,0,0,2018-06-01T00:00:00
HAMILTON ISLAND,2018,7,0,0,0,2018-07-01T00:00:00
HAMILTON ISLAND,2018,8,0,0,0,2018-08-01T00:00:00
HAMILTON ISLAND,2018,9,0,0,0,2018-09-01T00:00:00
HAMILTON ISLAND,2018,10,0,0,0,2018-10-01T00:00:00
HAMILTON ISLAND,2018,11,0,0,0,2018-11-01T00:00:00
HAMILTON ISLAND,2018,12,0,0,0,2018-12-01T00:00:00
HAMILTON ISLAND,2019,1,0,0,0,2019-01-01T00:00:00
HAMILTON ISLAND,2019,2,0,0,0,2019-02-01T00:00:00
HAMILTON ISLAND,2019,3,0,0,0,2019-03-01T00:00:00
HAMILTON ISLAND,2019,4,0,0,0,2019-04-01T00:00:00
HAMILTON ISLAND,2019,5,0,0,0,2019-05-01T00:00:00
HAMILTON ISLAND,2019,6,0,0,0,2019-06-01T00:00:00
HAMILTON ISLAND,2019,7,0,0,0,2019-07-01T00:00:00
HAMILTON ISLAND,2019,8,0,0,0,2019-08-01T00:00:00
HAMILTON ISLAND,2019,9,0,0,0,2019-09-01T00:00:00
HAMILTON ISLAND,2019,10,0,0,0,2019-10-01T00:00:00
HAMILTON ISLAND,2019,11,0,0,0,2019-11-01T00:00:00
HAMILTON ISLAND,2019,12,0,0,0,2019-12-01T00:00:00
HAMILTON ISLAND,2020,1,0,0,0,2020-01-01T00:00:00
HAMILTON ISLAND,2020,2,0,0,0,2020-02-01T00:00:00
HAMILTON ISLAND,2020,3,0,0,0,2020-03-01T00:00:00
HAMILTON ISLAND,2020,4,0,0,0,2020-04-01T00:00:00
HAMILTON ISLAND,2020,5,0,0,0,2020-05-01T00:00:00
HAMILTON ISLAND,2020,6,0,0,0,2020-06-01T00:00:00
HAMILTON ISLAND,2020,7,0,0,0,2020-07-01T00:00:00
HAMILTON ISLAND,2020,8,0,0,0,2020-08-01T00:00:00
HAMILTON ISLAND,2020,9,0,0,0,2020-09-01T00:00:00
HAMILTON ISLAND,2020,10,0,0,0,2020-10-01T00:00:00
HAMILTON ISLAND,2020,11,0,0,0,2020-11-01T00:00:00
HAMILTON ISLAND,2020,12,0,0,0,2020-12-01T00:00:00
HAMILTON ISLAND,2021,1,0,0,0,2021-01-01T00:00:00
HAMILTON ISLAND,2021,2,0,0,0,2021-02-01T00:00:00
HAMILTON ISLAND,2021,3,0,0,0,2021-03-01T00:00:00
HAMILTON ISLAND,2021,4,0,0,0,2021-04-01T00:00:00
HAMILTON ISLAND,2021,5,0,0,0,2021-05-01T00:00:00
HAMILTON ISLAND,2021,6,0,0,0,2021-06-01T00:00:00
HAMILTON ISLAND,2021,7,0,0,0,2021-07-01T00:00:00
HAMILTON ISLAND,2021,8,0,0,0,2021-08-01T00:00:00
HAMILTON ISLAND,2021,9,0,0,0,2021-09-01T00:00:00
HAMILTON ISLAND,2021,10,0,0,0,2021-10-01T00:00:00
HAMILTON ISLAND,2021,11,0,0,0,2021-11-01T00:00:00
HAMILTON ISLAND,2021,12,0,0,0,2021-12-01T00:00:00
HAMILTON ISLAND,2022,1,0,0,0,2022-01-01T00:00:00
HAMILTON ISLAND,2022,2,0,0,0,2022-02-01T00:00:00
HAMILTON ISLAND,2022,3,0,0,0,2022-03-01T00:00:00
HAMILTON ISLAND,2022,4,0,0,0,2022-04-01T00:00:00
HAMILTON ISLAND,2022,5,0,0,0,2022-05-01T00:00:00
HAMILTON ISLAND,2022,6,0,0,0,2022-06-01T00:00:00
HAMILTON ISLAND,2022,7,0,0,0,2022-07-01T00:00:00
HAMILTON ISLAND,2022,8,0,0,0,2022-08-01T00:00:00
HAMILTON ISLAND,2022,9,0,0,0,2022-09-01T00:00:00
HAMILTON ISLAND,2022,10,0,0,0,2022-10-01T00:00:00
HAMILTON ISLAND,2022,11,0,0,0,2022-11-01T00:00:00
HAMILTON ISLAND,2022,12,0,0,0,2022-12-01T00:00:00
HAMILTON ISLAND,2023,1,0,0,0,2023-01-01T00:00:00
HAMILTON ISLAND,2023,2,0,0,0,2023-02-01T00:00:00
HAMILTON ISLAND,2023,3,0,0,0,2023-03-01T00:00:00
HAMILTON ISLAND,2023,4,0,0,0,2023-04-01T00:00:00
HAMILTON ISLAND,2023,5,0,0,0,2023-05-01T00:00:00
HAMILTON ISLAND,2023,6,0,0,0,2023-06-01T00:00:00
HAMILTON ISLAND,2023,7,0,0,0,2023-07-01T00:00:00
HAMILTON ISLAND,2023,8,0,0,0,2023-08-01T00:00:00
HAMILTON ISLAND,2023,9,0,0,0,2023-09-01T00:00:00
HAMILTON ISLAND,2023,10,0,0,0,2023-10-01T00:00:00
HAMILTON ISLAND,2023,11,0,0,0,2023-11-01T00:00:00
HAMILTON ISLAND,2023,12,0,0,0,2023-12-01T00:00:00
HAMILTON ISLAND,2024,1,0,0,0,2024-01-01T00:00:00
HAMILTON ISLAND,2024,2,0,0,0,2024-02-01T00:00:00
HAMILTON ISLAND,2024,3,0,0,0,2024-03-01T00:00:00
HAMILTON ISLAND,2024,4,0,0,0,2024-04-01T00:00:00
HAMILTON ISLAND,2024,5,0,0,0,2024-05-01T00:00:00
HAMILTON ISLAND,2024,6,0,0,0,2024-06-01T00:00:00
HAMILTON ISLAND,2024,7,0,0,0,2024-07-01T00:00:00
HAMILTON ISLAND,2024,8,0,0,0,2024-08-01T00:00:00
HAMILTON ISLAND,2024,9,0,0,0,2024-09-01T00:00:00
HAMILTON ISLAND,2024,10,0,0,0,2024-10-01T00:00:00
HAMILTON ISLAND,2024,11,0,0,0,2024-11-01T00:00:00
HAMILTON ISLAND,2024,12,0,0,0,2024-12-01T00:00:00
HAMILTON ISLAND,2025,1,0,0,0,2025-01-01T00:00:00
HAMILTON ISLAND,2025,2,0,0,0,2025-02-01T00:00:00
HAMILTON ISLAND,2025,3,0,0,0,2025-03-01T00:00:00
HAMILTON ISLAND,2025,4,0,0,0,2025-04-01T00:00:00
HAMILTON ISLAND,2025,5,0,0,0,2025-05-01T00:00:00
HAMILTON ISLAND,2025,6,0,0,0,2025-06-01T00:00:00
HOBART,1985,1,903,886,1789,1985-01-01T00:00:00
HOBART,1985,2,776,587,1363,1985-02-01T00:00:00
HOBART,1985,3,938,735,1673,1985-03-01T00:00:00
HOBART,1985,4,618,517,1135,1985-04-01T00:00:00
HOBART,1985,5,743,593,1336,1985-05-01T00:00:00
HOBART,1985,6,657,559,1216,1985-06-01T00:00:00
HOBART,1985,7,304,350,654,1985-07-01T00:00:00
HOBART,1985,8,414,611,1025,1985-08-01T00:00:00
HOBART,1985,9,729,525,1254,1985-09-01T00:00:00
HOBART,1985,10,587,374,961,1985-10-01T00:00:00
HOBART,1985,11,472,610,1082,1985-11-01T00:00:00
HOBART,1985,12,770,1048,1818,1985-12-01T00:00:00
HOBART,1986,1,734,601,1335,1986-01-01T00:00:00
HOBART,1986,2,902,669,1571,1986-02-01T00:00:00
HOBART,1986,3,811,652,1463,1986-03-01T00:00:00
HOBART,1986,4,617,410,1027,1986-04-01T00:00:00
HOBART,1986,5,497,412,909,1986-05-01T00:00:00
HOBART,1986,6,678,477,1155,1986-06-01T00:00:00
HOBART,1986,7,478,392,870,1986-07-01T00:00:00
HOBART,1986,8,257,320,577,1986-08-01T00:00:00
HOBART,1986,9,967,813,1780,1986-09-01T00:00:00
HOBART,1986,10,504,412,916,1986-10-01T00:00:00
HOBART,1986,11,622,611,1233,1986-11-01T00:00:00
HOBART,1986,12,697,611,1308,1986-12-01T00:00:00
HOBART,1987,1,1027,1136,2163,1987-01-01T00:00:00
HOBART,1987,2,937,732,1669,1987-02-01T00:00:00
HOBART,1987,3,994,717,1711,1987-03-01T00:00:00
HOBART,1987,4,714,629,1343,1987-04-01T00:00:00
HOBART,1987,5,728,707,1435,1987-05-01T00:00:00
HOBART,1987,6,559,380,939,1987-06-01T00:00:00
HOBART,1987,7,432,388,820,1987-07-01T00:00:00
HOBART,1987,8,620,627,1247,1987-08-01T00:00:00
HOBART,1987,9,650,472,1122,1987-09-01T00:00:00
HOBART,1987,10,820,729,1549,1987-10-01T00:00:00
HOBART,1987,11,682,690,1372,1987-11-01T00:00:00
HOBART,1987,12,1249,803,2052,1987-12-01T00:00:00
HOBART,1988,1,994,1037,2031,1988-01-01T00:00:00
HOBART,1988,2,1043,633,1676,1988-02-01T00:00:00
HOBART,1988,3,715,625,1340,1988-03-01T00:00:00
HOBART,1988,4,668,641,1309,1988-04-01T00:00:00
HOBART,1988,5,491,512,1003,1988-05-01T00:00:00
HOBART,1988,6,469,343,812,1988-06-01T00:00:00
HOBART,1988,7,473,389,862,1988-07-01T00:00:00
HOBART,1988,8,506,534,1040,1988-08-01T00:00:00
HOBART,1988,9,633,567,1200,1988-09-01T00:00:00
HOBART,1988,10,806,614,1420,1988-10-01T00:00:00
HOBART,1988,11,661,605,1266,1988-11-01T00:00:00
HOBART,1988,12,687,717,1404,1988-12-01T00:00:00
HOBART,1989,1,826,868,1694,1989-01-01T00:00:00
HOBART,1989,2,1035,609,1644,1989-02-01T00:00:00
HOBART,1989,3,813,596,1409,1989-03-01T00:00:00
HOBART,1989,4,758,700,1458,1989-04-01T00:00:00
HOBART,1989,5,461,548,1009,1989-05-01T00:00:00
HOBART,1989,6,491,372,863,1989-06-01T00:00:00
HOBART,1989,7,473,511,984,1989-07-01T00:00:00
HOBART,1989,8,547,547,1094,1989-08-01T00:00:00
HOBART,1989,9,756,606,1362,1989-09-01T00:00:00
HOBART,1989,10,722,641,1363,1989-10-01T00:00:00
HOBART,1989,11,627,564,1191,1989-11-01T00:00:00
HOBART,1989,12,821,843,1664,1989-12-01T00:00:00
HOBART,1990,1,763,1061,1824,1990-01-01T00:00:00
HOBART,1990,2,1110,687,1797,1990-02-01T00:00:00
HOBART,1990,3,925,782,1707,1990-03-01T00:00:00
HOBART,1990,4,726,706,1432,1990-04-01T00:00:00
HOBART,1990,5,513,619,1132,1990-05-01T00:00:00
HOBART,1990,6,677,449,1126,1990-06-01T00:00:00
HOBART,1990,7,677,419,1096,1990-07-01T00:00:00
HOBART,1990,8,562,508,1070,1990-08-01T00:00:00
HOBART,1990,9,871,657,1528,1990-09-01T00:00:00
HOBART,1990,10,838,530,1368,1990-10-01T00:00:00
HOBART,1990,11,639,629,1268,1990-11-01T00:00:00
HOBART,1990,12,862,885,1747,1990-12-01T00:00:00
HOBART,1991,1,804,793,1597,1991-01-01T00:00:00
HOBART,1991,2,994,650,1644,1991-02-01T00:00:00
HOBART,1991,3,934,911,1845,1991-03-01T00:00:00
HOBART,1991,4,410,335,745,1991-04-01T00:00:00
HOBART,1991,5,335,400,735,1991-05-01T00:00:00
HOBART,1991,6,513,373,886,1991-06-01T00:00:00
HOBART,1991,7,342,353,695,1991-07-01T00:00:00
HOBART,1991,8,426,450,876,1991-08-01T00:00:00
HOBART,1991,9,348,386,734,1991-09-01T00:00:00
HOBART,1991,10,277,187,464,1991-10-01T00:00:00
HOBART,1991,11,393,421,814,1991-11-01T00:00:00
HOBART,1991,12,409,321,730,1991-12-01T00:00:00
HOBART,1992,1,343,492,835,1992-01-01T00:00:00
HOBART,1992,2,512,440,952,1992-02-01T00:00:00
HOBART,1992,3,402,394,796,1992-03-01T00:00:00
HOBART,1992,4,394,389,783,1992-04-01T00:00:00
HOBART,1992,5,428,416,844,1992-05-01T00:00:00
HOBART,1992,6,314,186,500,1992-06-01T00:00:00
HOBART,1992,7,190,195,385,1992-07-01T00:00:00
HOBART,1992,8,391,500,891,1992-08-01T00:00:00
HOBART,1992,9,408,307,715,1992-09-01T00:00:00
HOBART,1992,10,400,346,746,1992-10-01T00:00:00
HOBART,1992,11,273,257,530,1992-11-01T00:00:00
HOBART,1992,12,381,301,682,1992-12-01T00:00:00
HOBART,1993,1,507,548,1055,1993-01-01T00:00:00
HOBART,1993,2,651,388,1039,1993-02-01T00:00:00
HOBART,1993,3,448,409,857,1993-03-01T00:00:00
HOBART,1993,4,333,273,606,1993-04-01T00:00:00
HOBART,1993,5,447,452,899,1993-05-01T00:00:00
HOBART,1993,6,255,177,432,1993-06-01T00:00:00
HOBART,1993,7,313,314,627,1993-07-01T00:00:00
HOBART,1993,8,300,287,587,1993-08-01T00:00:00
HOBART,1993,9,379,273,652,1993-09-01T00:00:00
HOBART,1993,10,416,270,686,1993-10-01T00:00:00
HOBART,1993,11,370,355,725,1993-11-01T00:00:00
HOBART,1993,12,396,306,702,1993-12-01T00:00:00
HOBART,1994,1,474,489,963,1994-01-01T00:00:00
HOBART,1994,2,405,398,803,1994-02-01T00:00:00
HOBART,1994,3,416,386,802,1994-03-01T00:00:00
HOBART,1994,4,490,419,909,1994-04-01T00:00:00
HOBART,1994,5,243,295,538,1994-05-01T00:00:00
HOBART,1994,6,160,131,291,1994-06-01T00:00:00
HOBART,1994,7,179,152,331,1994-07-01T00:00:00
HOBART,1994,8,247,303,550,1994-08-01T00:00:00
HOBART,1994,9,330,301,631,1994-09-01T00:00:00
HOBART,1994,10,403,288,691,1994-10-01T00:00:00
HOBART,1994,11,330,326,656,1994-11-01T00:00:00
HOBART,1994,12,411,400,811,1994-12-01T00:00:00
HOBART,1995,1,315,388,703,1995-01-01T00:00:00
HOBART,1995,2,263,260,523,1995-02-01T00:00:00
HOBART,1995,3,336,378,714,1995-03-01T00:00:00
HOBART,1995,4,404,440,844,1995-04-01T00:00:00
HOBART,1995,5,280,242,522,1995-05-01T00:00:00
HOBART,1995,6,202,184,386,1995-06-01T00:00:00
HOBART,1995,7,272,238,510,1995-07-01T00:00:00
HOBART,1995,8,204,218,422,1995-08-01T00:00:00
HOBART,1995,9,415,326,741,1995-09-01T00:00:00
HOBART,1995,10,343,199,542,1995-10-01T00:00:00
HOBART,1995,11,383,290,673,1995-11-01T00:00:00
HOBART,1995,12,431,351,782,1995-12-01T00:00:00
HOBART,1996,1,399,380,779,1996-01-01T00:00:00
HOBART,1996,2,363,295,658,1996-02-01T00:00:00
HOBART,1996,3,501,462,963,1996-03-01T00:00:00
HOBART,1996,4,344,264,608,1996-04-01T00:00:00
HOBART,1996,5,164,190,354,1996-05-01T00:00:00
HOBART,1996,6,121,52,173,1996-06-01T00:00:00
HOBART,1996,7,0,0,0,1996-07-01T00:00:00
HOBART,1996,8,0,0,0,1996-08-01T00:00:00
HOBART,1996,9,0,0,0,1996-09-01T00:00:00
HOBART,1996,10,197,101,298,1996-10-01T00:00:00
HOBART,1996,11,415,302,717,1996-11-01T00:00:00
HOBART,1996,12,281,272,553,1996-12-01T00:00:00
HOBART,1997,1,382,302,684,1997-01-01T00:00:00
HOBART,1997,2,358,277,635,1997-02-01T00:00:00
HOBART,1997,3,422,343,765,1997-03-01T00:00:00
HOBART,1997,4,314,264,578,1997-04-01T00:00:00
HOBART,1997,5,0,0,0,1997-05-01T00:00:00
HOBART,1997,6,0,0,0,1997-06-01T00:00:00
HOBART,1997,7,0,0,0,1997-07-01T00:00:00
HOBART,1997,8,0,0,0,1997-08-01T00:00:00
HOBART,1997,9,0,0,0,1997-09-01T00:00:00
HOBART,1997,10,0,0,0,1997-10-01T00:00:00
HOBART,1997,11,364,213,577,1997-11-01T00:00:00
HOBART,1997,12,277,173,450,1997-12-01T00:00:00
HOBART,1998,1,341,390,731,1998-01-01T00:00:00
HOBART,1998,2,369,340,709,1998-02-01T00:00:00
HOBART,1998,3,397,282,679,1998-03-01T00:00:00
HOBART,1998,4,301,270,571,1998-04-01T00:00:00
HOBART,1998,5,0,0,0,1998-05-01T00:00:00
HOBART,1998,6,0,0,0,1998-06-01T00:00:00
HOBART,1998,7,0,0,0,1998-07-01T00:00:00
HOBART,1998,8,0,0,0,1998-08-01T00:00:00
HOBART,1998,9,0,0,0,1998-09-01T00:00:00
HOBART,1998,10,0,0,0,1998-10-01T00:00:00
HOBART,1998,11,0,0,0,1998-11-01T00:00:00
HOBART,1998,12,0,0,0,1998-12-01T00:00:00
HOBART,1999,1,0,0,0,1999-01-01T00:00:00
HOBART,1999,2,0,0,0,1999-02-01T00:00:00
HOBART,1999,3,0,0,0,1999-03-01T00:00:00
HOBART,1999,4,0,0,0,1999-04-01T00:00:00
HOBART,1999,5,0,0,0,1999-05-01T00:00:00
HOBART,1999,6,0,0,0,1999-06-01T00:00:00
HOBART,1999,7,0,0,0,1999-07-01T00:00:00
HOBART,1999,8,0,0,0,1999-08-01T00:00:00
HOBART,1999,9,0,0,0,1999-09-01T00:00:00
HOBART,1999,10,0,0,0,1999-10-01T00:00:00
HOBART,1999,11,0,0,0,1999-11-01T00:00:00
HOBART,1999,12,0,0,0,1999-12-01T00:00:00
HOBART,2000,1,0,0,0,2000-01-01T00:00:00
HOBART,2000,2,0,0,0,2000-02-01T00:00:00
HOBART,2000,3,0,0,0,2000-03-01T00:00:00
HOBART,2000,4,0,0,0,2000-04-01T00:00:00
HOBART,2000,5,0,0,0,2000-05-01T00:00:00
HOBART,2000,6,0,0,0,2000-06-01T00:00:00
HOBART,2000,7,0,0,0,2000-07-01T00:00:00
HOBART,2000,8,0,0,0,2000-08-01T00:00:00
HOBART,2000,9,0,0,0,2000-09-01T00:00:00
HOBART,2000,10,0,0,0,2000-10-01T00:00:00
HOBART,2000,11,0,0,0,2000-11-01T00:00:00
HOBART,2000,12,0,0,0,2000-12-01T00:00:00
HOBART,2001,1,0,0,0,2001-01-01T00:00:00
HOBART,2001,2,0,0,0,2001-02-01T00:00:00
HOBART,2001,3,0,0,0,2001-03-01T00:00:00
HOBART,2001,4,0,0,0,2001-04-01T00:00:00
HOBART,2001,5,0,0,0,2001-05-01T00:00:00
HOBART,2001,6,0,0,0,2001-06-01T00:00:00
HOBART,2001,7,0,0,0,2001-07-01T00:00:00
HOBART,2001,8,0,0,0,2001-08-01T00:00:00
HOBART,2001,9,0,0,0,2001-09-01T00:00:00
HOBART,2001,10,0,0,0,2001-10-01T00:00:00
HOBART,2001,11,0,0,0,2001-11-01T00:00:00
HOBART,2001,12,0,0,0,2001-12-01T00:00:00
HOBART,2002,1,0,0,0,2002-01-01T00:00:00
HOBART,2002,2,0,0,0,2002-02-01T00:00:00
HOBART,2002,3,0,0,0,2002-03-01T00:00:00
HOBART,2002,4,0,0,0,2002-04-01T00:00:00
HOBART,2002,5,0,0,0,2002-05-01T00:00:00
HOBART,2002,6,0,0,0,2002-06-01T00:00:00
HOBART,2002,7,0,0,0,2002-07-01T00:00:00
HOBART,2002,8,0,0,0,2002-08-01T00:00:00
HOBART,2002,9,0,0,0,2002-09-01T00:00:00
HOBART,2002,10,0,0,0,2002-10-01T00:00:00
HOBART,2002,11,0,0,0,2002-11-01T00:00:00
HOBART,2002,12,0,0,0,2002-12-01T00:00:00
HOBART,2003,1,0,0,0,2003-01-01T00:00:00
HOBART,2003,2,0,0,0,2003-02-01T00:00:00
HOBART,2003,3,0,0,0,2003-03-01T00:00:00
HOBART,2003,4,0,0,0,2003-04-01T00:00:00
HOBART,2003,5,0,0,0,2003-05-01T00:00:00
HOBART,2003,6,0,0,0,2003-06-01T00:00:00
HOBART,2003,7,0,0,0,2003-07-01T00:00:00
HOBART,2003,8,0,0,0,2003-08-01T00:00:00
HOBART,2003,9,0,0,0,2003-09-01T00:00:00
HOBART,2003,10,0,0,0,2003-10-01T00:00:00
HOBART,2003,11,0,0,0,2003-11-01T00:00:00
HOBART,2003,12,0,0,0,2003-12-01T00:00:00
HOBART,2004,1,0,0,0,2004-01-01T00:00:00
HOBART,2004,2,0,0,0,2004-02-01T00:00:00
HOBART,2004,3,0,0,0,2004-03-01T00:00:00
HOBART,2004,4,0,0,0,2004-04-01T00:00:00
HOBART,2004,5,0,0,0,2004-05-01T00:00:00
HOBART,2004,6,0,0,0,2004-06-01T00:00:00
HOBART,2004,7,0,0,0,2004-07-01T00:00:00
HOBART,2004,8,0,0,0,2004-08-01T00:00:00
HOBART,2004,9,0,0,0,2004-09-01T00:00:00
HOBART,2004,10,0,0,0,2004-10-01T00:00:00
HOBART,2004,11,0,0,0,2004-11-01T00:00:00
HOBART,2004,12,0,0,0,2004-12-01T00:00:00
HOBART,2005,1,0,0,0,2005-01-01T00:00:00
HOBART,2005,2,0,0,0,2005-02-01T00:00:00
HOBART,2005,3,0,0,0,2005-03-01T00:00:00
HOBART,2005,4,0,0,0,2005-04-01T00:00:00
HOBART,2005,5,0,0,0,2005-05-01T00:00:00
HOBART,2005,6,0,0,0,2005-06-01T00:00:00
HOBART,2005,7,0,0,0,2005-07-01T00:00:00
HOBART,2005,8,0,0,0,2005-08-01T00:00:00
HOBART,2005,9,0,0,0,2005-09-01T00:00:00
HOBART,2005,10,0,0,0,2005-10-01T00:00:00
HOBART,2005,11,0,0,0,2005-11-01T00:00:00
HOBART,2005,12,0,0,0,2005-12-01T00:00:00
HOBART,2006,1,0,0,0,2006-01-01T00:00:00
HOBART,2006,2,0,0,0,2006-02-01T00:00:00
HOBART,2006,3,0,0,0,2006-03-01T00:00:00
HOBART,2006,4,0,0,0,2006-04-01T00:00:00
HOBART,2006,5,0,0,0,2006-05-01T00:00:00
HOBART,2006,6,0,0,0,2006-06-01T00:00:00
HOBART,2006,7,0,0,0,2006-07-01T00:00:00
HOBART,2006,8,0,0,0,2006-08-01T00:00:00
HOBART,2006,9,0,0,0,2006-09-01T00:00:00
HOBART,2006,10,0,0,0,2006-10-01T00:00:00
HOBART,2006,11,0,0,0,2006-11-01T00:00:00
HOBART,2006,12,0,0,0,2006-12-01T00:00:00
HOBART,2007,1,0,0,0,2007-01-01T00:00:00
HOBART,2007,2,0,0,0,2007-02-01T00:00:00
HOBART,2007,3,0,0,0,2007-03-01T00:00:00
HOBART,2007,4,0,0,0,2007-04-01T00:00:00
HOBART,2007,5,0,0,0,2007-05-01T00:00:00
HOBART,2007,6,0,0,0,2007-06-01T00:00:00
HOBART,2007,7,0,0,0,2007-07-01T00:00:00
HOBART,2007,8,0,0,0,2007-08-01T00:00:00
HOBART,2007,9,0,0,0,2007-09-01T00:00:00
HOBART,2007,10,0,0,0,2007-10-01T00:00:00
HOBART,2007,11,0,0,0,2007-11-01T00:00:00
HOBART,2007,12,0,0,0,2007-12-01T00:00:00
HOBART,2008,1,0,0,0,2008-01-01T00:00:00
HOBART,2008,2,0,0,0,2008-02-01T00:00:00
HOBART,2008,3,0,0,0,2008-03-01T00:00:00
HOBART,2008,4,0,0,0,2008-04-01T00:00:00
HOBART,2008,5,0,0,0,2008-05-01T00:00:00
HOBART,2008,6,0,0,0,2008-06-01T00:00:00
HOBART,2008,7,0,0,0,2008-07-01T00:00:00
HOBART,2008,8,0,0,0,2008-08-01T00:00:00
HOBART,2008,9,0,0,0,2008-09-01T00:00:00
HOBART,2008,10,0,0,0,2008-10-01T00:00:00
HOBART,2008,11,0,0,0,2008-11-01T00:00:00
HOBART,2008,12,0,0,0,2008-12-01T00:00:00
HOBART,2009,1,0,0,0,2009-01-01T00:00:00
HOBART,2009,2,0,0,0,2009-02-01T00:00:00
HOBART,2009,3,0,0,0,2009-03-01T00:00:00
HOBART,2009,4,0,0,0,2009-04-01T00:00:00
HOBART,2009,5,0,0,0,2009-05-01T00:00:00
HOBART,2009,6,0,0,0,2009-06-01T00:00:00
HOBART,2009,7,0,0,0,2009-07-01T00:00:00
HOBART,2009,8,0,0,0,2009-08-01T00:00:00
HOBART,2009,9,0,0,0,2009-09-01T00:00:00
HOBART,2009,10,0,0,0,2009-10-01T00:00:00
HOBART,2009,11,0,0,0,2009-11-01T00:00:00
HOBART,2009,12,0,0,0,2009-12-01T00:00:00
HOBART,2010,1,0,0,0,2010-01-01T00:00:00
HOBART,2010,2,0,0,0,2010-02-01T00:00:00
HOBART,2010,3,0,0,0,2010-03-01T00:00:00
HOBART,2010,4,0,0,0,2010-04-01T00:00:00
HOBART,2010,5,0,0,0,2010-05-01T00:00:00
HOBART,2010,6,0,0,0,2010-06-01T00:00:00
HOBART,2010,7,0,0,0,2010-07-01T00:00:00
HOBART,2010,8,0,0,0,2010-08-01T00:00:00
HOBART,2010,9,0,0,0,2010-09-01T00:00:00
HOBART,2010,10,0,0,0,2010-10-01T00:00:00
HOBART,2010,11,0,0,0,2010-11-01T00:00:00
HOBART,2010,12,0,0,0,2010-12-01T00:00:00
HOBART,2011,1,0,0,0,2011-01-01T00:00:00
HOBART,2011,2,0,0,0,2011-02-01T00:00:00
HOBART,2011,3,0,0,0,2011-03-01T00:00:00
HOBART,2011,4,0,0,0,2011-04-01T00:00:00
HOBART,2011,5,0,0,0,2011-05-01T00:00:00
HOBART,2011,6,0,0,0,2011-06-01T00:00:00
HOBART,2011,7,0,0,0,2011-07-01T00:00:00
HOBART,2011,8,0,0,0,2011-08-01T00:00:00
HOBART,2011,9,0,0,0,2011-09-01T00:00:00
HOBART,2011,10,0,0,0,2011-10-01T00:00:00
HOBART,2011,11,0,0,0,2011-11-01T00:00:00
HOBART,2011,12,0,0,0,2011-12-01T00:00:00
HOBART,2012,1,0,0,0,2012-01-01T00:00:00
HOBART,2012,2,0,0,0,2012-02-01T00:00:00
HOBART,2012,3,0,0,0,2012-03-01T00:00:00
HOBART,2012,4,0,0,0,2012-04-01T00:00:00
HOBART,2012,5,0,0,0,2012-05-01T00:00:00
HOBART,2012,6,0,0,0,2012-06-01T00:00:00
HOBART,2012,7,0,0,0,2012-07-01T00:00:00
HOBART,2012,8,0,0,0,2012-08-01T00:00:00
HOBART,2012,9,0,0,0,2012-09-01T00:00:00
HOBART,2012,10,0,0,0,2012-10-01T00:00:00
HOBART,2012,11,0,0,0,2012-11-01T00:00:00
HOBART,2012,12,0,0,0,2012-12-01T00:00:00
HOBART,2013,1,0,0,0,2013-01-01T00:00:00
HOBART,2013,2,0,0,0,2013-02-01T00:00:00
HOBART,2013,3,0,0,0,2013-03-01T00:00:00
HOBART,2013,4,0,0,0,2013-04-01T00:00:00
HOBART,2013,5,0,0,0,2013-05-01T00:00:00
HOBART,2013,6,0,0,0,2013-06-01T00:00:00
HOBART,2013,7,0,0,0,2013-07-01T00:00:00
HOBART,2013,8,0,0,0,2013-08-01T00:00:00
HOBART,2013,9,0,0,0,2013-09-01T00:00:00
HOBART,2013,10,0,0,0,2013-10-01T00:00:00
HOBART,2013,11,0,0,0,2013-11-01T00:00:00
HOBART,2013,12,0,0,0,2013-12-01T00:00:00
HOBART,2014,1,0,0,0,2014-01-01T00:00:00
HOBART,2014,2,0,0,0,2014-02-01T00:00:00
HOBART,2014,3,0,0,0,2014-03-01T00:00:00
HOBART,2014,4,0,0,0,2014-04-01T00:00:00
HOBART,2014,5,0,0,0,2014-05-01T00:00:00
HOBART,2014,6,0,0,0,2014-06-01T00:00:00
HOBART,2014,7,0,0,0,2014-07-01T00:00:00
HOBART,2014,8,0,0,0,2014-08-01T00:00:00
HOBART,2014,9,0,0,0,2014-09-01T00:00:00
HOBART,2014,10,0,0,0,2014-10-01T00:00:00
HOBART,2014,11,0,0,0,2014-11-01T00:00:00
HOBART,2014,12,0,0,0,2014-12-01T00:00:00
HOBART,2015,1,0,0,0,2015-01-01T00:00:00
HOBART,2015,2,0,0,0,2015-02-01T00:00:00
HOBART,2015,3,0,0,0,2015-03-01T00:00:00
HOBART,2015,4,0,0,0,2015-04-01T00:00:00
HOBART,2015,5,0,0,0,2015-05-01T00:00:00
HOBART,2015,6,0,0,0,2015-06-01T00:00:00
HOBART,2015,7,0,0,0,2015-07-01T00:00:00
HOBART,2015,8,0,0,0,2015-08-01T00:00:00
HOBART,2015,9,0,0,0,2015-09-01T00:00:00
HOBART,2015,10,0,0,0,2015-10-01T00:00:00
HOBART,2015,11,0,0,0,2015-11-01T00:00:00
HOBART,2015,12,0,0,0,2015-12-01T00:00:00
HOBART,2016,1,0,0,0,2016-01-01T00:00:00
HOBART,2016,2,0,0,0,2016-02-01T00:00:00
HOBART,2016,3,0,0,0,2016-03-01T00:00:00
HOBART,2016,4,0,0,0,2016-04-01T00:00:00
HOBART,2016,5,0,0,0,2016-05-01T00:00:00
HOBART,2016,6,0,0,0,2016-06-01T00:00:00
HOBART,2016,7,0,0,0,2016-07-01T00:00:00
HOBART,2016,8,0,0,0,2016-08-01T00:00:00
HOBART,2016,9,0,0,0,2016-09-01T00:00:00
HOBART,2016,10,0,0,0,2016-10-01T00:00:00
HOBART,2016,11,0,0,0,2016-11-01T00:00:00
HOBART,2016,12,0,0,0,2016-12-01T00:00:00
HOBART,2017,1,0,0,0,2017-01-01T00:00:00
HOBART,2017,2,0,0,0,2017-02-01T00:00:00
HOBART,2017,3,0,0,0,2017-03-01T00:00:00
HOBART,2017,4,0,0,0,2017-04-01T00:00:00
HOBART,2017,5,0,0,0,2017-05-01T00:00:00
HOBART,2017,6,0,0,0,2017-06-01T00:00:00
HOBART,2017,7,0,0,0,2017-07-01T00:00:00
HOBART,2017,8,0,0,0,2017-08-01T00:00:00
HOBART,2017,9,0,0,0,2017-09-01T00:00:00
HOBART,2017,10,0,0,0,2017-10-01T00:00:00
HOBART,2017,11,0,0,0,2017-11-01T00:00:00
HOBART,2017,12,0,0,0,2017-12-01T00:00:00
HOBART,2018,1,0,0,0,2018-01-01T00:00:00
HOBART,2018,2,0,0,0,2018-02-01T00:00:00
HOBART,2018,3,0,0,0,2018-03-01T00:00:00
HOBART,2018,4,0,0,0,2018-04-01T00:00:00
HOBART,2018,5,0,0,0,2018-05-01T00:00:00
HOBART,2018,6,0,0,0,2018-06-01T00:00:00
HOBART,2018,7,0,0,0,2018-07-01T00:00:00
HOBART,2018,8,0,0,0,2018-08-01T00:00:00
HOBART,2018,9,0,0,0,2018-09-01T00:00:00
HOBART,2018,10,0,0,0,2018-10-01T00:00:00
HOBART,2018,11,0,0,0,2018-11-01T00:00:00
HOBART,2018,12,0,0,0,2018-12-01T00:00:00
HOBART,2019,1,0,0,0,2019-01-01T00:00:00
HOBART,2019,2,0,0,0,2019-02-01T00:00:00
HOBART,2019,3,0,0,0,2019-03-01T00:00:00
HOBART,2019,4,0,0,0,2019-04-01T00:00:00
HOBART,2019,5,0,0,0,2019-05-01T00:00:00
HOBART,2019,6,0,0,0,2019-06-01T00:00:00
HOBART,2019,7,0,0,0,2019-07-01T00:00:00
HOBART,2019,8,0,0,0,2019-08-01T00:00:00
HOBART,2019,9,0,0,0,2019-09-01T00:00:00
HOBART,2019,10,0,0,0,2019-10-01T00:00:00
HOBART,2019,11,0,0,0,2019-11-01T00:00:00
HOBART,2019,12,0,0,0,2019-12-01T00:00:00
HOBART,2020,1,0,0,0,2020-01-01T00:00:00
HOBART,2020,2,0,0,0,2020-02-01T00:00:00
HOBART,2020,3,0,0,0,2020-03-01T00:00:00
HOBART,2020,4,0,0,0,2020-04-01T00:00:00
HOBART,2020,5,0,0,0,2020-05-01T00:00:00
HOBART,2020,6,0,0,0,2020-06-01T00:00:00
HOBART,2020,7,0,0,0,2020-07-01T00:00:00
HOBART,2020,8,0,0,0,2020-08-01T00:00:00
HOBART,2020,9,0,0,0,2020-09-01T00:00:00
HOBART,2020,10,0,0,0,2020-10-01T00:00:00
HOBART,2020,11,0,0,0,2020-11-01T00:00:00
HOBART,2020,12,0,0,0,2020-12-01T00:00:00
HOBART,2021,1,0,0,0,2021-01-01T00:00:00
HOBART,2021,2,0,0,0,2021-02-01T00:00:00
HOBART,2021,3,0,0,0,2021-03-01T00:00:00
HOBART,2021,4,137,183,320,2021-04-01T00:00:00
HOBART,2021,5,488,562,1050,2021-05-01T00:00:00
HOBART,2021,6,689,702,1391,2021-06-01T00:00:00
HOBART,2021,7,833,886,1719,2021-07-01T00:00:00
HOBART,2021,8,0,0,0,2021-08-01T00:00:00
HOBART,2021,9,0,0,0,2021-09-01T00:00:00
HOBART,2021,10,0,0,0,2021-10-01T00:00:00
HOBART,2021,11,0,0,0,2021-11-01T00:00:00
HOBART,2021,12,0,0,0,2021-12-01T00:00:00
HOBART,2022,1,0,0,0,2022-01-01T00:00:00
HOBART,2022,2,0,0,0,2022-02-01T00:00:00
HOBART,2022,3,0,0,0,2022-03-01T00:00:00
HOBART,2022,4,0,0,0,2022-04-01T00:00:00
HOBART,2022,5,0,0,0,2022-05-01T00:00:00
HOBART,2022,6,0,0,0,2022-06-01T00:00:00
HOBART,2022,7,753,716,1469,2022-07-01T00:00:00
HOBART,2022,8,547,565,1112,2022-08-01T00:00:00
HOBART,2022,9,947,904,1851,2022-09-01T00:00:00
HOBART,2022,10,1508,1468,2976,2022-10-01T00:00:00
HOBART,2022,11,1778,1801,3579,2022-11-01T00:00:00
HOBART,2022,12,1730,1810,3540,2022-12-01T00:00:00
HOBART,2023,1,2065,1997,4062,2023-01-01T00:00:00
HOBART,2023,2,1576,1483,3059,2023-02-01T00:00:00
HOBART,2023,3,1813,1830,3643,2023-03-01T00:00:00
HOBART,2023,4,1788,1848,3636,2023-04-01T00:00:00
HOBART,2023,5,905,965,1870,2023-05-01T00:00:00
HOBART,2023,6,812,847,1659,2023-06-01T00:00:00
HOBART,2023,7,808,873,1681,2023-07-01T00:00:00
HOBART,2023,8,722,691,1413,2023-08-01T00:00:00
HOBART,2023,9,907,889,1796,2023-09-01T00:00:00
HOBART,2023,10,1328,1307,2635,2023-10-01T00:00:00
HOBART,2023,11,1884,1970,3854,2023-11-01T00:00:00
HOBART,2023,12,1297,1310,2607,2023-12-01T00:00:00
HOBART,2024,1,1529,1606,3135,2024-01-01T00:00:00
HOBART,2024,2,1944,1970,3914,2024-02-01T00:00:00
HOBART,2024,3,1992,2175,4167,2024-03-01T00:00:00
HOBART,2024,4,275,281,556,2024-04-01T00:00:00
HOBART,2024,5,0,0,0,2024-05-01T00:00:00
HOBART,2024,6,0,0,0,2024-06-01T00:00:00
HOBART,2024,7,0,0,0,2024-07-01T00:00:00
HOBART,2024,8,0,0,0,2024-08-01T00:00:00
HOBART,2024,9,0,0,0,2024-09-01T00:00:00
HOBART,2024,10,436,372,808,2024-10-01T00:00:00
HOBART,2024,11,1836,1905,3741,2024-11-01T00:00:00
HOBART,2024,12,2013,1958,3971,2024-12-01T00:00:00
HOBART,2025,1,1873,1877,3750,2025-01-01T00:00:00
HOBART,2025,2,1834,1735,3569,2025-02-01T00:00:00
HOBART,2025,3,2129,2129,4258,2025-03-01T00:00:00
HOBART,2025,4,0,0,0,2025-04-01T00:00:00
HOBART,2025,5,0,0,0,2025-05-01T00:00:00
HOBART,2025,6,0,0,0,2025-06-01T00:00:00
KARRATHA,1985,1,0,0,0,1985-01-01T00:00:00
KARRATHA,1985,2,0,0,0,1985-02-01T00:00:00
KARRATHA,1985,3,0,0,0,1985-03-01T00:00:00
KARRATHA,1985,4,0,0,0,1985-04-01T00:00:00
KARRATHA,1985,5,0,0,0,1985-05-01T00:00:00
KARRATHA,1985,6,0,0,0,1985-06-01T00:00:00
KARRATHA,1985,7,0,0,0,1985-07-01T00:00:00
KARRATHA,1985,8,0,0,0,1985-08-01T00:00:00
KARRATHA,1985,9,0,0,0,1985-09-01T00:00:00
KARRATHA,1985,10,0,0,0,1985-10-01T00:00:00
KARRATHA,1985,11,0,0,0,1985-11-01T00:00:00
KARRATHA,1985,12,0,0,0,1985-12-01T00:00:00
KARRATHA,1986,1,0,0,0,1986-01-01T00:00:00
KARRATHA,1986,2,0,0,0,1986-02-01T00:00:00
KARRATHA,1986,3,0,0,0,1986-03-01T00:00:00
KARRATHA,1986,4,0,0,0,1986-04-01T00:00:00
KARRATHA,1986,5,0,0,0,1986-05-01T00:00:00
KARRATHA,1986,6,0,0,0,1986-06-01T00:00:00
KARRATHA,1986,7,0,0,0,1986-07-01T00:00:00
KARRATHA,1986,8,0,0,0,1986-08-01T00:00:00
KARRATHA,1986,9,0,0,0,1986-09-01T00:00:00
KARRATHA,1986,10,0,0,0,1986-10-01T00:00:00
KARRATHA,1986,11,0,0,0,1986-11-01T00:00:00
KARRATHA,1986,12,0,0,0,1986-12-01T00:00:00
KARRATHA,1987,1,0,0,0,1987-01-01T00:00:00
KARRATHA,1987,2,0,0,0,1987-02-01T00:00:00
KARRATHA,1987,3,0,0,0,1987-03-01T00:00:00
KARRATHA,1987,4,0,0,0,1987-04-01T00:00:00
KARRATHA,1987,5,0,0,0,1987-05-01T00:00:00
KARRATHA,1987,6,0,0,0,1987-06-01T00:00:00
KARRATHA,1987,7,0,0,0,1987-07-01T00:00:00
KARRATHA,1987,8,0,0,0,1987-08-01T00:00:00
KARRATHA,1987,9,0,0,0,1987-09-01T00:00:00
KARRATHA,1987,10,0,0,0,1987-10-01T00:00:00
KARRATHA,1987,11,0,0,0,1987-11-01T00:00:00
KARRATHA,1987,12,0,0,0,1987-12-01T00:00:00
KARRATHA,1988,1,0,0,0,1988-01-01T00:00:00
KARRATHA,1988,2,0,0,0,1988-02-01T00:00:00
KARRATHA,1988,3,0,0,0,1988-03-01T00:00:00
KARRATHA,1988,4,0,0,0,1988-04-01T00:00:00
KARRATHA,1988,5,0,0,0,1988-05-01T00:00:00
KARRATHA,1988,6,0,0,0,1988-06-01T00:00:00
KARRATHA,1988,7,0,0,0,1988-07-01T00:00:00
KARRATHA,1988,8,0,0,0,1988-08-01T00:00:00
KARRATHA,1988,9,0,0,0,1988-09-01T00:00:00
KARRATHA,1988,10,0,0,0,1988-10-01T00:00:00
KARRATHA,1988,11,0,0,0,1988-11-01T00:00:00
KARRATHA,1988,12,0,0,0,1988-12-01T00:00:00
KARRATHA,1989,1,0,0,0,1989-01-01T00:00:00
KARRATHA,1989,2,0,0,0,1989-02-01T00:00:00
KARRATHA,1989,3,0,0,0,1989-03-01T00:00:00
KARRATHA,1989,4,0,0,0,1989-04-01T00:00:00
KARRATHA,1989,5,0,0,0,1989-05-01T00:00:00
KARRATHA,1989,6,0,0,0,1989-06-01T00:00:00
KARRATHA,1989,7,0,0,0,1989-07-01T00:00:00
KARRATHA,1989,8,0,0,0,1989-08-01T00:00:00
KARRATHA,1989,9,0,0,0,1989-09-01T00:00:00
KARRATHA,1989,10,0,0,0,1989-10-01T00:00:00
KARRATHA,1989,11,0,0,0,1989-11-01T00:00:00
KARRATHA,1989,12,0,0,0,1989-12-01T00:00:00
KARRATHA,1990,1,0,0,0,1990-01-01T00:00:00
KARRATHA,1990,2,0,0,0,1990-02-01T00:00:00
KARRATHA,1990,3,0,0,0,1990-03-01T00:00:00
KARRATHA,1990,4,0,0,0,1990-04-01T00:00:00
KARRATHA,1990,5,0,0,0,1990-05-01T00:00:00
KARRATHA,1990,6,0,0,0,1990-06-01T00:00:00
KARRATHA,1990,7,0,0,0,1990-07-01T00:00:00
KARRATHA,1990,8,0,0,0,1990-08-01T00:00:00
KARRATHA,1990,9,0,0,0,1990-09-01T00:00:00
KARRATHA,1990,10,0,0,0,1990-10-01T00:00:00
KARRATHA,1990,11,0,0,0,1990-11-01T00:00:00
KARRATHA,1990,12,0,0,0,1990-12-01T00:00:00
KARRATHA,1991,1,0,0,0,1991-01-01T00:00:00
KARRATHA,1991,2,0,0,0,1991-02-01T00:00:00
KARRATHA,1991,3,0,0,0,1991-03-01T00:00:00
KARRATHA,1991,4,0,0,0,1991-04-01T00:00:00
KARRATHA,1991,5,0,0,0,1991-05-01T00:00:00
KARRATHA,1991,6,0,0,0,1991-06-01T00:00:00
KARRATHA,1991,7,0,0,0,1991-07-01T00:00:00
KARRATHA,1991,8,0,0,0,1991-08-01T00:00:00
KARRATHA,1991,9,0,0,0,1991-09-01T00:00:00
KARRATHA,1991,10,0,0,0,1991-10-01T00:00:00
KARRATHA,1991,11,0,0,0,1991-11-01T00:00:00
KARRATHA,1991,12,0,0,0,1991-12-01T00:00:00
KARRATHA,1992,1,0,0,0,1992-01-01T00:00:00
KARRATHA,1992,2,0,0,0,1992-02-01T00:00:00
KARRATHA,1992,3,0,0,0,1992-03-01T00:00:00
KARRATHA,1992,4,0,0,0,1992-04-01T00:00:00
KARRATHA,1992,5,0,0,0,1992-05-01T00:00:00
KARRATHA,1992,6,0,0,0,1992-06-01T00:00:00
KARRATHA,1992,7,0,0,0,1992-07-01T00:00:00
KARRATHA,1992,8,0,0,0,1992-08-01T00:00:00
KARRATHA,1992,9,0,0,0,1992-09-01T00:00:00
KARRATHA,1992,10,0,0,0,1992-10-01T00:00:00
KARRATHA,1992,11,0,0,0,1992-11-01T00:00:00
KARRATHA,1992,12,0,0,0,1992-12-01T00:00:00
KARRATHA,1993,1,0,0,0,1993-01-01T00:00:00
KARRATHA,1993,2,0,0,0,1993-02-01T00:00:00
KARRATHA,1993,3,0,0,0,1993-03-01T00:00:00
KARRATHA,1993,4,0,0,0,1993-04-01T00:00:00
KARRATHA,1993,5,0,0,0,1993-05-01T00:00:00
KARRATHA,1993,6,0,0,0,1993-06-01T00:00:00
KARRATHA,1993,7,0,0,0,1993-07-01T00:00:00
KARRATHA,1993,8,0,0,0,1993-08-01T00:00:00
KARRATHA,1993,9,0,0,0,1993-09-01T00:00:00
KARRATHA,1993,10,0,0,0,1993-10-01T00:00:00
KARRATHA,1993,11,0,0,0,1993-11-01T00:00:00
KARRATHA,1993,12,0,0,0,1993-12-01T00:00:00
KARRATHA,1994,1,0,0,0,1994-01-01T00:00:00
KARRATHA,1994,2,0,0,0,1994-02-01T00:00:00
KARRATHA,1994,3,0,0,0,1994-03-01T00:00:00
KARRATHA,1994,4,0,0,0,1994-04-01T00:00:00
KARRATHA,1994,5,0,0,0,1994-05-01T00:00:00
KARRATHA,1994,6,0,0,0,1994-06-01T00:00:00
KARRATHA,1994,7,0,0,0,1994-07-01T00:00:00
KARRATHA,1994,8,0,0,0,1994-08-01T00:00:00
KARRATHA,1994,9,0,0,0,1994-09-01T00:00:00
KARRATHA,1994,10,0,0,0,1994-10-01T00:00:00
KARRATHA,1994,11,0,0,0,1994-11-01T00:00:00
KARRATHA,1994,12,0,0,0,1994-12-01T00:00:00
KARRATHA,1995,1,0,0,0,1995-01-01T00:00:00
KARRATHA,1995,2,0,0,0,1995-02-01T00:00:00
KARRATHA,1995,3,0,0,0,1995-03-01T00:00:00
KARRATHA,1995,4,0,0,0,1995-04-01T00:00:00
KARRATHA,1995,5,0,0,0,1995-05-01T00:00:00
KARRATHA,1995,6,0,0,0,1995-06-01T00:00:00
KARRATHA,1995,7,0,0,0,1995-07-01T00:00:00
KARRATHA,1995,8,0,0,0,1995-08-01T00:00:00
KARRATHA,1995,9,0,0,0,1995-09-01T00:00:00
KARRATHA,1995,10,0,0,0,1995-10-01T00:00:00
KARRATHA,1995,11,0,0,0,1995-11-01T00:00:00
KARRATHA,1995,12,0,0,0,1995-12-01T00:00:00
KARRATHA,1996,1,0,0,0,1996-01-01T00:00:00
KARRATHA,1996,2,0,0,0,1996-02-01T00:00:00
KARRATHA,1996,3,0,0,0,1996-03-01T00:00:00
KARRATHA,1996,4,0,0,0,1996-04-01T00:00:00
KARRATHA,1996,5,0,0,0,1996-05-01T00:00:00
KARRATHA,1996,6,0,0,0,1996-06-01T00:00:00
KARRATHA,1996,7,0,0,0,1996-07-01T00:00:00
KARRATHA,1996,8,0,0,0,1996-08-01T00:00:00
KARRATHA,1996,9,0,0,0,1996-09-01T00:00:00
KARRATHA,1996,10,0,0,0,1996-10-01T00:00:00
KARRATHA,1996,11,0,0,0,1996-11-01T00:00:00
KARRATHA,1996,12,0,0,0,1996-12-01T00:00:00
KARRATHA,1997,1,0,0,0,1997-01-01T00:00:00
KARRATHA,1997,2,0,0,0,1997-02-01T00:00:00
KARRATHA,1997,3,0,0,0,1997-03-01T00:00:00
KARRATHA,1997,4,0,0,0,1997-04-01T00:00:00
KARRATHA,1997,5,0,0,0,1997-05-01T00:00:00
KARRATHA,1997,6,0,0,0,1997-06-01T00:00:00
KARRATHA,1997,7,0,0,0,1997-07-01T00:00:00
KARRATHA,1997,8,0,0,0,1997-08-01T00:00:00
KARRATHA,1997,9,0,0,0,1997-09-01T00:00:00
KARRATHA,1997,10,0,0,0,1997-10-01T00:00:00
KARRATHA,1997,11,0,0,0,1997-11-01T00:00:00
KARRATHA,1997,12,0,0,0,1997-12-01T00:00:00
KARRATHA,1998,1,0,0,0,1998-01-01T00:00:00
KARRATHA,1998,2,0,0,0,1998-02-01T00:00:00
KARRATHA,1998,3,0,0,0,1998-03-01T00:00:00
KARRATHA,1998,4,0,0,0,1998-04-01T00:00:00
KARRATHA,1998,5,0,0,0,1998-05-01T00:00:00
KARRATHA,1998,6,0,0,0,1998-06-01T00:00:00
KARRATHA,1998,7,0,0,0,1998-07-01T00:00:00
KARRATHA,1998,8,0,0,0,1998-08-01T00:00:00
KARRATHA,1998,9,0,0,0,1998-09-01T00:00:00
KARRATHA,1998,10,0,0,0,1998-10-01T00:00:00
KARRATHA,1998,11,0,0,0,1998-11-01T00:00:00
KARRATHA,1998,12,0,0,0,1998-12-01T00:00:00
KARRATHA,1999,1,0,0,0,1999-01-01T00:00:00
KARRATHA,1999,2,0,0,0,1999-02-01T00:00:00
KARRATHA,1999,3,0,0,0,1999-03-01T00:00:00
KARRATHA,1999,4,0,0,0,1999-04-01T00:00:00
KARRATHA,1999,5,0,0,0,1999-05-01T00:00:00
KARRATHA,1999,6,0,0,0,1999-06-01T00:00:00
KARRATHA,1999,7,0,0,0,1999-07-01T00:00:00
KARRATHA,1999,8,0,0,0,1999-08-01T00:00:00
KARRATHA,1999,9,0,0,0,1999-09-01T00:00:00
KARRATHA,1999,10,0,0,0,1999-10-01T00:00:00
KARRATHA,1999,11,0,0,0,1999-11-01T00:00:00
KARRATHA,1999,12,0,0,0,1999-12-01T00:00:00
KARRATHA,2000,1,0,0,0,2000-01-01T00:00:00
KARRATHA,2000,2,0,0,0,2000-02-01T00:00:00
KARRATHA,2000,3,0,0,0,2000-03-01T00:00:00
KARRATHA,2000,4,0,0,0,2000-04-01T00:00:00
KARRATHA,2000,5,0,0,0,2000-05-01T00:00:00
KARRATHA,2000,6,0,0,0,2000-06-01T00:00:00
KARRATHA,2000,7,0,0,0,2000-07-01T00:00:00
KARRATHA,2000,8,0,0,0,2000-08-01T00:00:00
KARRATHA,2000,9,0,0,0,2000-09-01T00:00:00
KARRATHA,2000,10,0,0,0,2000-10-01T00:00:00
KARRATHA,2000,11,0,0,0,2000-11-01T00:00:00
KARRATHA,2000,12,0,0,0,2000-12-01T00:00:00
KARRATHA,2001,1,0,0,0,2001-01-01T00:00:00
KARRATHA,2001,2,0,0,0,2001-02-01T00:00:00
KARRATHA,2001,3,0,0,0,2001-03-01T00:00:00
KARRATHA,2001,4,0,0,0,2001-04-01T00:00:00
KARRATHA,2001,5,0,0,0,2001-05-01T00:00:00
KARRATHA,2001,6,0,0,0,2001-06-01T00:00:00
KARRATHA,2001,7,0,0,0,2001-07-01T00:00:00
KARRATHA,2001,8,0,0,0,2001-08-01T00:00:00
KARRATHA,2001,9,0,0,0,2001-09-01T00:00:00
KARRATHA,2001,10,0,0,0,2001-10-01T00:00:00
KARRATHA,2001,11,0,0,0,2001-11-01T00:00:00
KARRATHA,2001,12,0,0,0,2001-12-01T00:00:00
KARRATHA,2002,1,0,0,0,2002-01-01T00:00:00
KARRATHA,2002,2,0,0,0,2002-02-01T00:00:00
KARRATHA,2002,3,0,0,0,2002-03-01T00:00:00
KARRATHA,2002,4,0,0,0,2002-04-01T00:00:00
KARRATHA,2002,5,0,0,0,2002-05-01T00:00:00
KARRATHA,2002,6,0,0,0,2002-06-01T00:00:00
KARRATHA,2002,7,0,0,0,2002-07-01T00:00:00
KARRATHA,2002,8,0,0,0,2002-08-01T00:00:00
KARRATHA,2002,9,0,0,0,2002-09-01T00:00:00
KARRATHA,2002,10,0,0,0,2002-10-01T00:00:00
KARRATHA,2002,11,0,0,0,2002-11-01T00:00:00
KARRATHA,2002,12,0,0,0,2002-12-01T00:00:00
KARRATHA,2003,1,0,0,0,2003-01-01T00:00:00
KARRATHA,2003,2,0,0,0,2003-02-01T00:00:00
KARRATHA,2003,3,0,0,0,2003-03-01T00:00:00
KARRATHA,2003,4,0,0,0,2003-04-01T00:00:00
KARRATHA,2003,5,0,0,0,2003-05-01T00:00:00
KARRATHA,2003,6,0,0,0,2003-06-01T00:00:00
KARRATHA,2003,7,0,0,0,2003-07-01T00:00:00
KARRATHA,2003,8,0,0,0,2003-08-01T00:00:00
KARRATHA,2003,9,0,0,0,2003-09-01T00:00:00
KARRATHA,2003,10,0,0,0,2003-10-01T00:00:00
KARRATHA,2003,11,0,0,0,2003-11-01T00:00:00
KARRATHA,2003,12,0,0,0,2003-12-01T00:00:00
KARRATHA,2004,1,0,0,0,2004-01-01T00:00:00
KARRATHA,2004,2,0,0,0,2004-02-01T00:00:00
KARRATHA,2004,3,0,0,0,2004-03-01T00:00:00
KARRATHA,2004,4,0,0,0,2004-04-01T00:00:00
KARRATHA,2004,5,0,0,0,2004-05-01T00:00:00
KARRATHA,2004,6,0,0,0,2004-06-01T00:00:00
KARRATHA,2004,7,0,0,0,2004-07-01T00:00:00
KARRATHA,2004,8,0,0,0,2004-08-01T00:00:00
KARRATHA,2004,9,0,0,0,2004-09-01T00:00:00
KARRATHA,2004,10,0,0,0,2004-10-01T00:00:00
KARRATHA,2004,11,0,0,0,2004-11-01T00:00:00
KARRATHA,2004,12,0,0,0,2004-12-01T00:00:00
KARRATHA,2005,1,0,0,0,2005-01-01T00:00:00
KARRATHA,2005,2,0,0,0,2005-02-01T00:00:00
KARRATHA,2005,3,0,0,0,2005-03-01T00:00:00
KARRATHA,2005,4,0,0,0,2005-04-01T00:00:00
KARRATHA,2005,5,0,0,0,2005-05-01T00:00:00
KARRATHA,2005,6,0,0,0,2005-06-01T00:00:00
KARRATHA,2005,7,0,0,0,2005-07-01T00:00:00
KARRATHA,2005,8,0,0,0,2005-08-01T00:00:00
KARRATHA,2005,9,0,0,0,2005-09-01T00:00:00
KARRATHA,2005,10,0,0,0,2005-10-01T00:00:00
KARRATHA,2005,11,0,0,0,2005-11-01T00:00:00
KARRATHA,2005,12,0,0,0,2005-12-01T00:00:00
KARRATHA,2006,1,0,0,0,2006-01-01T00:00:00
KARRATHA,2006,2,0,0,0,2006-02-01T00:00:00
KARRATHA,2006,3,0,0,0,2006-03-01T00:00:00
KARRATHA,2006,4,0,0,0,2006-04-01T00:00:00
KARRATHA,2006,5,0,0,0,2006-05-01T00:00:00
KARRATHA,2006,6,0,0,0,2006-06-01T00:00:00
KARRATHA,2006,7,0,0,0,2006-07-01T00:00:00
KARRATHA,2006,8,0,0,0,2006-08-01T00:00:00
KARRATHA,2006,9,0,0,0,2006-09-01T00:00:00
KARRATHA,2006,10,0,0,0,2006-10-01T00:00:00
KARRATHA,2006,11,0,0,0,2006-11-01T00:00:00
KARRATHA,2006,12,0,0,0,2006-12-01T00:00:00
KARRATHA,2007,1,0,0,0,2007-01-01T00:00:00
KARRATHA,2007,2,0,0,0,2007-02-01T00:00:00
KARRATHA,2007,3,0,0,0,2007-03-01T00:00:00
KARRATHA,2007,4,0,0,0,2007-04-01T00:00:00
KARRATHA,2007,5,0,0,0,2007-05-01T00:00:00
KARRATHA,2007,6,0,0,0,2007-06-01T00:00:00
KARRATHA,2007,7,0,0,0,2007-07-01T00:00:00
KARRATHA,2007,8,0,0,0,2007-08-01T00:00:00
KARRATHA,2007,9,0,0,0,2007-09-01T00:00:00
KARRATHA,2007,10,0,0,0,2007-10-01T00:00:00
KARRATHA,2007,11,0,0,0,2007-11-01T00:00:00
KARRATHA,2007,12,0,0,0,2007-12-01T00:00:00
KARRATHA,2008,1,0,0,0,2008-01-01T00:00:00
KARRATHA,2008,2,0,0,0,2008-02-01T00:00:00
KARRATHA,2008,3,0,0,0,2008-03-01T00:00:00
KARRATHA,2008,4,0,0,0,2008-04-01T00:00:00
KARRATHA,2008,5,0,0,0,2008-05-01T00:00:00
KARRATHA,2008,6,0,0,0,2008-06-01T00:00:00
KARRATHA,2008,7,0,0,0,2008-07-01T00:00:00
KARRATHA,2008,8,0,0,0,2008-08-01T00:00:00
KARRATHA,2008,9,0,0,0,2008-09-01T00:00:00
KARRATHA,2008,10,0,0,0,2008-10-01T00:00:00
KARRATHA,2008,11,0,0,0,2008-11-01T00:00:00
KARRATHA,2008,12,0,0,0,2008-12-01T00:00:00
KARRATHA,2009,1,0,0,0,2009-01-01T00:00:00
KARRATHA,2009,2,0,0,0,2009-02-01T00:00:00
KARRATHA,2009,3,0,0,0,2009-03-01T00:00:00
KARRATHA,2009,4,0,0,0,2009-04-01T00:00:00
KARRATHA,2009,5,0,0,0,2009-05-01T00:00:00
KARRATHA,2009,6,0,0,0,2009-06-01T00:00:00
KARRATHA,2009,7,0,0,0,2009-07-01T00:00:00
KARRATHA,2009,8,0,0,0,2009-08-01T00:00:00
KARRATHA,2009,9,0,0,0,2009-09-01T00:00:00
KARRATHA,2009,10,0,0,0,2009-10-01T00:00:00
KARRATHA,2009,11,0,0,0,2009-11-01T00:00:00
KARRATHA,2009,12,0,0,0,2009-12-01T00:00:00
KARRATHA,2010,1,0,0,0,2010-01-01T00:00:00
KARRATHA,2010,2,0,0,0,2010-02-01T00:00:00
KARRATHA,2010,3,0,0,0,2010-03-01T00:00:00
KARRATHA,2010,4,0,0,0,2010-04-01T00:00:00
KARRATHA,2010,5,0,0,0,2010-05-01T00:00:00
KARRATHA,2010,6,0,0,0,2010-06-01T00:00:00
KARRATHA,2010,7,0,0,0,2010-07-01T00:00:00
KARRATHA,2010,8,0,0,0,2010-08-01T00:00:00
KARRATHA,2010,9,0,0,0,2010-09-01T00:00:00
KARRATHA,2010,10,0,0,0,2010-10-01T00:00:00
KARRATHA,2010,11,0,0,0,2010-11-01T00:00:00
KARRATHA,2010,12,0,0,0,2010-12-01T00:00:00
KARRATHA,2011,1,0,0,0,2011-01-01T00:00:00
KARRATHA,2011,2,0,0,0,2011-02-01T00:00:00
KARRATHA,2011,3,0,0,0,2011-03-01T00:00:00
KARRATHA,2011,4,0,0,0,2011-04-01T00:00:00
KARRATHA,2011,5,0,0,0,2011-05-01T00:00:00
KARRATHA,2011,6,0,0,0,2011-06-01T00:00:00
KARRATHA,2011,7,0,0,0,2011-07-01T00:00:00
KARRATHA,2011,8,0,0,0,2011-08-01T00:00:00
KARRATHA,2011,9,0,0,0,2011-09-01T00:00:00
KARRATHA,2011,10,0,0,0,2011-10-01T00:00:00
KARRATHA,2011,11,0,0,0,2011-11-01T00:00:00
KARRATHA,2011,12,0,0,0,2011-12-01T00:00:00
KARRATHA,2012,1,0,0,0,2012-01-01T00:00:00
KARRATHA,2012,2,0,0,0,2012-02-01T00:00:00
KARRATHA,2012,3,0,0,0,2012-03-01T00:00:00
KARRATHA,2012,4,0,0,0,2012-04-01T00:00:00
KARRATHA,2012,5,0,0,0,2012-05-01T00:00:00
KARRATHA,2012,6,0,0,0,2012-06-01T00:00:00
KARRATHA,2012,7,0,0,0,2012-07-01T00:00:00
KARRATHA,2012,8,0,0,0,2012-08-01T00:00:00
KARRATHA,2012,9,0,0,0,2012-09-01T00:00:00
KARRATHA,2012,10,0,0,0,2012-10-01T00:00:00
KARRATHA,2012,11,0,0,0,2012-11-01T00:00:00
KARRATHA,2012,12,0,0,0,2012-12-01T00:00:00
KARRATHA,2013,1,0,0,0,2013-01-01T00:00:00
KARRATHA,2013,2,0,0,0,2013-02-01T00:00:00
KARRATHA,2013,3,0,0,0,2013-03-01T00:00:00
KARRATHA,2013,4,0,0,0,2013-04-01T00:00:00
KARRATHA,2013,5,0,0,0,2013-05-01T00:00:00
KARRATHA,2013,6,0,0,0,2013-06-01T00:00:00
KARRATHA,2013,7,0,0,0,2013-07-01T00:00:00
KARRATHA,2013,8,0,0,0,2013-08-01T00:00:00
KARRATHA,2013,9,0,0,0,2013-09-01T00:00:00
KARRATHA,2013,10,0,0,0,2013-10-01T00:00:00
KARRATHA,2013,11,0,0,0,2013-11-01T00:00:00
KARRATHA,2013,12,0,0,0,2013-12-01T00:00:00
KARRATHA,2014,1,0,0,0,2014-01-01T00:00:00
KARRATHA,2014,2,0,0,0,2014-02-01T00:00:00
KARRATHA,2014,3,0,0,0,2014-03-01T00:00:00
KARRATHA,2014,4,0,0,0,2014-04-01T00:00:00
KARRATHA,2014,5,0,0,0,2014-05-01T00:00:00
KARRATHA,2014,6,0,0,0,2014-06-01T00:00:00
KARRATHA,2014,7,0,0,0,2014-07-01T00:00:00
KARRATHA,2014,8,0,0,0,2014-08-01T00:00:00
KARRATHA,2014,9,0,0,0,2014-09-01T00:00:00
KARRATHA,2014,10,0,0,0,2014-10-01T00:00:00
KARRATHA,2014,11,0,0,0,2014-11-01T00:00:00
KARRATHA,2014,12,0,0,0,2014-12-01T00:00:00
KARRATHA,2015,1,0,0,0,2015-01-01T00:00:00
KARRATHA,2015,2,0,0,0,2015-02-01T00:00:00
KARRATHA,2015,3,0,0,0,2015-03-01T00:00:00
KARRATHA,2015,4,0,0,0,2015-04-01T00:00:00
KARRATHA,2015,5,0,0,0,2015-05-01T00:00:00
KARRATHA,2015,6,0,0,0,2015-06-01T00:00:00
KARRATHA,2015,7,0,0,0,2015-07-01T00:00:00
KARRATHA,2015,8,0,0,0,2015-08-01T00:00:00
KARRATHA,2015,9,0,0,0,2015-09-01T00:00:00
KARRATHA,2015,10,0,0,0,2015-10-01T00:00:00
KARRATHA,2015,11,0,0,0,2015-11-01T00:00:00
KARRATHA,2015,12,0,0,0,2015-12-01T00:00:00
KARRATHA,2016,1,0,0,0,2016-01-01T00:00:00
KARRATHA,2016,2,0,0,0,2016-02-01T00:00:00
KARRATHA,2016,3,0,0,0,2016-03-01T00:00:00
KARRATHA,2016,4,0,0,0,2016-04-01T00:00:00
KARRATHA,2016,5,0,0,0,2016-05-01T00:00:00
KARRATHA,2016,6,0,0,0,2016-06-01T00:00:00
KARRATHA,2016,7,0,0,0,2016-07-01T00:00:00
KARRATHA,2016,8,0,0,0,2016-08-01T00:00:00
KARRATHA,2016,9,0,0,0,2016-09-01T00:00:00
KARRATHA,2016,10,0,0,0,2016-10-01T00:00:00
KARRATHA,2016,11,0,0,0,2016-11-01T00:00:00
KARRATHA,2016,12,0,0,0,2016-12-01T00:00:00
KARRATHA,2017,1,0,0,0,2017-01-01T00:00:00
KARRATHA,2017,2,0,0,0,2017-02-01T00:00:00
KARRATHA,2017,3,0,0,0,2017-03-01T00:00:00
KARRATHA,2017,4,0,0,0,2017-04-01T00:00:00
KARRATHA,2017,5,0,0,0,2017-05-01T00:00:00
KARRATHA,2017,6,0,0,0,2017-06-01T00:00:00
KARRATHA,2017,7,0,0,0,2017-07-01T00:00:00
KARRATHA,2017,8,0,0,0,2017-08-01T00:00:00
KARRATHA,2017,9,0,0,0,2017-09-01T00:00:00
KARRATHA,2017,10,0,0,0,2017-10-01T00:00:00
KARRATHA,2017,11,0,0,0,2017-11-01T00:00:00
KARRATHA,2017,12,0,0,0,2017-12-01T00:00:00
KARRATHA,2018,1,0,0,0,2018-01-01T00:00:00
KARRATHA,2018,2,0,0,0,2018-02-01T00:00:00
KARRATHA,2018,3,0,0,0,2018-03-01T00:00:00
KARRATHA,2018,4,0,0,0,2018-04-01T00:00:00
KARRATHA,2018,5,0,0,0,2018-05-01T00:00:00
KARRATHA,2018,6,0,0,0,2018-06-01T00:00:00
KARRATHA,2018,7,0,0,0,2018-07-01T00:00:00
KARRATHA,2018,8,0,0,0,2018-08-01T00:00:00
KARRATHA,2018,9,0,0,0,2018-09-01T00:00:00
KARRATHA,2018,10,0,0,0,2018-10-01T00:00:00
KARRATHA,2018,11,0,0,0,2018-11-01T00:00:00
KARRATHA,2018,12,0,0,0,2018-12-01T00:00:00
KARRATHA,2019,1,0,0,0,2019-01-01T00:00:00
KARRATHA,2019,2,0,0,0,2019-02-01T00:00:00
KARRATHA,2019,3,0,0,0,2019-03-01T00:00:00
KARRATHA,2019,4,0,0,0,2019-04-01T00:00:00
KARRATHA,2019,5,0,0,0,2019-05-01T00:00:00
KARRATHA,2019,6,0,0,0,2019-06-01T00:00:00
KARRATHA,2019,7,0,0,0,2019-07-01T00:00:00
KARRATHA,2019,8,0,0,0,2019-08-01T00:00:00
KARRATHA,2019,9,0,0,0,2019-09-01T00:00:00
KARRATHA,2019,10,0,0,0,2019-10-01T00:00:00
KARRATHA,2019,11,0,0,0,2019-11-01T00:00:00
KARRATHA,2019,12,0,0,0,2019-12-01T00:00:00
KARRATHA,2020,1,0,0,0,2020-01-01T00:00:00
KARRATHA,2020,2,0,0,0,2020-02-01T00:00:00
KARRATHA,2020,3,0,0,0,2020-03-01T00:00:00
KARRATHA,2020,4,0,0,0,2020-04-01T00:00:00
KARRATHA,2020,5,0,0,0,2020-05-01T00:00:00
KARRATHA,2020,6,0,0,0,2020-06-01T00:00:00
KARRATHA,2020,7,0,0,0,2020-07-01T00:00:00
KARRATHA,2020,8,0,0,0,2020-08-01T00:00:00
KARRATHA,2020,9,0,0,0,2020-09-01T00:00:00
KARRATHA,2020,10,0,0,0,2020-10-01T00:00:00
KARRATHA,2020,11,0,0,0,2020-11-01T00:00:00
KARRATHA,2020,12,0,0,0,2020-12-01T00:00:00
KARRATHA,2021,1,0,0,0,2021-01-01T00:00:00
KARRATHA,2021,2,0,0,0,2021-02-01T00:00:00
KARRATHA,2021,3,0,0,0,2021-03-01T00:00:00
KARRATHA,2021,4,0,0,0,2021-04-01T00:00:00
KARRATHA,2021,5,0,0,0,2021-05-01T00:00:00
KARRATHA,2021,6,0,0,0,2021-06-01T00:00:00
KARRATHA,2021,7,0,0,0,2021-07-01T00:00:00
KARRATHA,2021,8,0,0,0,2021-08-01T00:00:00
KARRATHA,2021,9,0,0,0,2021-09-01T00:00:00
KARRATHA,2021,10,0,0,0,2021-10-01T00:00:00
KARRATHA,2021,11,0,0,0,2021-11-01T00:00:00
KARRATHA,2021,12,0,0,0,2021-12-01T00:00:00
KARRATHA,2022,1,0,0,0,2022-01-01T00:00:00
KARRATHA,2022,2,0,0,0,2022-02-01T00:00:00
KARRATHA,2022,3,0,0,0,2022-03-01T00:00:00
KARRATHA,2022,4,0,0,0,2022-04-01T00:00:00
KARRATHA,2022,5,0,0,0,2022-05-01T00:00:00
KARRATHA,2022,6,0,0,0,2022-06-01T00:00:00
KARRATHA,2022,7,0,0,0,2022-07-01T00:00:00
KARRATHA,2022,8,0,0,0,2022-08-01T00:00:00
KARRATHA,2022,9,0,0,0,2022-09-01T00:00:00
KARRATHA,2022,10,0,0,0,2022-10-01T00:00:00
KARRATHA,2022,11,0,0,0,2022-11-01T00:00:00
KARRATHA,2022,12,0,0,0,2022-12-01T00:00:00
KARRATHA,2023,1,0,0,0,2023-01-01T00:00:00
KARRATHA,2023,2,0,0,0,2023-02-01T00:00:00
KARRATHA,2023,3,0,0,0,2023-03-01T00:00:00
KARRATHA,2023,4,0,0,0,2023-04-01T00:00:00
KARRATHA,2023,5,0,0,0,2023-05-01T00:00:00
KARRATHA,2023,6,0,0,0,2023-06-01T00:00:00
KARRATHA,2023,7,0,0,0,2023-07-01T00:00:00
KARRATHA,2023,8,0,0,0,2023-08-01T00:00:00
KARRATHA,2023,9,0,0,0,2023-09-01T00:00:00
KARRATHA,2023,10,0,0,0,2023-10-01T00:00:00
KARRATHA,2023,11,0,0,0,2023-11-01T00:00:00
KARRATHA,2023,12,0,0,0,2023-12-01T00:00:00
KARRATHA,2024,1,0,0,0,2024-01-01T00:00:00
KARRATHA,2024,2,0,0,0,2024-02-01T00:00:00
KARRATHA,2024,3,0,0,0,2024-03-01T00:00:00
KARRATHA,2024,4,0,0,0,2024-04-01T00:00:00
KARRATHA,2024,5,0,0,0,2024-05-01T00:00:00
KARRATHA,2024,6,0,0,0,2024-06-01T00:00:00
KARRATHA,2024,7,0,0,0,2024-07-01T00:00:00
KARRATHA,2024,8,0,0,0,2024-08-01T00:00:00
KARRATHA,2024,9,0,0,0,2024-09-01T00:00:00
KARRATHA,2024,10,0,0,0,2024-10-01T00:00:00
KARRATHA,2024,11,0,0,0,2024-11-01T00:00:00
KARRATHA,2024,12,0,0,0,2024-12-01T00:00:00
KARRATHA,2025,1,0,0,0,2025-01-01T00:00:00
KARRATHA,2025,2,0,0,0,2025-02-01T00:00:00
KARRATHA,2025,3,0,0,0,2025-03-01T00:00:00
KARRATHA,2025,4,0,0,0,2025-04-01T00:00:00
KARRATHA,2025,5,0,0,0,2025-05-01T00:00:00
KARRATHA,2025,6,0,0,0,2025-06-01T00:00:00
LAUNCESTON,1985,1,0,0,0,1985-01-01T00:00:00
LAUNCESTON,1985,2,0,0,0,1985-02-01T00:00:00
LAUNCESTON,1985,3,0,0,0,1985-03-01T00:00:00
LAUNCESTON,1985,4,0,0,0,1985-04-01T00:00:00
LAUNCESTON,1985,5,0,0,0,1985-05-01T00:00:00
LAUNCESTON,1985,6,0,0,0,1985-06-01T00:00:00
LAUNCESTON,1985,7,0,0,0,1985-07-01T00:00:00
LAUNCESTON,1985,8,0,0,0,1985-08-01T00:00:00
LAUNCESTON,1985,9,0,0,0,1985-09-01T00:00:00
LAUNCESTON,1985,10,0,0,0,1985-10-01T00:00:00
LAUNCESTON,1985,11,0,0,0,1985-11-01T00:00:00
LAUNCESTON,1985,12,0,0,0,1985-12-01T00:00:00
LAUNCESTON,1986,1,0,0,0,1986-01-01T00:00:00
LAUNCESTON,1986,2,0,0,0,1986-02-01T00:00:00
LAUNCESTON,1986,3,0,0,0,1986-03-01T00:00:00
LAUNCESTON,1986,4,0,0,0,1986-04-01T00:00:00
LAUNCESTON,1986,5,0,0,0,1986-05-01T00:00:00
LAUNCESTON,1986,6,0,0,0,1986-06-01T00:00:00
LAUNCESTON,1986,7,0,0,0,1986-07-01T00:00:00
LAUNCESTON,1986,8,0,0,0,1986-08-01T00:00:00
LAUNCESTON,1986,9,0,0,0,1986-09-01T00:00:00
LAUNCESTON,1986,10,0,0,0,1986-10-01T00:00:00
LAUNCESTON,1986,11,0,0,0,1986-11-01T00:00:00
LAUNCESTON,1986,12,0,0,0,1986-12-01T00:00:00
LAUNCESTON,1987,1,0,0,0,1987-01-01T00:00:00
LAUNCESTON,1987,2,0,0,0,1987-02-01T00:00:00
LAUNCESTON,1987,3,0,0,0,1987-03-01T00:00:00
LAUNCESTON,1987,4,0,0,0,1987-04-01T00:00:00
LAUNCESTON,1987,5,0,0,0,1987-05-01T00:00:00
LAUNCESTON,1987,6,0,0,0,1987-06-01T00:00:00
LAUNCESTON,1987,7,0,0,0,1987-07-01T00:00:00
LAUNCESTON,1987,8,0,0,0,1987-08-01T00:00:00
LAUNCESTON,1987,9,0,0,0,1987-09-01T00:00:00
LAUNCESTON,1987,10,0,0,0,1987-10-01T00:00:00
LAUNCESTON,1987,11,0,0,0,1987-11-01T00:00:00
LAUNCESTON,1987,12,0,0,0,1987-12-01T00:00:00
LAUNCESTON,1988,1,0,0,0,1988-01-01T00:00:00
LAUNCESTON,1988,2,0,0,0,1988-02-01T00:00:00
LAUNCESTON,1988,3,0,0,0,1988-03-01T00:00:00
LAUNCESTON,1988,4,0,0,0,1988-04-01T00:00:00
LAUNCESTON,1988,5,0,0,0,1988-05-01T00:00:00
LAUNCESTON,1988,6,0,0,0,1988-06-01T00:00:00
LAUNCESTON,1988,7,0,0,0,1988-07-01T00:00:00
LAUNCESTON,1988,8,0,0,0,1988-08-01T00:00:00
LAUNCESTON,1988,9,0,0,0,1988-09-01T00:00:00
LAUNCESTON,1988,10,0,0,0,1988-10-01T00:00:00
LAUNCESTON,1988,11,0,0,0,1988-11-01T00:00:00
LAUNCESTON,1988,12,0,0,0,1988-12-01T00:00:00
LAUNCESTON,1989,1,0,0,0,1989-01-01T00:00:00
LAUNCESTON,1989,2,0,0,0,1989-02-01T00:00:00
LAUNCESTON,1989,3,0,0,0,1989-03-01T00:00:00
LAUNCESTON,1989,4,0,0,0,1989-04-01T00:00:00
LAUNCESTON,1989,5,0,0,0,1989-05-01T00:00:00
LAUNCESTON,1989,6,0,0,0,1989-06-01T00:00:00
LAUNCESTON,1989,7,0,0,0,1989-07-01T00:00:00
LAUNCESTON,1989,8,0,0,0,1989-08-01T00:00:00
LAUNCESTON,1989,9,0,0,0,1989-09-01T00:00:00
LAUNCESTON,1989,10,0,0,0,1989-10-01T00:00:00
LAUNCESTON,1989,11,0,0,0,1989-11-01T00:00:00
LAUNCESTON,1989,12,0,0,0,1989-12-01T00:00:00
LAUNCESTON,1990,1,0,0,0,1990-01-01T00:00:00
LAUNCESTON,1990,2,0,0,0,1990-02-01T00:00:00
LAUNCESTON,1990,3,0,0,0,1990-03-01T00:00:00
LAUNCESTON,1990,4,0,0,0,1990-04-01T00:00:00
LAUNCESTON,1990,5,0,0,0,1990-05-01T00:00:00
LAUNCESTON,1990,6,0,0,0,1990-06-01T00:00:00
LAUNCESTON,1990,7,0,0,0,1990-07-01T00:00:00
LAUNCESTON,1990,8,0,0,0,1990-08-01T00:00:00
LAUNCESTON,1990,9,0,0,0,1990-09-01T00:00:00
LAUNCESTON,1990,10,0,0,0,1990-10-01T00:00:00
LAUNCESTON,1990,11,0,0,0,1990-11-01T00:00:00
LAUNCESTON,1990,12,0,0,0,1990-12-01T00:00:00
LAUNCESTON,1991,1,0,0,0,1991-01-01T00:00:00
LAUNCESTON,1991,2,0,0,0,1991-02-01T00:00:00
LAUNCESTON,1991,3,0,0,0,1991-03-01T00:00:00
LAUNCESTON,1991,4,0,0,0,1991-04-01T00:00:00
LAUNCESTON,1991,5,0,0,0,1991-05-01T00:00:00
LAUNCESTON,1991,6,0,0,0,1991-06-01T00:00:00
LAUNCESTON,1991,7,0,0,0,1991-07-01T00:00:00
LAUNCESTON,1991,8,0,0,0,1991-08-01T00:00:00
LAUNCESTON,1991,9,0,0,0,1991-09-01T00:00:00
LAUNCESTON,1991,10,0,0,0,1991-10-01T00:00:00
LAUNCESTON,1991,11,0,0,0,1991-11-01T00:00:00
LAUNCESTON,1991,12,0,0,0,1991-12-01T00:00:00
LAUNCESTON,1992,1,0,0,0,1992-01-01T00:00:00
LAUNCESTON,1992,2,0,0,0,1992-02-01T00:00:00
LAUNCESTON,1992,3,0,0,0,1992-03-01T00:00:00
LAUNCESTON,1992,4,0,0,0,1992-04-01T00:00:00
LAUNCESTON,1992,5,0,0,0,1992-05-01T00:00:00
LAUNCESTON,1992,6,0,0,0,1992-06-01T00:00:00
LAUNCESTON,1992,7,0,0,0,1992-07-01T00:00:00
LAUNCESTON,1992,8,0,0,0,1992-08-01T00:00:00
LAUNCESTON,1992,9,0,0,0,1992-09-01T00:00:00
LAUNCESTON,1992,10,0,0,0,1992-10-01T00:00:00
LAUNCESTON,1992,11,0,0,0,1992-11-01T00:00:00
LAUNCESTON,1992,12,0,0,0,1992-12-01T00:00:00
LAUNCESTON,1993,1,0,0,0,1993-01-01T00:00:00
LAUNCESTON,1993,2,0,0,0,1993-02-01T00:00:00
LAUNCESTON,1993,3,0,0,0,1993-03-01T00:00:00
LAUNCESTON,1993,4,0,0,0,1993-04-01T00:00:00
LAUNCESTON,1993,5,0,0,0,1993-05-01T00:00:00
LAUNCESTON,1993,6,0,0,0,1993-06-01T00:00:00
LAUNCESTON,1993,7,0,0,0,1993-07-01T00:00:00
LAUNCESTON,1993,8,0,0,0,1993-08-01T00:00:00
LAUNCESTON,1993,9,0,0,0,1993-09-01T00:00:00
LAUNCESTON,1993,10,0,0,0,1993-10-01T00:00:00
LAUNCESTON,1993,11,0,0,0,1993-11-01T00:00:00
LAUNCESTON,1993,12,0,0,0,1993-12-01T00:00:00
LAUNCESTON,1994,1,0,0,0,1994-01-01T00:00:00
LAUNCESTON,1994,2,0,0,0,1994-02-01T00:00:00
LAUNCESTON,1994,3,0,0,0,1994-03-01T00:00:00
LAUNCESTON,1994,4,0,0,0,1994-04-01T00:00:00
LAUNCESTON,1994,5,0,0,0,1994-05-01T00:00:00
LAUNCESTON,1994,6,0,0,0,1994-06-01T00:00:00
LAUNCESTON,1994,7,0,0,0,1994-07-01T00:00:00
LAUNCESTON,1994,8,0,0,0,1994-08-01T00:00:00
LAUNCESTON,1994,9,0,0,0,1994-09-01T00:00:00
LAUNCESTON,1994,10,0,0,0,1994-10-01T00:00:00
LAUNCESTON,1994,11,0,0,0,1994-11-01T00:00:00
LAUNCESTON,1994,12,0,0,0,1994-12-01T00:00:00
LAUNCESTON,1995,1,0,0,0,1995-01-01T00:00:00
LAUNCESTON,1995,2,0,0,0,1995-02-01T00:00:00
LAUNCESTON,1995,3,0,0,0,1995-03-01T00:00:00
LAUNCESTON,1995,4,0,0,0,1995-04-01T00:00:00
LAUNCESTON,1995,5,0,0,0,1995-05-01T00:00:00
LAUNCESTON,1995,6,0,0,0,1995-06-01T00:00:00
LAUNCESTON,1995,7,0,0,0,1995-07-01T00:00:00
LAUNCESTON,1995,8,0,0,0,1995-08-01T00:00:00
LAUNCESTON,1995,9,0,0,0,1995-09-01T00:00:00
LAUNCESTON,1995,10,0,0,0,1995-10-01T00:00:00
LAUNCESTON,1995,11,0,0,0,1995-11-01T00:00:00
LAUNCESTON,1995,12,0,0,0,1995-12-01T00:00:00
LAUNCESTON,1996,1,0,0,0,1996-01-01T00:00:00
LAUNCESTON,1996,2,0,0,0,1996-02-01T00:00:00
LAUNCESTON,1996,3,0,0,0,1996-03-01T00:00:00
LAUNCESTON,1996,4,0,0,0,1996-04-01T00:00:00
LAUNCESTON,1996,5,0,0,0,1996-05-01T00:00:00
LAUNCESTON,1996,6,0,0,0,1996-06-01T00:00:00
LAUNCESTON,1996,7,0,0,0,1996-07-01T00:00:00
LAUNCESTON,1996,8,0,0,0,1996-08-01T00:00:00
LAUNCESTON,1996,9,0,0,0,1996-09-01T00:00:00
LAUNCESTON,1996,10,0,0,0,1996-10-01T00:00:00
LAUNCESTON,1996,11,0,0,0,1996-11-01T00:00:00
LAUNCESTON,1996,12,0,0,0,1996-12-01T00:00:00
LAUNCESTON,1997,1,0,0,0,1997-01-01T00:00:00
LAUNCESTON,1997,2,0,0,0,1997-02-01T00:00:00
LAUNCESTON,1997,3,0,0,0,1997-03-01T00:00:00
LAUNCESTON,1997,4,0,0,0,1997-04-01T00:00:00
LAUNCESTON,1997,5,0,0,0,1997-05-01T00:00:00
LAUNCESTON,1997,6,0,0,0,1997-06-01T00:00:00
LAUNCESTON,1997,7,0,0,0,1997-07-01T00:00:00
LAUNCESTON,1997,8,0,0,0,1997-08-01T00:00:00
LAUNCESTON,1997,9,0,0,0,1997-09-01T00:00:00
LAUNCESTON,1997,10,0,0,0,1997-10-01T00:00:00
LAUNCESTON,1997,11,0,0,0,1997-11-01T00:00:00
LAUNCESTON,1997,12,0,0,0,1997-12-01T00:00:00
LAUNCESTON,1998,1,0,0,0,1998-01-01T00:00:00
LAUNCESTON,1998,2,0,0,0,1998-02-01T00:00:00
LAUNCESTON,1998,3,0,0,0,1998-03-01T00:00:00
LAUNCESTON,1998,4,0,0,0,1998-04-01T00:00:00
LAUNCESTON,1998,5,0,0,0,1998-05-01T00:00:00
LAUNCESTON,1998,6,0,0,0,1998-06-01T00:00:00
LAUNCESTON,1998,7,0,0,0,1998-07-01T00:00:00
LAUNCESTON,1998,8,0,0,0,1998-08-01T00:00:00
LAUNCESTON,1998,9,0,0,0,1998-09-01T00:00:00
LAUNCESTON,1998,10,0,0,0,1998-10-01T00:00:00
LAUNCESTON,1998,11,0,0,0,1998-11-01T00:00:00
LAUNCESTON,1998,12,0,0,0,1998-12-01T00:00:00
LAUNCESTON,1999,1,0,0,0,1999-01-01T00:00:00
LAUNCESTON,1999,2,0,0,0,1999-02-01T00:00:00
LAUNCESTON,1999,3,0,0,0,1999-03-01T00:00:00
LAUNCESTON,1999,4,0,0,0,1999-04-01T00:00:00
LAUNCESTON,1999,5,0,0,0,1999-05-01T00:00:00
LAUNCESTON,1999,6,0,0,0,1999-06-01T00:00:00
LAUNCESTON,1999,7,0,0,0,1999-07-01T00:00:00
LAUNCESTON,1999,8,0,0,0,1999-08-01T00:00:00
LAUNCESTON,1999,9,0,0,0,1999-09-01T00:00:00
LAUNCESTON,1999,10,0,0,0,1999-10-01T00:00:00
LAUNCESTON,1999,11,0,0,0,1999-11-01T00:00:00
LAUNCESTON,1999,12,0,0,0,1999-12-01T00:00:00
LAUNCESTON,2000,1,0,0,0,2000-01-01T00:00:00
LAUNCESTON,2000,2,0,0,0,2000-02-01T00:00:00
LAUNCESTON,2000,3,0,0,0,2000-03-01T00:00:00
LAUNCESTON,2000,4,0,0,0,2000-04-01T00:00:00
LAUNCESTON,2000,5,0,0,0,2000-05-01T00:00:00
LAUNCESTON,2000,6,0,0,0,2000-06-01T00:00:00
LAUNCESTON,2000,7,0,0,0,2000-07-01T00:00:00
LAUNCESTON,2000,8,0,0,0,2000-08-01T00:00:00
LAUNCESTON,2000,9,0,0,0,2000-09-01T00:00:00
LAUNCESTON,2000,10,0,0,0,2000-10-01T00:00:00
LAUNCESTON,2000,11,0,0,0,2000-11-01T00:00:00
LAUNCESTON,2000,12,0,0,0,2000-12-01T00:00:00
LAUNCESTON,2001,1,0,0,0,2001-01-01T00:00:00
LAUNCESTON,2001,2,0,0,0,2001-02-01T00:00:00
LAUNCESTON,2001,3,0,0,0,2001-03-01T00:00:00
LAUNCESTON,2001,4,0,0,0,2001-04-01T00:00:00
LAUNCESTON,2001,5,0,0,0,2001-05-01T00:00:00
LAUNCESTON,2001,6,0,0,0,2001-06-01T00:00:00
LAUNCESTON,2001,7,0,0,0,2001-07-01T00:00:00
LAUNCESTON,2001,8,0,0,0,2001-08-01T00:00:00
LAUNCESTON,2001,9,0,0,0,2001-09-01T00:00:00
LAUNCESTON,2001,10,0,0,0,2001-10-01T00:00:00
LAUNCESTON,2001,11,0,0,0,2001-11-01T00:00:00
LAUNCESTON,2001,12,0,0,0,2001-12-01T00:00:00
LAUNCESTON,2002,1,0,0,0,2002-01-01T00:00:00
LAUNCESTON,2002,2,0,0,0,2002-02-01T00:00:00
LAUNCESTON,2002,3,0,0,0,2002-03-01T00:00:00
LAUNCESTON,2002,4,0,0,0,2002-04-01T00:00:00
LAUNCESTON,2002,5,0,0,0,2002-05-01T00:00:00
LAUNCESTON,2002,6,0,0,0,2002-06-01T00:00:00
LAUNCESTON,2002,7,0,0,0,2002-07-01T00:00:00
LAUNCESTON,2002,8,0,0,0,2002-08-01T00:00:00
LAUNCESTON,2002,9,0,0,0,2002-09-01T00:00:00
LAUNCESTON,2002,10,0,0,0,2002-10-01T00:00:00
LAUNCESTON,2002,11,0,0,0,2002-11-01T00:00:00
LAUNCESTON,2002,12,0,0,0,2002-12-01T00:00:00
LAUNCESTON,2003,1,0,0,0,2003-01-01T00:00:00
LAUNCESTON,2003,2,0,0,0,2003-02-01T00:00:00
LAUNCESTON,2003,3,0,0,0,2003-03-01T00:00:00
LAUNCESTON,2003,4,0,0,0,2003-04-01T00:00:00
LAUNCESTON,2003,5,0,0,0,2003-05-01T00:00:00
LAUNCESTON,2003,6,0,0,0,2003-06-01T00:00:00
LAUNCESTON,2003,7,0,0,0,2003-07-01T00:00:00
LAUNCESTON,2003,8,0,0,0,2003-08-01T00:00:00
LAUNCESTON,2003,9,0,0,0,2003-09-01T00:00:00
LAUNCESTON,2003,10,0,0,0,2003-10-01T00:00:00
LAUNCESTON,2003,11,0,0,0,2003-11-01T00:00:00
LAUNCESTON,2003,12,0,0,0,2003-12-01T00:00:00
LAUNCESTON,2004,1,0,0,0,2004-01-01T00:00:00
LAUNCESTON,2004,2,0,0,0,2004-02-01T00:00:00
LAUNCESTON,2004,3,0,0,0,2004-03-01T00:00:00
LAUNCESTON,2004,4,0,0,0,2004-04-01T00:00:00
LAUNCESTON,2004,5,0,0,0,2004-05-01T00:00:00
LAUNCESTON,2004,6,0,0,0,2004-06-01T00:00:00
LAUNCESTON,2004,7,0,0,0,2004-07-01T00:00:00
LAUNCESTON,2004,8,0,0,0,2004-08-01T00:00:00
LAUNCESTON,2004,9,0,0,0,2004-09-01T00:00:00
LAUNCESTON,2004,10,0,0,0,2004-10-01T00:00:00
LAUNCESTON,2004,11,0,0,0,2004-11-01T00:00:00
LAUNCESTON,2004,12,0,0,0,2004-12-01T00:00:00
LAUNCESTON,2005,1,0,0,0,2005-01-01T00:00:00
LAUNCESTON,2005,2,0,0,0,2005-02-01T00:00:00
LAUNCESTON,2005,3,0,0,0,2005-03-01T00:00:00
LAUNCESTON,2005,4,0,0,0,2005-04-01T00:00:00
LAUNCESTON,2005,5,0,0,0,2005-05-01T00:00:00
LAUNCESTON,2005,6,0,0,0,2005-06-01T00:00:00
LAUNCESTON,2005,7,0,0,0,2005-07-01T00:00:00
LAUNCESTON,2005,8,0,0,0,2005-08-01T00:00:00
LAUNCESTON,2005,9,0,0,0,2005-09-01T00:00:00
LAUNCESTON,2005,10,0,0,0,2005-10-01T00:00:00
LAUNCESTON,2005,11,0,0,0,2005-11-01T00:00:00
LAUNCESTON,2005,12,0,0,0,2005-12-01T00:00:00
LAUNCESTON,2006,1,0,0,0,2006-01-01T00:00:00
LAUNCESTON,2006,2,0,0,0,2006-02-01T00:00:00
LAUNCESTON,2006,3,0,0,0,2006-03-01T00:00:00
LAUNCESTON,2006,4,0,0,0,2006-04-01T00:00:00
LAUNCESTON,2006,5,0,0,0,2006-05-01T00:00:00
LAUNCESTON,2006,6,0,0,0,2006-06-01T00:00:00
LAUNCESTON,2006,7,0,0,0,2006-07-01T00:00:00
LAUNCESTON,2006,8,0,0,0,2006-08-01T00:00:00
LAUNCESTON,2006,9,0,0,0,2006-09-01T00:00:00
LAUNCESTON,2006,10,0,0,0,2006-10-01T00:00:00
LAUNCESTON,2006,11,0,0,0,2006-11-01T00:00:00
LAUNCESTON,2006,12,0,0,0,2006-12-01T00:00:00
LAUNCESTON,2007,1,0,0,0,2007-01-01T00:00:00
LAUNCESTON,2007,2,0,0,0,2007-02-01T00:00:00
LAUNCESTON,2007,3,0,0,0,2007-03-01T00:00:00
LAUNCESTON,2007,4,0,0,0,2007-04-01T00:00:00
LAUNCESTON,2007,5,0,0,0,2007-05-01T00:00:00
LAUNCESTON,2007,6,0,0,0,2007-06-01T00:00:00
LAUNCESTON,2007,7,0,0,0,2007-07-01T00:00:00
LAUNCESTON,2007,8,0,0,0,2007-08-01T00:00:00
LAUNCESTON,2007,9,0,0,0,2007-09-01T00:00:00
LAUNCESTON,2007,10,0,0,0,2007-10-01T00:00:00
LAUNCESTON,2007,11,0,0,0,2007-11-01T00:00:00
LAUNCESTON,2007,12,0,0,0,2007-12-01T00:00:00
LAUNCESTON,2008,1,0,0,0,2008-01-01T00:00:00
LAUNCESTON,2008,2,0,0,0,2008-02-01T00:00:00
LAUNCESTON,2008,3,0,0,0,2008-03-01T00:00:00
LAUNCESTON,2008,4,0,0,0,2008-04-01T00:00:00
LAUNCESTON,2008,5,0,0,0,2008-05-01T00:00:00
LAUNCESTON,2008,6,0,0,0,2008-06-01T00:00:00
LAUNCESTON,2008,7,0,0,0,2008-07-01T00:00:00
LAUNCESTON,2008,8,0,0,0,2008-08-01T00:00:00
LAUNCESTON,2008,9,0,0,0,2008-09-01T00:00:00
LAUNCESTON,2008,10,0,0,0,2008-10-01T00:00:00
LAUNCESTON,2008,11,0,0,0,2008-11-01T00:00:00
LAUNCESTON,2008,12,0,0,0,2008-12-01T00:00:00
LAUNCESTON,2009,1,0,0,0,2009-01-01T00:00:00
LAUNCESTON,2009,2,0,0,0,2009-02-01T00:00:00
LAUNCESTON,2009,3,0,0,0,2009-03-01T00:00:00
LAUNCESTON,2009,4,0,0,0,2009-04-01T00:00:00
LAUNCESTON,2009,5,0,0,0,2009-05-01T00:00:00
LAUNCESTON,2009,6,0,0,0,2009-06-01T00:00:00
LAUNCESTON,2009,7,0,0,0,2009-07-01T00:00:00
LAUNCESTON,2009,8,0,0,0,2009-08-01T00:00:00
LAUNCESTON,2009,9,0,0,0,2009-09-01T00:00:00
LAUNCESTON,2009,10,0,0,0,2009-10-01T00:00:00
LAUNCESTON,2009,11,0,0,0,2009-11-01T00:00:00
LAUNCESTON,2009,12,0,0,0,2009-12-01T00:00:00
LAUNCESTON,2010,1,0,0,0,2010-01-01T00:00:00
LAUNCESTON,2010,2,0,0,0,2010-02-01T00:00:00
LAUNCESTON,2010,3,0,0,0,2010-03-01T00:00:00
LAUNCESTON,2010,4,0,0,0,2010-04-01T00:00:00
LAUNCESTON,2010,5,0,0,0,2010-05-01T00:00:00
LAUNCESTON,2010,6,0,0,0,2010-06-01T00:00:00
LAUNCESTON,2010,7,0,0,0,2010-07-01T00:00:00
LAUNCESTON,2010,8,0,0,0,2010-08-01T00:00:00
LAUNCESTON,2010,9,0,0,0,2010-09-01T00:00:00
LAUNCESTON,2010,10,0,0,0,2010-10-01T00:00:00
LAUNCESTON,2010,11,0,0,0,2010-11-01T00:00:00
LAUNCESTON,2010,12,0,0,0,2010-12-01T00:00:00
LAUNCESTON,2011,1,0,0,0,2011-01-01T00:00:00
LAUNCESTON,2011,2,0,0,0,2011-02-01T00:00:00
LAUNCESTON,2011,3,0,0,0,2011-03-01T00:00:00
LAUNCESTON,2011,4,0,0,0,2011-04-01T00:00:00
LAUNCESTON,2011,5,0,0,0,2011-05-01T00:00:00
LAUNCESTON,2011,6,0,0,0,2011-06-01T00:00:00
LAUNCESTON,2011,7,0,0,0,2011-07-01T00:00:00
LAUNCESTON,2011,8,0,0,0,2011-08-01T00:00:00
LAUNCESTON,2011,9,0,0,0,2011-09-01T00:00:00
LAUNCESTON,2011,10,0,0,0,2011-10-01T00:00:00
LAUNCESTON,2011,11,0,0,0,2011-11-01T00:00:00
LAUNCESTON,2011,12,0,0,0,2011-12-01T00:00:00
LAUNCESTON,2012,1,0,0,0,2012-01-01T00:00:00
LAUNCESTON,2012,2,0,0,0,2012-02-01T00:00:00
LAUNCESTON,2012,3,0,0,0,2012-03-01T00:00:00
LAUNCESTON,2012,4,0,0,0,2012-04-01T00:00:00
LAUNCESTON,2012,5,0,0,0,2012-05-01T00:00:00
LAUNCESTON,2012,6,0,0,0,2012-06-01T00:00:00
LAUNCESTON,2012,7,0,0,0,2012-07-01T00:00:00
LAUNCESTON,2012,8,0,0,0,2012-08-01T00:00:00
LAUNCESTON,2012,9,0,0,0,2012-09-01T00:00:00
LAUNCESTON,2012,10,0,0,0,2012-10-01T00:00:00
LAUNCESTON,2012,11,0,0,0,2012-11-01T00:00:00
LAUNCESTON,2012,12,0,0,0,2012-12-01T00:00:00
LAUNCESTON,2013,1,0,0,0,2013-01-01T00:00:00
LAUNCESTON,2013,2,0,0,0,2013-02-01T00:00:00
LAUNCESTON,2013,3,0,0,0,2013-03-01T00:00:00
LAUNCESTON,2013,4,0,0,0,2013-04-01T00:00:00
LAUNCESTON,2013,5,0,0,0,2013-05-01T00:00:00
LAUNCESTON,2013,6,0,0,0,2013-06-01T00:00:00
LAUNCESTON,2013,7,0,0,0,2013-07-01T00:00:00
LAUNCESTON,2013,8,0,0,0,2013-08-01T00:00:00
LAUNCESTON,2013,9,0,0,0,2013-09-01T00:00:00
LAUNCESTON,2013,10,0,0,0,2013-10-01T00:00:00
LAUNCESTON,2013,11,0,0,0,2013-11-01T00:00:00
LAUNCESTON,2013,12,0,0,0,2013-12-01T00:00:00
LAUNCESTON,2014,1,0,0,0,2014-01-01T00:00:00
LAUNCESTON,2014,2,0,0,0,2014-02-01T00:00:00
LAUNCESTON,2014,3,0,0,0,2014-03-01T00:00:00
LAUNCESTON,2014,4,0,0,0,2014-04-01T00:00:00
LAUNCESTON,2014,5,0,0,0,2014-05-01T00:00:00
LAUNCESTON,2014,6,0,0,0,2014-06-01T00:00:00
LAUNCESTON,2014,7,0,0,0,2014-07-01T00:00:00
LAUNCESTON,2014,8,0,0,0,2014-08-01T00:00:00
LAUNCESTON,2014,9,0,0,0,2014-09-01T00:00:00
LAUNCESTON,2014,10,0,0,0,2014-10-01T00:00:00
LAUNCESTON,2014,11,0,0,0,2014-11-01T00:00:00
LAUNCESTON,2014,12,0,0,0,2014-12-01T00:00:00
LAUNCESTON,2015,1,0,0,0,2015-01-01T00:00:00
LAUNCESTON,2015,2,0,0,0,2015-02-01T00:00:00
LAUNCESTON,2015,3,0,0,0,2015-03-01T00:00:00
LAUNCESTON,2015,4,0,0,0,2015-04-01T00:00:00
LAUNCESTON,2015,5,0,0,0,2015-05-01T00:00:00
LAUNCESTON,2015,6,0,0,0,2015-06-01T00:00:00
LAUNCESTON,2015,7,0,0,0,2015-07-01T00:00:00
LAUNCESTON,2015,8,0,0,0,2015-08-01T00:00:00
LAUNCESTON,2015,9,0,0,0,2015-09-01T00:00:00
LAUNCESTON,2015,10,0,0,0,2015-10-01T00:00:00
LAUNCESTON,2015,11,0,0,0,2015-11-01T00:00:00
LAUNCESTON,2015,12,0,0,0,2015-12-01T00:00:00
LAUNCESTON,2016,1,0,0,0,2016-01-01T00:00:00
LAUNCESTON,2016,2,0,0,0,2016-02-01T00:00:00
LAUNCESTON,2016,3,0,0,0,2016-03-01T00:00:00
LAUNCESTON,2016,4,0,0,0,2016-04-01T00:00:00
LAUNCESTON,2016,5,0,0,0,2016-05-01T00:00:00
LAUNCESTON,2016,6,0,0,0,2016-06-01T00:00:00
LAUNCESTON,2016,7,0,0,0,2016-07-01T00:00:00
LAUNCESTON,2016,8,0,0,0,2016-08-01T00:00:00
LAUNCESTON,2016,9,0,0,0,2016-09-01T00:00:00
LAUNCESTON,2016,10,0,0,0,2016-10-01T00:00:00
LAUNCESTON,2016,11,0,0,0,2016-11-01T00:00:00
LAUNCESTON,2016,12,0,0,0,2016-12-01T00:00:00
LAUNCESTON,2017,1,0,0,0,2017-01-01T00:00:00
LAUNCESTON,2017,2,0,0,0,2017-02-01T00:00:00
LAUNCESTON,2017,3,0,0,0,2017-03-01T00:00:00
LAUNCESTON,2017,4,0,0,0,2017-04-01T00:00:00
LAUNCESTON,2017,5,0,0,0,2017-05-01T00:00:00
LAUNCESTON,2017,6,0,0,0,2017-06-01T00:00:00
LAUNCESTON,2017,7,0,0,0,2017-07-01T00:00:00
LAUNCESTON,2017,8,0,0,0,2017-08-01T00:00:00
LAUNCESTON,2017,9,0,0,0,2017-09-01T00:00:00
LAUNCESTON,2017,10,0,0,0,2017-10-01T00:00:00
LAUNCESTON,2017,11,0,0,0,2017-11-01T00:00:00
LAUNCESTON,2017,12,0,0,0,2017-12-01T00:00:00
LAUNCESTON,2018,1,0,0,0,2018-01-01T00:00:00
LAUNCESTON,2018,2,0,0,0,2018-02-01T00:00:00
LAUNCESTON,2018,3,0,0,0,2018-03-01T00:00:00
LAUNCESTON,2018,4,0,0,0,2018-04-01T00:00:00
LAUNCESTON,2018,5,0,0,0,2018-05-01T00:00:00
LAUNCESTON,2018,6,0,0,0,2018-06-01T00:00:00
LAUNCESTON,2018,7,0,0,0,2018-07-01T00:00:00
LAUNCESTON,2018,8,0,0,0,2018-08-01T00:00:00
LAUNCESTON,2018,9,0,0,0,2018-09-01T00:00:00
LAUNCESTON,2018,10,0,0,0,2018-10-01T00:00:00
LAUNCESTON,2018,11,0,0,0,2018-11-01T00:00:00
LAUNCESTON,2018,12,0,0,0,2018-12-01T00:00:00
LAUNCESTON,2019,1,0,0,0,2019-01-01T00:00:00
LAUNCESTON,2019,2,0,0,0,2019-02-01T00:00:00
LAUNCESTON,2019,3,0,0,0,2019-03-01T00:00:00
LAUNCESTON,2019,4,0,0,0,2019-04-01T00:00:00
LAUNCESTON,2019,5,0,0,0,2019-05-01T00:00:00
LAUNCESTON,2019,6,0,0,0,2019-06-01T00:00:00
LAUNCESTON,2019,7,0,0,0,2019-07-01T00:00:00
LAUNCESTON,2019,8,0,0,0,2019-08-01T00:00:00
LAUNCESTON,2019,9,0,0,0,2019-09-01T00:00:00
LAUNCESTON,2019,10,0,0,0,2019-10-01T00:00:00
LAUNCESTON,2019,11,0,0,0,2019-11-01T00:00:00
LAUNCESTON,2019,12,0,0,0,2019-12-01T00:00:00
LAUNCESTON,2020,1,0,0,0,2020-01-01T00:00:00
LAUNCESTON,2020,2,0,0,0,2020-02-01T00:00:00
LAUNCESTON,2020,3,0,0,0,2020-03-01T00:00:00
LAUNCESTON,2020,4,0,0,0,2020-04-01T00:00:00
LAUNCESTON,2020,5,0,0,0,2020-05-01T00:00:00
LAUNCESTON,2020,6,0,0,0,2020-06-01T00:00:00
LAUNCESTON,2020,7,0,0,0,2020-07-01T00:00:00
LAUNCESTON,2020,8,0,0,0,2020-08-01T00:00:00
LAUNCESTON,2020,9,0,0,0,2020-09-01T00:00:00
LAUNCESTON,2020,10,0,0,0,2020-10-01T00:00:00
LAUNCESTON,2020,11,0,0,0,2020-11-01T00:00:00
LAUNCESTON,2020,12,0,0,0,2020-12-01T00:00:00
LAUNCESTON,2021,1,0,0,0,2021-01-01T00:00:00
LAUNCESTON,2021,2,0,0,0,2021-02-01T00:00:00
LAUNCESTON,2021,3,0,0,0,2021-03-01T00:00:00
LAUNCESTON,2021,4,0,0,0,2021-04-01T00:00:00
LAUNCESTON,2021,5,0,0,0,2021-05-01T00:00:00
LAUNCESTON,2021,6,0,0,0,2021-06-01T00:00:00
LAUNCESTON,2021,7,0,0,0,2021-07-01T00:00:00
LAUNCESTON,2021,8,0,0,0,2021-08-01T00:00:00
LAUNCESTON,2021,9,0,0,0,2021-09-01T00:00:00
LAUNCESTON,2021,10,0,0,0,2021-10-01T00:00:00
LAUNCESTON,2021,11,0,0,0,2021-11-01T00:00:00
LAUNCESTON,2021,12,0,0,0,2021-12-01T00:00:00
LAUNCESTON,2022,1,0,0,0,2022-01-01T00:00:00
LAUNCESTON,2022,2,0,0,0,2022-02-01T00:00:00
LAUNCESTON,2022,3,0,0,0,2022-03-01T00:00:00
LAUNCESTON,2022,4,0,0,0,2022-04-01T00:00:00
LAUNCESTON,2022,5,0,0,0,2022-05-01T00:00:00
LAUNCESTON,2022,6,0,0,0,2022-06-01T00:00:00
LAUNCESTON,2022,7,0,0,0,2022-07-01T00:00:00
LAUNCESTON,2022,8,0,0,0,2022-08-01T00:00:00
LAUNCESTON,2022,9,0,0,0,2022-09-01T00:00:00
LAUNCESTON,2022,10,0,0,0,2022-10-01T00:00:00
LAUNCESTON,2022,11,0,0,0,2022-11-01T00:00:00
LAUNCESTON,2022,12,0,0,0,2022-12-01T00:00:00
LAUNCESTON,2023,1,0,0,0,2023-01-01T00:00:00
LAUNCESTON,2023,2,0,0,0,2023-02-01T00:00:00
LAUNCESTON,2023,3,0,0,0,2023-03-01T00:00:00
LAUNCESTON,2023,4,0,0,0,2023-04-01T00:00:00
LAUNCESTON,2023,5,0,0,0,2023-05-01T00:00:00
LAUNCESTON,2023,6,0,0,0,2023-06-01T00:00:00
LAUNCESTON,2023,7,0,0,0,2023-07-01T00:00:00
LAUNCESTON,2023,8,0,0,0,2023-08-01T00:00:00
LAUNCESTON,2023,9,0,0,0,2023-09-01T00:00:00
LAUNCESTON,2023,10,0,0,0,2023-10-01T00:00:00
LAUNCESTON,2023,11,0,0,0,2023-11-01T00:00:00
LAUNCESTON,2023,12,0,0,0,2023-12-01T00:00:00
LAUNCESTON,2024,1,0,0,0,2024-01-01T00:00:00
LAUNCESTON,2024,2,0,0,0,2024-02-01T00:00:00
LAUNCESTON,2024,3,0,0,0,2024-03-01T00:00:00
LAUNCESTON,2024,4,0,0,0,2024-04-01T00:00:00
LAUNCESTON,2024,5,0,0,0,2024-05-01T00:00:00
LAUNCESTON,2024,6,0,0,0,2024-06-01T00:00:00
LAUNCESTON,2024,7,0,0,0,2024-07-01T00:00:00
LAUNCESTON,2024,8,0,0,0,2024-08-01T00:00:00
LAUNCESTON,2024,9,0,0,0,2024-09-01T00:00:00
LAUNCESTON,2024,10,0,0,0,2024-10-01T00:00:00
LAUNCESTON,2024,11,0,0,0,2024-11-01T00:00:00
LAUNCESTON,2024,12,0,0,0,2024-12-01T00:00:00
LAUNCESTON,2025,1,0,0,0,2025-01-01T00:00:00
LAUNCESTON,2025,2,0,0,0,2025-02-01T00:00:00
LAUNCESTON,2025,3,0,0,0,2025-03-01T00:00:00
LAUNCESTON,2025,4,0,0,0,2025-04-01T00:00:00
LAUNCESTON,2025,5,0,0,0,2025-05-01T00:00:00
LAUNCESTON,2025,6,0,0,0,2025-06-01T00:00:00
MACKAY,1985,1,0,0,0,1985-01-01T00:00:00
MACKAY,1985,2,0,0,0,1985-02-01T00:00:00
MACKAY,1985,3,0,0,0,1985-03-01T00:00:00
MACKAY,1985,4,0,0,0,1985-04-01T00:00:00
MACKAY,1985,5,0,0,0,1985-05-01T00:00:00
MACKAY,1985,6,0,0,0,1985-06-01T00:00:00
MACKAY,1985,7,0,0,0,1985-07-01T00:00:00
MACKAY,1985,8,0,0,0,1985-08-01T00:00:00
MACKAY,1985,9,0,0,0,1985-09-01T00:00:00
MACKAY,1985,10,0,0,0,1985-10-01T00:00:00
MACKAY,1985,11,0,0,0,1985-11-01T00:00:00
MACKAY,1985,12,0,0,0,1985-12-01T00:00:00
MACKAY,1986,1,0,0,0,1986-01-01T00:00:00
MACKAY,1986,2,0,0,0,1986-02-01T00:00:00
MACKAY,1986,3,0,0,0,1986-03-01T00:00:00
MACKAY,1986,4,0,0,0,1986-04-01T00:00:00
MACKAY,1986,5,0,0,0,1986-05-01T00:00:00
MACKAY,1986,6,0,0,0,1986-06-01T00:00:00
MACKAY,1986,7,0,0,0,1986-07-01T00:00:00
MACKAY,1986,8,0,0,0,1986-08-01T00:00:00
MACKAY,1986,9,0,0,0,1986-09-01T00:00:00
MACKAY,1986,10,0,0,0,1986-10-01T00:00:00
MACKAY,1986,11,0,0,0,1986-11-01T00:00:00
MACKAY,1986,12,0,0,0,1986-12-01T00:00:00
MACKAY,1987,1,0,0,0,1987-01-01T00:00:00
MACKAY,1987,2,0,0,0,1987-02-01T00:00:00
MACKAY,1987,3,0,0,0,1987-03-01T00:00:00
MACKAY,1987,4,0,0,0,1987-04-01T00:00:00
MACKAY,1987,5,0,0,0,1987-05-01T00:00:00
MACKAY,1987,6,0,0,0,1987-06-01T00:00:00
MACKAY,1987,7,0,0,0,1987-07-01T00:00:00
MACKAY,1987,8,0,0,0,1987-08-01T00:00:00
MACKAY,1987,9,0,0,0,1987-09-01T00:00:00
MACKAY,1987,10,0,0,0,1987-10-01T00:00:00
MACKAY,1987,11,0,0,0,1987-11-01T00:00:00
MACKAY,1987,12,0,0,0,1987-12-01T00:00:00
MACKAY,1988,1,0,0,0,1988-01-01T00:00:00
MACKAY,1988,2,0,0,0,1988-02-01T00:00:00
MACKAY,1988,3,0,0,0,1988-03-01T00:00:00
MACKAY,1988,4,0,0,0,1988-04-01T00:00:00
MACKAY,1988,5,0,0,0,1988-05-01T00:00:00
MACKAY,1988,6,0,0,0,1988-06-01T00:00:00
MACKAY,1988,7,0,0,0,1988-07-01T00:00:00
MACKAY,1988,8,0,0,0,1988-08-01T00:00:00
MACKAY,1988,9,0,0,0,1988-09-01T00:00:00
MACKAY,1988,10,0,0,0,1988-10-01T00:00:00
MACKAY,1988,11,0,0,0,1988-11-01T00:00:00
MACKAY,1988,12,0,0,0,1988-12-01T00:00:00
MACKAY,1989,1,0,0,0,1989-01-01T00:00:00
MACKAY,1989,2,0,0,0,1989-02-01T00:00:00
MACKAY,1989,3,0,0,0,1989-03-01T00:00:00
MACKAY,1989,4,0,0,0,1989-04-01T00:00:00
MACKAY,1989,5,0,0,0,1989-05-01T00:00:00
MACKAY,1989,6,0,0,0,1989-06-01T00:00:00
MACKAY,1989,7,0,0,0,1989-07-01T00:00:00
MACKAY,1989,8,0,0,0,1989-08-01T00:00:00
MACKAY,1989,9,0,0,0,1989-09-01T00:00:00
MACKAY,1989,10,0,0,0,1989-10-01T00:00:00
MACKAY,1989,11,0,0,0,1989-11-01T00:00:00
MACKAY,1989,12,0,0,0,1989-12-01T00:00:00
MACKAY,1990,1,0,0,0,1990-01-01T00:00:00
MACKAY,1990,2,0,0,0,1990-02-01T00:00:00
MACKAY,1990,3,0,0,0,1990-03-01T00:00:00
MACKAY,1990,4,0,0,0,1990-04-01T00:00:00
MACKAY,1990,5,0,0,0,1990-05-01T00:00:00
MACKAY,1990,6,0,0,0,1990-06-01T00:00:00
MACKAY,1990,7,0,0,0,1990-07-01T00:00:00
MACKAY,1990,8,0,0,0,1990-08-01T00:00:00
MACKAY,1990,9,0,0,0,1990-09-01T00:00:00
MACKAY,1990,10,0,0,0,1990-10-01T00:00:00
MACKAY,1990,11,0,0,0,1990-11-01T00:00:00
MACKAY,1990,12,0,0,0,1990-12-01T00:00:00
MACKAY,1991,1,0,0,0,1991-01-01T00:00:00
MACKAY,1991,2,0,0,0,1991-02-01T00:00:00
MACKAY,1991,3,0,0,0,1991-03-01T00:00:00
MACKAY,1991,4,0,0,0,1991-04-01T00:00:00
MACKAY,1991,5,0,0,0,1991-05-01T00:00:00
MACKAY,1991,6,0,0,0,1991-06-01T00:00:00
MACKAY,1991,7,0,0,0,1991-07-01T00:00:00
MACKAY,1991,8,0,0,0,1991-08-01T00:00:00
MACKAY,1991,9,0,0,0,1991-09-01T00:00:00
MACKAY,1991,10,0,0,0,1991-10-01T00:00:00
MACKAY,1991,11,0,0,0,1991-11-01T00:00:00
MACKAY,1991,12,0,0,0,1991-12-01T00:00:00
MACKAY,1992,1,0,0,0,1992-01-01T00:00:00
MACKAY,1992,2,0,0,0,1992-02-01T00:00:00
MACKAY,1992,3,0,0,0,1992-03-01T00:00:00
MACKAY,1992,4,0,0,0,1992-04-01T00:00:00
MACKAY,1992,5,0,0,0,1992-05-01T00:00:00
MACKAY,1992,6,0,0,0,1992-06-01T00:00:00
MACKAY,1992,7,0,0,0,1992-07-01T00:00:00
MACKAY,1992,8,0,0,0,1992-08-01T00:00:00
MACKAY,1992,9,0,0,0,1992-09-01T00:00:00
MACKAY,1992,10,0,0,0,1992-10-01T00:00:00
MACKAY,1992,11,0,0,0,1992-11-01T00:00:00
MACKAY,1992,12,0,0,0,1992-12-01T00:00:00
MACKAY,1993,1,0,0,0,1993-01-01T00:00:00
MACKAY,1993,2,0,0,0,1993-02-01T00:00:00
MACKAY,1993,3,0,0,0,1993-03-01T00:00:00
MACKAY,1993,4,0,0,0,1993-04-01T00:00:00
MACKAY,1993,5,0,0,0,1993-05-01T00:00:00
MACKAY,1993,6,0,0,0,1993-06-01T00:00:00
MACKAY,1993,7,0,0,0,1993-07-01T00:00:00
MACKAY,1993,8,0,0,0,1993-08-01T00:00:00
MACKAY,1993,9,0,0,0,1993-09-01T00:00:00
MACKAY,1993,10,0,0,0,1993-10-01T00:00:00
MACKAY,1993,11,0,0,0,1993-11-01T00:00:00
MACKAY,1993,12,0,0,0,1993-12-01T00:00:00
MACKAY,1994,1,0,0,0,1994-01-01T00:00:00
MACKAY,1994,2,0,0,0,1994-02-01T00:00:00
MACKAY,1994,3,0,0,0,1994-03-01T00:00:00
MACKAY,1994,4,0,0,0,1994-04-01T00:00:00
MACKAY,1994,5,0,0,0,1994-05-01T00:00:00
MACKAY,1994,6,0,0,0,1994-06-01T00:00:00
MACKAY,1994,7,0,0,0,1994-07-01T00:00:00
MACKAY,1994,8,0,0,0,1994-08-01T00:00:00
MACKAY,1994,9,0,0,0,1994-09-01T00:00:00
MACKAY,1994,10,0,0,0,1994-10-01T00:00:00
MACKAY,1994,11,0,0,0,1994-11-01T00:00:00
MACKAY,1994,12,0,0,0,1994-12-01T00:00:00
MACKAY,1995,1,0,0,0,1995-01-01T00:00:00
MACKAY,1995,2,0,0,0,1995-02-01T00:00:00
MACKAY,1995,3,0,0,0,1995-03-01T00:00:00
MACKAY,1995,4,0,0,0,1995-04-01T00:00:00
MACKAY,1995,5,0,0,0,1995-05-01T00:00:00
MACKAY,1995,6,0,0,0,1995-06-01T00:00:00
MACKAY,1995,7,0,0,0,1995-07-01T00:00:00
MACKAY,1995,8,0,0,0,1995-08-01T00:00:00
MACKAY,1995,9,0,0,0,1995-09-01T00:00:00
MACKAY,1995,10,0,0,0,1995-10-01T00:00:00
MACKAY,1995,11,0,0,0,1995-11-01T00:00:00
MACKAY,1995,12,0,0,0,1995-12-01T00:00:00
MACKAY,1996,1,0,0,0,1996-01-01T00:00:00
MACKAY,1996,2,0,0,0,1996-02-01T00:00:00
MACKAY,1996,3,0,0,0,1996-03-01T00:00:00
MACKAY,1996,4,0,0,0,1996-04-01T00:00:00
MACKAY,1996,5,0,0,0,1996-05-01T00:00:00
MACKAY,1996,6,0,0,0,1996-06-01T00:00:00
MACKAY,1996,7,0,0,0,1996-07-01T00:00:00
MACKAY,1996,8,0,0,0,1996-08-01T00:00:00
MACKAY,1996,9,0,0,0,1996-09-01T00:00:00
MACKAY,1996,10,0,0,0,1996-10-01T00:00:00
MACKAY,1996,11,0,0,0,1996-11-01T00:00:00
MACKAY,1996,12,0,0,0,1996-12-01T00:00:00
MACKAY,1997,1,0,0,0,1997-01-01T00:00:00
MACKAY,1997,2,0,0,0,1997-02-01T00:00:00
MACKAY,1997,3,0,0,0,1997-03-01T00:00:00
MACKAY,1997,4,0,0,0,1997-04-01T00:00:00
MACKAY,1997,5,0,0,0,1997-05-01T00:00:00
MACKAY,1997,6,0,0,0,1997-06-01T00:00:00
MACKAY,1997,7,0,0,0,1997-07-01T00:00:00
MACKAY,1997,8,0,0,0,1997-08-01T00:00:00
MACKAY,1997,9,0,0,0,1997-09-01T00:00:00
MACKAY,1997,10,0,0,0,1997-10-01T00:00:00
MACKAY,1997,11,0,0,0,1997-11-01T00:00:00
MACKAY,1997,12,0,0,0,1997-12-01T00:00:00
MACKAY,1998,1,0,0,0,1998-01-01T00:00:00
MACKAY,1998,2,0,0,0,1998-02-01T00:00:00
MACKAY,1998,3,0,0,0,1998-03-01T00:00:00
MACKAY,1998,4,0,0,0,1998-04-01T00:00:00
MACKAY,1998,5,0,0,0,1998-05-01T00:00:00
MACKAY,1998,6,0,0,0,1998-06-01T00:00:00
MACKAY,1998,7,0,0,0,1998-07-01T00:00:00
MACKAY,1998,8,0,0,0,1998-08-01T00:00:00
MACKAY,1998,9,0,0,0,1998-09-01T00:00:00
MACKAY,1998,10,0,0,0,1998-10-01T00:00:00
MACKAY,1998,11,0,0,0,1998-11-01T00:00:00
MACKAY,1998,12,0,0,0,1998-12-01T00:00:00
MACKAY,1999,1,0,0,0,1999-01-01T00:00:00
MACKAY,1999,2,0,0,0,1999-02-01T00:00:00
MACKAY,1999,3,0,0,0,1999-03-01T00:00:00
MACKAY,1999,4,0,0,0,1999-04-01T00:00:00
MACKAY,1999,5,0,0,0,1999-05-01T00:00:00
MACKAY,1999,6,0,0,0,1999-06-01T00:00:00
MACKAY,1999,7,0,0,0,1999-07-01T00:00:00
MACKAY,1999,8,0,0,0,1999-08-01T00:00:00
MACKAY,1999,9,0,0,0,1999-09-01T00:00:00
MACKAY,1999,10,0,0,0,1999-10-01T00:00:00
MACKAY,1999,11,0,0,0,1999-11-01T00:00:00
MACKAY,1999,12,0,0,0,1999-12-01T00:00:00
MACKAY,2000,1,0,0,0,2000-01-01T00:00:00
MACKAY,2000,2,0,0,0,2000-02-01T00:00:00
MACKAY,2000,3,0,0,0,2000-03-01T00:00:00
MACKAY,2000,4,0,0,0,2000-04-01T00:00:00
MACKAY,2000,5,0,0,0,2000-05-01T00:00:00
MACKAY,2000,6,0,0,0,2000-06-01T00:00:00
MACKAY,2000,7,0,0,0,2000-07-01T00:00:00
MACKAY,2000,8,0,0,0,2000-08-01T00:00:00
MACKAY,2000,9,0,0,0,2000-09-01T00:00:00
MACKAY,2000,10,0,0,0,2000-10-01T00:00:00
MACKAY,2000,11,0,0,0,2000-11-01T00:00:00
MACKAY,2000,12,0,0,0,2000-12-01T00:00:00
MACKAY,2001,1,0,0,0,2001-01-01T00:00:00
MACKAY,2001,2,0,0,0,2001-02-01T00:00:00
MACKAY,2001,3,0,0,0,2001-03-01T00:00:00
MACKAY,2001,4,0,0,0,2001-04-01T00:00:00
MACKAY,2001,5,0,0,0,2001-05-01T00:00:00
MACKAY,2001,6,0,0,0,2001-06-01T00:00:00
MACKAY,2001,7,0,0,0,2001-07-01T00:00:00
MACKAY,2001,8,0,0,0,2001-08-01T00:00:00
MACKAY,2001,9,0,0,0,2001-09-01T00:00:00
MACKAY,2001,10,0,0,0,2001-10-01T00:00:00
MACKAY,2001,11,0,0,0,2001-11-01T00:00:00
MACKAY,2001,12,0,0,0,2001-12-01T00:00:00
MACKAY,2002,1,0,0,0,2002-01-01T00:00:00
MACKAY,2002,2,0,0,0,2002-02-01T00:00:00
MACKAY,2002,3,0,0,0,2002-03-01T00:00:00
MACKAY,2002,4,0,0,0,2002-04-01T00:00:00
MACKAY,2002,5,0,0,0,2002-05-01T00:00:00
MACKAY,2002,6,0,0,0,2002-06-01T00:00:00
MACKAY,2002,7,0,0,0,2002-07-01T00:00:00
MACKAY,2002,8,0,0,0,2002-08-01T00:00:00
MACKAY,2002,9,0,0,0,2002-09-01T00:00:00
MACKAY,2002,10,0,0,0,2002-10-01T00:00:00
MACKAY,2002,11,0,0,0,2002-11-01T00:00:00
MACKAY,2002,12,0,0,0,2002-12-01T00:00:00
MACKAY,2003,1,0,0,0,2003-01-01T00:00:00
MACKAY,2003,2,0,0,0,2003-02-01T00:00:00
MACKAY,2003,3,0,0,0,2003-03-01T00:00:00
MACKAY,2003,4,0,0,0,2003-04-01T00:00:00
MACKAY,2003,5,0,0,0,2003-05-01T00:00:00
MACKAY,2003,6,0,0,0,2003-06-01T00:00:00
MACKAY,2003,7,0,0,0,2003-07-01T00:00:00
MACKAY,2003,8,0,0,0,2003-08-01T00:00:00
MACKAY,2003,9,0,0,0,2003-09-01T00:00:00
MACKAY,2003,10,0,0,0,2003-10-01T00:00:00
MACKAY,2003,11,0,0,0,2003-11-01T00:00:00
MACKAY,2003,12,0,0,0,2003-12-01T00:00:00
MACKAY,2004,1,0,0,0,2004-01-01T00:00:00
MACKAY,2004,2,0,0,0,2004-02-01T00:00:00
MACKAY,2004,3,0,0,0,2004-03-01T00:00:00
MACKAY,2004,4,0,0,0,2004-04-01T00:00:00
MACKAY,2004,5,0,0,0,2004-05-01T00:00:00
MACKAY,2004,6,0,0,0,2004-06-01T00:00:00
MACKAY,2004,7,0,0,0,2004-07-01T00:00:00
MACKAY,2004,8,0,0,0,2004-08-01T00:00:00
MACKAY,2004,9,0,0,0,2004-09-01T00:00:00
MACKAY,2004,10,0,0,0,2004-10-01T00:00:00
MACKAY,2004,11,0,0,0,2004-11-01T00:00:00
MACKAY,2004,12,0,0,0,2004-12-01T00:00:00
MACKAY,2005,1,0,0,0,2005-01-01T00:00:00
MACKAY,2005,2,0,0,0,2005-02-01T00:00:00
MACKAY,2005,3,0,0,0,2005-03-01T00:00:00
MACKAY,2005,4,0,0,0,2005-04-01T00:00:00
MACKAY,2005,5,0,0,0,2005-05-01T00:00:00
MACKAY,2005,6,0,0,0,2005-06-01T00:00:00
MACKAY,2005,7,0,0,0,2005-07-01T00:00:00
MACKAY,2005,8,0,0,0,2005-08-01T00:00:00
MACKAY,2005,9,0,0,0,2005-09-01T00:00:00
MACKAY,2005,10,0,0,0,2005-10-01T00:00:00
MACKAY,2005,11,0,0,0,2005-11-01T00:00:00
MACKAY,2005,12,0,0,0,2005-12-01T00:00:00
MACKAY,2006,1,0,0,0,2006-01-01T00:00:00
MACKAY,2006,2,0,0,0,2006-02-01T00:00:00
MACKAY,2006,3,0,0,0,2006-03-01T00:00:00
MACKAY,2006,4,0,0,0,2006-04-01T00:00:00
MACKAY,2006,5,0,0,0,2006-05-01T00:00:00
MACKAY,2006,6,0,0,0,2006-06-01T00:00:00
MACKAY,2006,7,0,0,0,2006-07-01T00:00:00
MACKAY,2006,8,0,0,0,2006-08-01T00:00:00
MACKAY,2006,9,0,0,0,2006-09-01T00:00:00
MACKAY,2006,10,0,0,0,2006-10-01T00:00:00
MACKAY,2006,11,0,0,0,2006-11-01T00:00:00
MACKAY,2006,12,0,0,0,2006-12-01T00:00:00
MACKAY,2007,1,0,0,0,2007-01-01T00:00:00
MACKAY,2007,2,0,0,0,2007-02-01T00:00:00
MACKAY,2007,3,0,0,0,2007-03-01T00:00:00
MACKAY,2007,4,0,0,0,2007-04-01T00:00:00
MACKAY,2007,5,0,0,0,2007-05-01T00:00:00
MACKAY,2007,6,0,0,0,2007-06-01T00:00:00
MACKAY,2007,7,0,0,0,2007-07-01T00:00:00
MACKAY,2007,8,0,0,0,2007-08-01T00:00:00
MACKAY,2007,9,0,0,0,2007-09-01T00:00:00
MACKAY,2007,10,0,0,0,2007-10-01T00:00:00
MACKAY,2007,11,0,0,0,2007-11-01T00:00:00
MACKAY,2007,12,0,0,0,2007-12-01T00:00:00
MACKAY,2008,1,0,0,0,2008-01-01T00:00:00
MACKAY,2008,2,0,0,0,2008-02-01T00:00:00
MACKAY,2008,3,0,0,0,2008-03-01T00:00:00
MACKAY,2008,4,0,0,0,2008-04-01T00:00:00
MACKAY,2008,5,0,0,0,2008-05-01T00:00:00
MACKAY,2008,6,0,0,0,2008-06-01T00:00:00
MACKAY,2008,7,0,0,0,2008-07-01T00:00:00
MACKAY,2008,8,0,0,0,2008-08-01T00:00:00
MACKAY,2008,9,0,0,0,2008-09-01T00:00:00
MACKAY,2008,10,0,0,0,2008-10-01T00:00:00
MACKAY,2008,11,0,0,0,2008-11-01T00:00:00
MACKAY,2008,12,0,0,0,2008-12-01T00:00:00
MACKAY,2009,1,0,0,0,2009-01-01T00:00:00
MACKAY,2009,2,0,0,0,2009-02-01T00:00:00
MACKAY,2009,3,0,0,0,2009-03-01T00:00:00
MACKAY,2009,4,0,0,0,2009-04-01T00:00:00
MACKAY,2009,5,0,0,0,2009-05-01T00:00:00
MACKAY,2009,6,0,0,0,2009-06-01T00:00:00
MACKAY,2009,7,0,0,0,2009-07-01T00:00:00
MACKAY,2009,8,0,0,0,2009-08-01T00:00:00
MACKAY,2009,9,0,0,0,2009-09-01T00:00:00
MACKAY,2009,10,0,0,0,2009-10-01T00:00:00
MACKAY,2009,11,0,0,0,2009-11-01T00:00:00
MACKAY,2009,12,0,0,0,2009-12-01T00:00:00
MACKAY,2010,1,0,0,0,2010-01-01T00:00:00
MACKAY,2010,2,0,0,0,2010-02-01T00:00:00
MACKAY,2010,3,0,0,0,2010-03-01T00:00:00
MACKAY,2010,4,0,0,0,2010-04-01T00:00:00
MACKAY,2010,5,0,0,0,2010-05-01T00:00:00
MACKAY,2010,6,0,0,0,2010-06-01T00:00:00
MACKAY,2010,7,0,0,0,2010-07-01T00:00:00
MACKAY,2010,8,0,0,0,2010-08-01T00:00:00
MACKAY,2010,9,0,0,0,2010-09-01T00:00:00
MACKAY,2010,10,0,0,0,2010-10-01T00:00:00
MACKAY,2010,11,0,0,0,2010-11-01T00:00:00
MACKAY,2010,12,0,0,0,2010-12-01T00:00:00
MACKAY,2011,1,0,0,0,2011-01-01T00:00:00
MACKAY,2011,2,0,0,0,2011-02-01T00:00:00
MACKAY,2011,3,0,0,0,2011-03-01T00:00:00
MACKAY,2011,4,0,0,0,2011-04-01T00:00:00
MACKAY,2011,5,0,0,0,2011-05-01T00:00:00
MACKAY,2011,6,0,0,0,2011-06-01T00:00:00
MACKAY,2011,7,0,0,0,2011-07-01T00:00:00
MACKAY,2011,8,0,0,0,2011-08-01T00:00:00
MACKAY,2011,9,0,0,0,2011-09-01T00:00:00
MACKAY,2011,10,0,0,0,2011-10-01T00:00:00
MACKAY,2011,11,0,0,0,2011-11-01T00:00:00
MACKAY,2011,12,0,0,0,2011-12-01T00:00:00
MACKAY,2012,1,0,0,0,2012-01-01T00:00:00
MACKAY,2012,2,0,0,0,2012-02-01T00:00:00
MACKAY,2012,3,0,0,0,2012-03-01T00:00:00
MACKAY,2012,4,0,0,0,2012-04-01T00:00:00
MACKAY,2012,5,0,0,0,2012-05-01T00:00:00
MACKAY,2012,6,0,0,0,2012-06-01T00:00:00
MACKAY,2012,7,0,0,0,2012-07-01T00:00:00
MACKAY,2012,8,0,0,0,2012-08-01T00:00:00
MACKAY,2012,9,0,0,0,2012-09-01T00:00:00
MACKAY,2012,10,0,0,0,2012-10-01T00:00:00
MACKAY,2012,11,0,0,0,2012-11-01T00:00:00
MACKAY,2012,12,0,0,0,2012-12-01T00:00:00
MACKAY,2013,1,0,0,0,2013-01-01T00:00:00
MACKAY,2013,2,0,0,0,2013-02-01T00:00:00
MACKAY,2013,3,0,0,0,2013-03-01T00:00:00
MACKAY,2013,4,0,0,0,2013-04-01T00:00:00
MACKAY,2013,5,0,0,0,2013-05-01T00:00:00
MACKAY,2013,6,0,0,0,2013-06-01T00:00:00
MACKAY,2013,7,0,0,0,2013-07-01T00:00:00
MACKAY,2013,8,0,0,0,2013-08-01T00:00:00
MACKAY,2013,9,0,0,0,2013-09-01T00:00:00
MACKAY,2013,10,0,0,0,2013-10-01T00:00:00
MACKAY,2013,11,0,0,0,2013-11-01T00:00:00
MACKAY,2013,12,0,0,0,2013-12-01T00:00:00
MACKAY,2014,1,0,0,0,2014-01-01T00:00:00
MACKAY,2014,2,0,0,0,2014-02-01T00:00:00
MACKAY,2014,3,0,0,0,2014-03-01T00:00:00
MACKAY,2014,4,0,0,0,2014-04-01T00:00:00
MACKAY,2014,5,0,0,0,2014-05-01T00:00:00
MACKAY,2014,6,0,0,0,2014-06-01T00:00:00
MACKAY,2014,7,0,0,0,2014-07-01T00:00:00
MACKAY,2014,8,0,0,0,2014-08-01T00:00:00
MACKAY,2014,9,0,0,0,2014-09-01T00:00:00
MACKAY,2014,10,0,0,0,2014-10-01T00:00:00
MACKAY,2014,11,0,0,0,2014-11-01T00:00:00
MACKAY,2014,12,0,0,0,2014-12-01T00:00:00
MACKAY,2015,1,0,0,0,2015-01-01T00:00:00
MACKAY,2015,2,0,0,0,2015-02-01T00:00:00
MACKAY,2015,3,0,0,0,2015-03-01T00:00:00
MACKAY,2015,4,0,0,0,2015-04-01T00:00:00
MACKAY,2015,5,0,0,0,2015-05-01T00:00:00
MACKAY,2015,6,0,0,0,2015-06-01T00:00:00
MACKAY,2015,7,0,0,0,2015-07-01T00:00:00
MACKAY,2015,8,0,0,0,2015-08-01T00:00:00
MACKAY,2015,9,0,0,0,2015-09-01T00:00:00
MACKAY,2015,10,0,0,0,2015-10-01T00:00:00
MACKAY,2015,11,0,0,0,2015-11-01T00:00:00
MACKAY,2015,12,0,0,0,2015-12-01T00:00:00
MACKAY,2016,1,0,0,0,2016-01-01T00:00:00
MACKAY,2016,2,0,0,0,2016-02-01T00:00:00
MACKAY,2016,3,0,0,0,2016-03-01T00:00:00
MACKAY,2016,4,0,0,0,2016-04-01T00:00:00
MACKAY,2016,5,0,0,0,2016-05-01T00:00:00
MACKAY,2016,6,0,0,0,2016-06-01T00:00:00
MACKAY,2016,7,0,0,0,2016-07-01T00:00:00
MACKAY,2016,8,0,0,0,2016-08-01T00:00:00
MACKAY,2016,9,0,0,0,2016-09-01T00:00:00
MACKAY,2016,10,0,0,0,2016-10-01T00:00:00
MACKAY,2016,11,0,0,0,2016-11-01T00:00:00
MACKAY,2016,12,0,0,0,2016-12-01T00:00:00
MACKAY,2017,1,0,0,0,2017-01-01T00:00:00
MACKAY,2017,2,0,0,0,2017-02-01T00:00:00
MACKAY,2017,3,0,0,0,2017-03-01T00:00:00
MACKAY,2017,4,0,0,0,2017-04-01T00:00:00
MACKAY,2017,5,0,0,0,2017-05-01T00:00:00
MACKAY,2017,6,0,0,0,2017-06-01T00:00:00
MACKAY,2017,7,0,0,0,2017-07-01T00:00:00
MACKAY,2017,8,0,0,0,2017-08-01T00:00:00
MACKAY,2017,9,0,0,0,2017-09-01T00:00:00
MACKAY,2017,10,0,0,0,2017-10-01T00:00:00
MACKAY,2017,11,0,0,0,2017-11-01T00:00:00
MACKAY,2017,12,0,0,0,2017-12-01T00:00:00
MACKAY,2018,1,0,0,0,2018-01-01T00:00:00
MACKAY,2018,2,0,0,0,2018-02-01T00:00:00
MACKAY,2018,3,0,0,0,2018-03-01T00:00:00
MACKAY,2018,4,0,0,0,2018-04-01T00:00:00
MACKAY,2018,5,0,0,0,2018-05-01T00:00:00
MACKAY,2018,6,0,0,0,2018-06-01T00:00:00
MACKAY,2018,7,0,0,0,2018-07-01T00:00:00
MACKAY,2018,8,0,0,0,2018-08-01T00:00:00
MACKAY,2018,9,0,0,0,2018-09-01T00:00:00
MACKAY,2018,10,0,0,0,2018-10-01T00:00:00
MACKAY,2018,11,0,0,0,2018-11-01T00:00:00
MACKAY,2018,12,0,0,0,2018-12-01T00:00:00
MACKAY,2019,1,0,0,0,2019-01-01T00:00:00
MACKAY,2019,2,0,0,0,2019-02-01T00:00:00
MACKAY,2019,3,0,0,0,2019-03-01T00:00:00
MACKAY,2019,4,0,0,0,2019-04-01T00:00:00
MACKAY,2019,5,0,0,0,2019-05-01T00:00:00
MACKAY,2019,6,0,0,0,2019-06-01T00:00:00
MACKAY,2019,7,0,0,0,2019-07-01T00:00:00
MACKAY,2019,8,0,0,0,2019-08-01T00:00:00
MACKAY,2019,9,0,0,0,2019-09-01T00:00:00
MACKAY,2019,10,0,0,0,2019-10-01T00:00:00
MACKAY,2019,11,0,0,0,2019-11-01T00:00:00
MACKAY,2019,12,0,0,0,2019-12-01T00:00:00
MACKAY,2020,1,0,0,0,2020-01-01T00:00:00
MACKAY,2020,2,0,0,0,2020-02-01T00:00:00
MACKAY,2020,3,0,0,0,2020-03-01T00:00:00
MACKAY,2020,4,0,0,0,2020-04-01T00:00:00
MACKAY,2020,5,0,0,0,2020-05-01T00:00:00
MACKAY,2020,6,0,0,0,2020-06-01T00:00:00
MACKAY,2020,7,0,0,0,2020-07-01T00:00:00
MACKAY,2020,8,0,0,0,2020-08-01T00:00:00
MACKAY,2020,9,0,0,0,2020-09-01T00:00:00
MACKAY,2020,10,0,0,0,2020-10-01T00:00:00
MACKAY,2020,11,0,0,0,2020-11-01T00:00:00
MACKAY,2020,12,0,0,0,2020-12-01T00:00:00
MACKAY,2021,1,0,0,0,2021-01-01T00:00:00
MACKAY,2021,2,0,0,0,2021-02-01T00:00:00
MACKAY,2021,3,0,0,0,2021-03-01T00:00:00
MACKAY,2021,4,0,0,0,2021-04-01T00:00:00
MACKAY,2021,5,0,0,0,2021-05-01T00:00:00
MACKAY,2021,6,0,0,0,2021-06-01T00:00:00
MACKAY,2021,7,0,0,0,2021-07-01T00:00:00
MACKAY,2021,8,0,0,0,2021-08-01T00:00:00
MACKAY,2021,9,0,0,0,2021-09-01T00:00:00
MACKAY,2021,10,0,0,0,2021-10-01T00:00:00
MACKAY,2021,11,0,0,0,2021-11-01T00:00:00
MACKAY,2021,12,0,0,0,2021-12-01T00:00:00
MACKAY,2022,1,0,0,0,2022-01-01T00:00:00
MACKAY,2022,2,0,0,0,2022-02-01T00:00:00
MACKAY,2022,3,0,0,0,2022-03-01T00:00:00
MACKAY,2022,4,0,0,0,2022-04-01T00:00:00
MACKAY,2022,5,0,0,0,2022-05-01T00:00:00
MACKAY,2022,6,0,0,0,2022-06-01T00:00:00
MACKAY,2022,7,0,0,0,2022-07-01T00:00:00
MACKAY,2022,8,0,0,0,2022-08-01T00:00:00
MACKAY,2022,9,0,0,0,2022-09-01T00:00:00
MACKAY,2022,10,0,0,0,2022-10-01T00:00:00
MACKAY,2022,11,0,0,0,2022-11-01T00:00:00
MACKAY,2022,12,0,0,0,2022-12-01T00:00:00
MACKAY,2023,1,0,0,0,2023-01-01T00:00:00
MACKAY,2023,2,0,0,0,2023-02-01T00:00:00
MACKAY,2023,3,0,0,0,2023-03-01T00:00:00
MACKAY,2023,4,0,0,0,2023-04-01T00:00:00
MACKAY,2023,5,0,0,0,2023-05-01T00:00:00
MACKAY,2023,6,0,0,0,2023-06-01T00:00:00
MACKAY,2023,7,0,0,0,2023-07-01T00:00:00
MACKAY,2023,8,0,0,0,2023-08-01T00:00:00
MACKAY,2023,9,0,0,0,2023-09-01T00:00:00
MACKAY,2023,10,0,0,0,2023-10-01T00:00:00
MACKAY,2023,11,0,0,0,2023-11-01T00:00:00
MACKAY,2023,12,0,0,0,2023-12-01T00:00:00
MACKAY,2024,1,0,0,0,2024-01-01T00:00:00
MACKAY,2024,2,0,0,0,2024-02-01T00:00:00
MACKAY,2024,3,0,0,0,2024-03-01T00:00:00
MACKAY,2024,4,0,0,0,2024-04-01T00:00:00
MACKAY,2024,5,0,0,0,2024-05-01T00:00:00
MACKAY,2024,6,0,0,0,2024-06-01T00:00:00
MACKAY,2024,7,0,0,0,2024-07-01T00:00:00
MACKAY,2024,8,0,0,0,2024-08-01T00:00:00
MACKAY,2024,9,0,0,0,2024-09-01T00:00:00
MACKAY,2024,10,0,0,0,2024-10-01T00:00:00
MACKAY,2024,11,0,0,0,2024-11-01T00:00:00
MACKAY,2024,12,0,0,0,2024-12-01T00:00:00
MACKAY,2025,1,0,0,0,2025-01-01T00:00:00
MACKAY,2025,2,0,0,0,2025-02-01T00:00:00
MACKAY,2025,3,0,0,0,2025-03-01T00:00:00
MACKAY,2025,4,0,0,0,2025-04-01T00:00:00
MACKAY,2025,5,0,0,0,2025-05-01T00:00:00
MACKAY,2025,6,0,0,0,2025-06-01T00:00:00
MELBOURNE,1985,1,60993,46287,107280,1985-01-01T00:00:00
MELBOURNE,1985,2,49421,38273,87694,1985-02-01T00:00:00
MELBOURNE,1985,3,43664,52459,96123,1985-03-01T00:00:00
MELBOURNE,1985,4,37818,49088,86906,1985-04-01T00:00:00
MELBOURNE,1985,5,43843,53808,97651,1985-05-01T00:00:00
MELBOURNE,1985,6,43094,47240,90334,1985-06-01T00:00:00
MELBOURNE,1985,7,47568,50356,97924,1985-07-01T00:00:00
MELBOURNE,1985,8,51807,52527,104334,1985-08-01T00:00:00
MELBOURNE,1985,9,62602,41145,103747,1985-09-01T00:00:00
MELBOURNE,1985,10,58200,35929,94129,1985-10-01T00:00:00
MELBOURNE,1985,11,52209,42466,94675,1985-11-01T00:00:00
MELBOURNE,1985,12,52122,61521,113643,1985-12-01T00:00:00
MELBOURNE,1986,1,65598,51261,116859,1986-01-01T00:00:00
MELBOURNE,1986,2,51836,39152,90988,1986-02-01T00:00:00
MELBOURNE,1986,3,43523,48894,92417,1986-03-01T00:00:00
MELBOURNE,1986,4,43239,51176,94415,1986-04-01T00:00:00
MELBOURNE,1986,5,47958,56902,104860,1986-05-01T00:00:00
MELBOURNE,1986,6,44415,48510,92925,1986-06-01T00:00:00
MELBOURNE,1986,7,49505,52158,101663,1986-07-01T00:00:00
MELBOURNE,1986,8,60089,62471,122560,1986-08-01T00:00:00
MELBOURNE,1986,9,66987,46325,113312,1986-09-01T00:00:00
MELBOURNE,1986,10,64352,43722,108074,1986-10-01T00:00:00
MELBOURNE,1986,11,58774,51074,109848,1986-11-01T00:00:00
MELBOURNE,1986,12,59367,65791,125158,1986-12-01T00:00:00
MELBOURNE,1987,1,75017,55952,130969,1987-01-01T00:00:00
MELBOURNE,1987,2,60597,46479,107076,1987-02-01T00:00:00
MELBOURNE,1987,3,54002,60158,114160,1987-03-01T00:00:00
MELBOURNE,1987,4,50932,52682,103614,1987-04-01T00:00:00
MELBOURNE,1987,5,47989,57865,105854,1987-05-01T00:00:00
MELBOURNE,1987,6,45982,57200,103182,1987-06-01T00:00:00
MELBOURNE,1987,7,64716,55056,119772,1987-07-01T00:00:00
MELBOURNE,1987,8,62874,58505,121379,1987-08-01T00:00:00
MELBOURNE,1987,9,67981,61591,129572,1987-09-01T00:00:00
MELBOURNE,1987,10,81777,46722,128499,1987-10-01T00:00:00
MELBOURNE,1987,11,68808,52302,121110,1987-11-01T00:00:00
MELBOURNE,1987,12,64926,68578,133504,1987-12-01T00:00:00
MELBOURNE,1988,1,80311,63356,143667,1988-01-01T00:00:00
MELBOURNE,1988,2,65184,51314,116498,1988-02-01T00:00:00
MELBOURNE,1988,3,61095,62449,123544,1988-03-01T00:00:00
MELBOURNE,1988,4,56795,61228,118023,1988-04-01T00:00:00
MELBOURNE,1988,5,49634,59349,108983,1988-05-01T00:00:00
MELBOURNE,1988,6,54308,63028,117336,1988-06-01T00:00:00
MELBOURNE,1988,7,69920,58282,128202,1988-07-01T00:00:00
MELBOURNE,1988,8,65090,62654,127744,1988-08-01T00:00:00
MELBOURNE,1988,9,75760,66770,142530,1988-09-01T00:00:00
MELBOURNE,1988,10,80770,57069,137839,1988-10-01T00:00:00
MELBOURNE,1988,11,70825,58249,129074,1988-11-01T00:00:00
MELBOURNE,1988,12,70046,75784,145830,1988-12-01T00:00:00
MELBOURNE,1989,1,87469,70355,157824,1989-01-01T00:00:00
MELBOURNE,1989,2,70831,55002,125833,1989-02-01T00:00:00
MELBOURNE,1989,3,62541,71289,133830,1989-03-01T00:00:00
MELBOURNE,1989,4,59039,64928,123967,1989-04-01T00:00:00
MELBOURNE,1989,5,48827,58595,107422,1989-05-01T00:00:00
MELBOURNE,1989,6,56786,68862,125648,1989-06-01T00:00:00
MELBOURNE,1989,7,74194,64672,138866,1989-07-01T00:00:00
MELBOURNE,1989,8,66257,66067,132324,1989-08-01T00:00:00
MELBOURNE,1989,9,75949,71811,147760,1989-09-01T00:00:00
MELBOURNE,1989,10,87884,58433,146317,1989-10-01T00:00:00
MELBOURNE,1989,11,72398,61775,134173,1989-11-01T00:00:00
MELBOURNE,1989,12,70414,84904,155318,1989-12-01T00:00:00
MELBOURNE,1990,1,90472,72160,162632,1990-01-01T00:00:00
MELBOURNE,1990,2,75666,57293,132959,1990-02-01T00:00:00
MELBOURNE,1990,3,65664,70273,135937,1990-03-01T00:00:00
MELBOURNE,1990,4,65140,78832,143972,1990-04-01T00:00:00
MELBOURNE,1990,5,55647,68433,124080,1990-05-01T00:00:00
MELBOURNE,1990,6,59966,70358,130324,1990-06-01T00:00:00
MELBOURNE,1990,7,78753,77210,155963,1990-07-01T00:00:00
MELBOURNE,1990,8,72685,70668,143353,1990-08-01T00:00:00
MELBOURNE,1990,9,77182,71180,148362,1990-09-01T00:00:00
MELBOURNE,1990,10,93671,56184,149855,1990-10-01T00:00:00
MELBOURNE,1990,11,69989,63915,133904,1990-11-01T00:00:00
MELBOURNE,1990,12,70887,84963,155850,1990-12-01T00:00:00
MELBOURNE,1991,1,89025,68545,157570,1991-01-01T00:00:00
MELBOURNE,1991,2,70101,57118,127219,1991-02-01T00:00:00
MELBOURNE,1991,3,63964,68351,132315,1991-03-01T00:00:00
MELBOURNE,1991,4,57912,67020,124932,1991-04-01T00:00:00
MELBOURNE,1991,5,55471,66984,122455,1991-05-01T00:00:00
MELBOURNE,1991,6,57792,67725,125517,1991-06-01T00:00:00
MELBOURNE,1991,7,79325,75800,155125,1991-07-01T00:00:00
MELBOURNE,1991,8,73368,68621,141989,1991-08-01T00:00:00
MELBOURNE,1991,9,74725,73459,148184,1991-09-01T00:00:00
MELBOURNE,1991,10,93847,65872,159719,1991-10-01T00:00:00
MELBOURNE,1991,11,76872,75004,151876,1991-11-01T00:00:00
MELBOURNE,1991,12,71806,85159,156965,1991-12-01T00:00:00
MELBOURNE,1992,1,89736,71659,161395,1992-01-01T00:00:00
MELBOURNE,1992,2,78510,63849,142359,1992-02-01T00:00:00
MELBOURNE,1992,3,64662,74641,139303,1992-03-01T00:00:00
MELBOURNE,1992,4,64692,75470,140162,1992-04-01T00:00:00
MELBOURNE,1992,5,58989,69821,128810,1992-05-01T00:00:00
MELBOURNE,1992,6,59390,68350,127740,1992-06-01T00:00:00
MELBOURNE,1992,7,74547,70113,144660,1992-07-01T00:00:00
MELBOURNE,1992,8,68404,67192,135596,1992-08-01T00:00:00
MELBOURNE,1992,9,77392,73389,150781,1992-09-01T00:00:00
MELBOURNE,1992,10,88507,63144,151651,1992-10-01T00:00:00
MELBOURNE,1992,11,72672,72656,145328,1992-11-01T00:00:00
MELBOURNE,1992,12,75747,94424,170171,1992-12-01T00:00:00
MELBOURNE,1993,1,98504,76605,175109,1993-01-01T00:00:00
MELBOURNE,1993,2,79557,63380,142937,1993-02-01T00:00:00
MELBOURNE,1993,3,69987,76538,146525,1993-03-01T00:00:00
MELBOURNE,1993,4,69740,78228,147968,1993-04-01T00:00:00
MELBOURNE,1993,5,65965,78681,144646,1993-05-01T00:00:00
MELBOURNE,1993,6,60292,73036,133328,1993-06-01T00:00:00
MELBOURNE,1993,7,84257,75700,159957,1993-07-01T00:00:00
MELBOURNE,1993,8,70787,69189,139976,1993-08-01T00:00:00
MELBOURNE,1993,9,78905,82131,161036,1993-09-01T00:00:00
MELBOURNE,1993,10,93580,70868,164448,1993-10-01T00:00:00
MELBOURNE,1993,11,77864,81592,159456,1993-11-01T00:00:00
MELBOURNE,1993,12,80723,91768,172491,1993-12-01T00:00:00
MELBOURNE,1994,1,98571,78535,177106,1994-01-01T00:00:00
MELBOURNE,1994,2,81738,69912,151650,1994-02-01T00:00:00
MELBOURNE,1994,3,79814,83879,163693,1994-03-01T00:00:00
MELBOURNE,1994,4,73495,79473,152968,1994-04-01T00:00:00
MELBOURNE,1994,5,58306,70387,128693,1994-05-01T00:00:00
MELBOURNE,1994,6,65435,74695,140130,1994-06-01T00:00:00
MELBOURNE,1994,7,86147,78555,164702,1994-07-01T00:00:00
MELBOURNE,1994,8,70482,69829,140311,1994-08-01T00:00:00
MELBOURNE,1994,9,81325,77858,159183,1994-09-01T00:00:00
MELBOURNE,1994,10,92148,69632,161780,1994-10-01T00:00:00
MELBOURNE,1994,11,76058,74705,150763,1994-11-01T00:00:00
MELBOURNE,1994,12,83669,96860,180529,1994-12-01T00:00:00
MELBOURNE,1995,1,100753,84363,185116,1995-01-01T00:00:00
MELBOURNE,1995,2,89076,71597,160673,1995-02-01T00:00:00
MELBOURNE,1995,3,79406,86624,166030,1995-03-01T00:00:00
MELBOURNE,1995,4,80703,90710,171413,1995-04-01T00:00:00
MELBOURNE,1995,5,64658,78944,143602,1995-05-01T00:00:00
MELBOURNE,1995,6,68130,79019,147149,1995-06-01T00:00:00
MELBOURNE,1995,7,94775,86375,181150,1995-07-01T00:00:00
MELBOURNE,1995,8,76367,75661,152028,1995-08-01T00:00:00
MELBOURNE,1995,9,83638,84493,168131,1995-09-01T00:00:00
MELBOURNE,1995,10,97997,74702,172699,1995-10-01T00:00:00
MELBOURNE,1995,11,86126,85560,171686,1995-11-01T00:00:00
MELBOURNE,1995,12,87368,104109,191477,1995-12-01T00:00:00
MELBOURNE,1996,1,108197,90293,198490,1996-01-01T00:00:00
MELBOURNE,1996,2,98599,80253,178852,1996-02-01T00:00:00
MELBOURNE,1996,3,87813,95860,183673,1996-03-01T00:00:00
MELBOURNE,1996,4,84040,92566,176606,1996-04-01T00:00:00
MELBOURNE,1996,5,69503,81521,151024,1996-05-01T00:00:00
MELBOURNE,1996,6,77280,90626,167906,1996-06-01T00:00:00
MELBOURNE,1996,7,96758,89717,186475,1996-07-01T00:00:00
MELBOURNE,1996,8,82905,83209,166114,1996-08-01T00:00:00
MELBOURNE,1996,9,95541,93994,189535,1996-09-01T00:00:00
MELBOURNE,1996,10,109375,82925,192300,1996-10-01T00:00:00
MELBOURNE,1996,11,96223,94909,191132,1996-11-01T00:00:00
MELBOURNE,1996,12,97452,113750,211202,1996-12-01T00:00:00
MELBOURNE,1997,1,116651,101626,218277,1997-01-01T00:00:00
MELBOURNE,1997,2,103647,87652,191299,1997-02-01T00:00:00
MELBOURNE,1997,3,96275,106030,202305,1997-03-01T00:00:00
MELBOURNE,1997,4,86028,99197,185225,1997-04-01T00:00:00
MELBOURNE,1997,5,75808,92620,168428,1997-05-01T00:00:00
MELBOURNE,1997,6,82678,102864,185542,1997-06-01T00:00:00
MELBOURNE,1997,7,119075,101440,220515,1997-07-01T00:00:00
MELBOURNE,1997,8,89720,92333,182053,1997-08-01T00:00:00
MELBOURNE,1997,9,100665,97582,198247,1997-09-01T00:00:00
MELBOURNE,1997,10,114239,89556,203795,1997-10-01T00:00:00
MELBOURNE,1997,11,102028,98410,200438,1997-11-01T00:00:00
MELBOURNE,1997,12,101490,115521,217011,1997-12-01T00:00:00
MELBOURNE,1998,1,121117,103614,224731,1998-01-01T00:00:00
MELBOURNE,1998,2,105516,85925,191441,1998-02-01T00:00:00
MELBOURNE,1998,3,95787,102633,198420,1998-03-01T00:00:00
MELBOURNE,1998,4,94513,102869,197382,1998-04-01T00:00:00
MELBOURNE,1998,5,83776,98646,182422,1998-05-01T00:00:00
MELBOURNE,1998,6,89343,102028,191371,1998-06-01T00:00:00
MELBOURNE,1998,7,117443,101011,218454,1998-07-01T00:00:00
MELBOURNE,1998,8,94701,99351,194052,1998-08-01T00:00:00
MELBOURNE,1998,9,106918,103303,210221,1998-09-01T00:00:00
MELBOURNE,1998,10,126780,104283,231063,1998-10-01T00:00:00
MELBOURNE,1998,11,110336,108228,218564,1998-11-01T00:00:00
MELBOURNE,1998,12,114133,116878,231011,1998-12-01T00:00:00
MELBOURNE,1999,1,127491,115103,242594,1999-01-01T00:00:00
MELBOURNE,1999,2,110356,92370,202726,1999-02-01T00:00:00
MELBOURNE,1999,3,109040,115120,224160,1999-03-01T00:00:00
MELBOURNE,1999,4,98771,107011,205782,1999-04-01T00:00:00
MELBOURNE,1999,5,90036,98909,188945,1999-05-01T00:00:00
MELBOURNE,1999,6,90952,108773,199725,1999-06-01T00:00:00
MELBOURNE,1999,7,122390,101681,224071,1999-07-01T00:00:00
MELBOURNE,1999,8,104990,112123,217113,1999-08-01T00:00:00
MELBOURNE,1999,9,116797,111411,228208,1999-09-01T00:00:00
MELBOURNE,1999,10,131764,109882,241646,1999-10-01T00:00:00
MELBOURNE,1999,11,119424,119592,239016,1999-11-01T00:00:00
MELBOURNE,1999,12,113547,127274,240821,1999-12-01T00:00:00
MELBOURNE,2000,1,138776,126770,265546,2000-01-01T00:00:00
MELBOURNE,2000,2,126905,106335,233240,2000-02-01T00:00:00
MELBOURNE,2000,3,117411,127177,244588,2000-03-01T00:00:00
MELBOURNE,2000,4,121332,131042,252374,2000-04-01T00:00:00
MELBOURNE,2000,5,98769,119675,218444,2000-05-01T00:00:00
MELBOURNE,2000,6,102972,124957,227929,2000-06-01T00:00:00
MELBOURNE,2000,7,137987,118308,256295,2000-07-01T00:00:00
MELBOURNE,2000,8,117696,121887,239583,2000-08-01T00:00:00
MELBOURNE,2000,9,126498,126054,252552,2000-09-01T00:00:00
MELBOURNE,2000,10,145846,121279,267125,2000-10-01T00:00:00
MELBOURNE,2000,11,137152,136928,274080,2000-11-01T00:00:00
MELBOURNE,2000,12,147547,164326,311873,2000-12-01T00:00:00
MELBOURNE,2001,1,169109,152493,321602,2001-01-01T00:00:00
MELBOURNE,2001,2,145578,118058,263636,2001-02-01T00:00:00
MELBOURNE,2001,3,135343,146093,281436,2001-03-01T00:00:00
MELBOURNE,2001,4,137170,145603,282773,2001-04-01T00:00:00
MELBOURNE,2001,5,109605,131744,241349,2001-05-01T00:00:00
MELBOURNE,2001,6,120697,139429,260126,2001-06-01T00:00:00
MELBOURNE,2001,7,160488,135724,296212,2001-07-01T00:00:00
MELBOURNE,2001,8,125942,135805,261747,2001-08-01T00:00:00
MELBOURNE,2001,9,137268,134285,271553,2001-09-01T00:00:00
MELBOURNE,2001,10,149864,117967,267831,2001-10-01T00:00:00
MELBOURNE,2001,11,128589,127943,256532,2001-11-01T00:00:00
MELBOURNE,2001,12,148224,162551,310775,2001-12-01T00:00:00
MELBOURNE,2002,1,168339,154245,322584,2002-01-01T00:00:00
MELBOURNE,2002,2,149598,124476,274074,2002-02-01T00:00:00
MELBOURNE,2002,3,152356,156881,309237,2002-03-01T00:00:00
MELBOURNE,2002,4,123765,129504,253269,2002-04-01T00:00:00
MELBOURNE,2002,5,107018,125821,232839,2002-05-01T00:00:00
MELBOURNE,2002,6,113347,133486,246833,2002-06-01T00:00:00
MELBOURNE,2002,7,154111,130785,284896,2002-07-01T00:00:00
MELBOURNE,2002,8,128752,128883,257635,2002-08-01T00:00:00
MELBOURNE,2002,9,136250,134719,270969,2002-09-01T00:00:00
MELBOURNE,2002,10,158574,122869,281443,2002-10-01T00:00:00
MELBOURNE,2002,11,138174,132791,270965,2002-11-01T00:00:00
MELBOURNE,2002,12,147524,161483,309007,2002-12-01T00:00:00
MELBOURNE,2003,1,166711,148063,314774,2003-01-01T00:00:00
MELBOURNE,2003,2,147228,114253,261481,2003-02-01T00:00:00
MELBOURNE,2003,3,133746,129527,263273,2003-03-01T00:00:00
MELBOURNE,2003,4,107381,109427,216808,2003-04-01T00:00:00
MELBOURNE,2003,5,89779,100828,190607,2003-05-01T00:00:00
MELBOURNE,2003,6,98707,115855,214562,2003-06-01T00:00:00
MELBOURNE,2003,7,139891,122158,262049,2003-07-01T00:00:00
MELBOURNE,2003,8,123460,130276,253736,2003-08-01T00:00:00
MELBOURNE,2003,9,138353,137802,276155,2003-09-01T00:00:00
MELBOURNE,2003,10,162441,132267,294708,2003-10-01T00:00:00
MELBOURNE,2003,11,150928,155924,306852,2003-11-01T00:00:00
MELBOURNE,2003,12,162028,182501,344529,2003-12-01T00:00:00
MELBOURNE,2004,1,189024,168144,357168,2004-01-01T00:00:00
MELBOURNE,2004,2,168702,132445,301147,2004-02-01T00:00:00
MELBOURNE,2004,3,154264,159916,314180,2004-03-01T00:00:00
MELBOURNE,2004,4,154450,159451,313901,2004-04-01T00:00:00
MELBOURNE,2004,5,128728,148120,276848,2004-05-01T00:00:00
MELBOURNE,2004,6,136158,163641,299799,2004-06-01T00:00:00
MELBOURNE,2004,7,194163,152010,346173,2004-07-01T00:00:00
MELBOURNE,2004,8,148644,156785,305429,2004-08-01T00:00:00
MELBOURNE,2004,9,166366,162238,328604,2004-09-01T00:00:00
MELBOURNE,2004,10,194432,152197,346629,2004-10-01T00:00:00
MELBOURNE,2004,11,172338,175154,347492,2004-11-01T00:00:00
MELBOURNE,2004,12,185771,213294,399065,2004-12-01T00:00:00
MELBOURNE,2005,1,224188,189259,413447,2005-01-01T00:00:00
MELBOURNE,2005,2,189638,153315,342953,2005-02-01T00:00:00
MELBOURNE,2005,3,179860,180907,360767,2005-03-01T00:00:00
MELBOURNE,2005,4,165011,166036,331047,2005-04-01T00:00:00
MELBOURNE,2005,5,137456,161326,298782,2005-05-01T00:00:00
MELBOURNE,2005,6,147415,176352,323767,2005-06-01T00:00:00
MELBOURNE,2005,7,207364,164140,371504,2005-07-01T00:00:00
MELBOURNE,2005,8,162467,166456,328923,2005-08-01T00:00:00
MELBOURNE,2005,9,177772,169975,347747,2005-09-01T00:00:00
MELBOURNE,2005,10,202890,158173,361063,2005-10-01T00:00:00
MELBOURNE,2005,11,170855,178943,349798,2005-11-01T00:00:00
MELBOURNE,2005,12,185308,209529,394837,2005-12-01T00:00:00
MELBOURNE,2006,1,221854,188571,410425,2006-01-01T00:00:00
MELBOURNE,2006,2,190788,153505,344293,2006-02-01T00:00:00
MELBOURNE,2006,3,183635,176863,360498,2006-03-01T00:00:00
MELBOURNE,2006,4,161967,174747,336714,2006-04-01T00:00:00
MELBOURNE,2006,5,139726,163023,302749,2006-05-01T00:00:00
MELBOURNE,2006,6,157179,187538,344717,2006-06-01T00:00:00
MELBOURNE,2006,7,196492,157279,353771,2006-07-01T00:00:00
MELBOURNE,2006,8,163060,165438,328498,2006-08-01T00:00:00
MELBOURNE,2006,9,187117,180311,367428,2006-09-01T00:00:00
MELBOURNE,2006,10,198949,160761,359710,2006-10-01T00:00:00
MELBOURNE,2006,11,180335,182668,363003,2006-11-01T00:00:00
MELBOURNE,2006,12,200204,219280,419484,2006-12-01T00:00:00
MELBOURNE,2007,1,227278,202772,430050,2007-01-01T00:00:00
MELBOURNE,2007,2,196447,161820,358267,2007-02-01T00:00:00
MELBOURNE,2007,3,196256,193785,390041,2007-03-01T00:00:00
MELBOURNE,2007,4,178238,183063,361301,2007-04-01T00:00:00
MELBOURNE,2007,5,156746,175322,332068,2007-05-01T00:00:00
MELBOURNE,2007,6,168100,187830,355930,2007-06-01T00:00:00
MELBOURNE,2007,7,204486,180555,385041,2007-07-01T00:00:00
MELBOURNE,2007,8,182874,182956,365830,2007-08-01T00:00:00
MELBOURNE,2007,9,187800,191970,379770,2007-09-01T00:00:00
MELBOURNE,2007,10,217864,173005,390869,2007-10-01T00:00:00
MELBOURNE,2007,11,194774,195578,390352,2007-11-01T00:00:00
MELBOURNE,2007,12,197752,227813,425565,2007-12-01T00:00:00
MELBOURNE,2008,1,233816,199579,433395,2008-01-01T00:00:00
MELBOURNE,2008,2,204958,169355,374313,2008-02-01T00:00:00
MELBOURNE,2008,3,201409,205233,406642,2008-03-01T00:00:00
MELBOURNE,2008,4,191257,185830,377087,2008-04-01T00:00:00
MELBOURNE,2008,5,166679,188468,355147,2008-05-01T00:00:00
MELBOURNE,2008,6,178213,199813,378026,2008-06-01T00:00:00
MELBOURNE,2008,7,220372,184151,404523,2008-07-01T00:00:00
MELBOURNE,2008,8,186810,188092,374902,2008-08-01T00:00:00
MELBOURNE,2008,9,192424,189709,382133,2008-09-01T00:00:00
MELBOURNE,2008,10,222911,180151,403062,2008-10-01T00:00:00
MELBOURNE,2008,11,195450,199696,395146,2008-11-01T00:00:00
MELBOURNE,2008,12,205898,242270,448168,2008-12-01T00:00:00
MELBOURNE,2009,1,252477,212009,464486,2009-01-01T00:00:00
MELBOURNE,2009,2,210713,168227,378940,2009-02-01T00:00:00
MELBOURNE,2009,3,202276,196643,398919,2009-03-01T00:00:00
MELBOURNE,2009,4,204299,208083,412382,2009-04-01T00:00:00
MELBOURNE,2009,5,173774,197709,371483,2009-05-01T00:00:00
MELBOURNE,2009,6,178162,218630,396792,2009-06-01T00:00:00
MELBOURNE,2009,7,240001,197523,437524,2009-07-01T00:00:00
MELBOURNE,2009,8,203480,205689,409169,2009-08-01T00:00:00
MELBOURNE,2009,9,219950,222581,442531,2009-09-01T00:00:00
MELBOURNE,2009,10,249880,207089,456969,2009-10-01T00:00:00
MELBOURNE,2009,11,218576,228831,447407,2009-11-01T00:00:00
MELBOURNE,2009,12,234725,279025,513750,2009-12-01T00:00:00
MELBOURNE,2010,1,284826,243684,528510,2010-01-01T00:00:00
MELBOURNE,2010,2,243752,204449,448201,2010-02-01T00:00:00
MELBOURNE,2010,3,231673,239252,470925,2010-03-01T00:00:00
MELBOURNE,2010,4,220800,219940,440740,2010-04-01T00:00:00
MELBOURNE,2010,5,188710,221202,409912,2010-05-01T00:00:00
MELBOURNE,2010,6,208773,257409,466182,2010-06-01T00:00:00
MELBOURNE,2010,7,283636,231976,515612,2010-07-01T00:00:00
MELBOURNE,2010,8,231395,241959,473354,2010-08-01T00:00:00
MELBOURNE,2010,9,255664,259528,515192,2010-09-01T00:00:00
MELBOURNE,2010,10,286793,239495,526288,2010-10-01T00:00:00
MELBOURNE,2010,11,240786,250417,491203,2010-11-01T00:00:00
MELBOURNE,2010,12,265242,321150,586392,2010-12-01T00:00:00
MELBOURNE,2011,1,336970,290873,627843,2011-01-01T00:00:00
MELBOURNE,2011,2,274243,220878,495121,2011-02-01T00:00:00
MELBOURNE,2011,3,243754,237994,481748,2011-03-01T00:00:00
MELBOURNE,2011,4,250130,274680,524810,2011-04-01T00:00:00
MELBOURNE,2011,5,230962,247707,478669,2011-05-01T00:00:00
MELBOURNE,2011,6,223865,273382,497247,2011-06-01T00:00:00
MELBOURNE,2011,7,309728,262089,571817,2011-07-01T00:00:00
MELBOURNE,2011,8,259446,261977,521423,2011-08-01T00:00:00
MELBOURNE,2011,9,263756,282047,545803,2011-09-01T00:00:00
MELBOURNE,2011,10,306328,247114,553442,2011-10-01T00:00:00
MELBOURNE,2011,11,267990,269556,537546,2011-11-01T00:00:00
MELBOURNE,2011,12,281266,344223,625489,2011-12-01T00:00:00
MELBOURNE,2012,1,354018,306119,660137,2012-01-01T00:00:00
MELBOURNE,2012,2,291804,232419,524223,2012-02-01T00:00:00
MELBOURNE,2012,3,268269,279024,547293,2012-03-01T00:00:00
MELBOURNE,2012,4,266969,271006,537975,2012-04-01T00:00:00
MELBOURNE,2012,5,230069,259264,489333,2012-05-01T00:00:00
MELBOURNE,2012,6,248038,295361,543399,2012-06-01T00:00:00
MELBOURNE,2012,7,316164,261920,578084,2012-07-01T00:00:00
MELBOURNE,2012,8,271345,275906,547251,2012-08-01T00:00:00
MELBOURNE,2012,9,284472,291959,576431,2012-09-01T00:00:00
MELBOURNE,2012,10,323971,261191,585162,2012-10-01T00:00:00
MELBOURNE,2012,11,281637,289422,571059,2012-11-01T00:00:00
MELBOURNE,2012,12,302814,356081,658895,2012-12-01T00:00:00
MELBOURNE,2013,1,363773,309819,673592,2013-01-01T00:00:00
MELBOURNE,2013,2,290165,245270,535435,2013-02-01T00:00:00
MELBOURNE,2013,3,284291,298294,582585,2013-03-01T00:00:00
MELBOURNE,2013,4,284224,278932,563156,2013-04-01T00:00:00
MELBOURNE,2013,5,247987,284390,532377,2013-05-01T00:00:00
MELBOURNE,2013,6,266815,316664,583479,2013-06-01T00:00:00
MELBOURNE,2013,7,350003,299718,649721,2013-07-01T00:00:00
MELBOURNE,2013,8,309206,314962,624168,2013-08-01T00:00:00
MELBOURNE,2013,9,308437,314280,622717,2013-09-01T00:00:00
MELBOURNE,2013,10,347223,277637,624860,2013-10-01T00:00:00
MELBOURNE,2013,11,297331,296101,593432,2013-11-01T00:00:00
MELBOURNE,2013,12,334315,392306,726621,2013-12-01T00:00:00
MELBOURNE,2014,1,405925,345753,751678,2014-01-01T00:00:00
MELBOURNE,2014,2,317446,271754,589200,2014-02-01T00:00:00
MELBOURNE,2014,3,298547,301050,599597,2014-03-01T00:00:00
MELBOURNE,2014,4,314516,330983,645499,2014-04-01T00:00:00
MELBOURNE,2014,5,288008,311686,599694,2014-05-01T00:00:00
MELBOURNE,2014,6,283842,355095,638937,2014-06-01T00:00:00
MELBOURNE,2014,7,396854,328613,725467,2014-07-01T00:00:00
MELBOURNE,2014,8,323724,340678,664402,2014-08-01T00:00:00
MELBOURNE,2014,9,337512,339350,676862,2014-09-01T00:00:00
MELBOURNE,2014,10,381908,312662,694570,2014-10-01T00:00:00
MELBOURNE,2014,11,328293,335780,664073,2014-11-01T00:00:00
MELBOURNE,2014,12,355406,417081,772487,2014-12-01T00:00:00
MELBOURNE,2015,1,438126,370081,808207,2015-01-01T00:00:00
MELBOURNE,2015,2,365109,313219,678328,2015-02-01T00:00:00
MELBOURNE,2015,3,345323,371197,716520,2015-03-01T00:00:00
MELBOURNE,2015,4,340239,344512,684751,2015-04-01T00:00:00
MELBOURNE,2015,5,302738,334198,636936,2015-05-01T00:00:00
MELBOURNE,2015,6,308765,379573,688338,2015-06-01T00:00:00
MELBOURNE,2015,7,420433,358670,779103,2015-07-01T00:00:00
MELBOURNE,2015,8,363372,369533,732905,2015-08-01T00:00:00
MELBOURNE,2015,9,373604,370822,744426,2015-09-01T00:00:00
MELBOURNE,2015,10,422440,352894,775334,2015-10-01T00:00:00
MELBOURNE,2015,11,369057,367768,736825,2015-11-01T00:00:00
MELBOURNE,2015,12,408817,468826,877643,2015-12-01T00:00:00
MELBOURNE,2016,1,479446,415848,895294,2016-01-01T00:00:00
MELBOURNE,2016,2,409332,354902,764234,2016-02-01T00:00:00
MELBOURNE,2016,3,375712,400070,775782,2016-03-01T00:00:00
MELBOURNE,2016,4,377543,363931,741474,2016-04-01T00:00:00
MELBOURNE,2016,5,329015,361483,690498,2016-05-01T00:00:00
MELBOURNE,2016,6,344024,421392,765416,2016-06-01T00:00:00
MELBOURNE,2016,7,473996,402026,876022,2016-07-01T00:00:00
MELBOURNE,2016,8,387190,393644,780834,2016-08-01T00:00:00
MELBOURNE,2016,9,407615,395718,803333,2016-09-01T00:00:00
MELBOURNE,2016,10,439964,373475,813439,2016-10-01T00:00:00
MELBOURNE,2016,11,386213,394006,780219,2016-11-01T00:00:00
MELBOURNE,2016,12,444950,511091,956041,2016-12-01T00:00:00
MELBOURNE,2017,1,523394,456706,980100,2017-01-01T00:00:00
MELBOURNE,2017,2,424162,354176,778338,2017-02-01T00:00:00
MELBOURNE,2017,3,388096,397069,785165,2017-03-01T00:00:00
MELBOURNE,2017,4,421407,426800,848207,2017-04-01T00:00:00
MELBOURNE,2017,5,355754,384545,740299,2017-05-01T00:00:00
MELBOURNE,2017,6,368104,439357,807461,2017-06-01T00:00:00
MELBOURNE,2017,7,498958,427923,926881,2017-07-01T00:00:00
MELBOURNE,2017,8,417818,422697,840515,2017-08-01T00:00:00
MELBOURNE,2017,9,428355,438578,866933,2017-09-01T00:00:00
MELBOURNE,2017,10,486720,396510,883230,2017-10-01T00:00:00
MELBOURNE,2017,11,419680,431707,851387,2017-11-01T00:00:00
MELBOURNE,2017,12,478099,537167,1015266,2017-12-01T00:00:00
MELBOURNE,2018,1,547626,473098,1020724,2018-01-01T00:00:00
MELBOURNE,2018,2,469329,401858,871187,2018-02-01T00:00:00
MELBOURNE,2018,3,445563,464345,909908,2018-03-01T00:00:00
MELBOURNE,2018,4,453020,441242,894262,2018-04-01T00:00:00
MELBOURNE,2018,5,387395,413425,800820,2018-05-01T00:00:00
MELBOURNE,2018,6,410590,492367,902957,2018-06-01T00:00:00
MELBOURNE,2018,7,538582,455634,994216,2018-07-01T00:00:00
MELBOURNE,2018,8,464566,473550,938116,2018-08-01T00:00:00
MELBOURNE,2018,9,471762,479739,951501,2018-09-01T00:00:00
MELBOURNE,2018,10,523788,436520,960308,2018-10-01T00:00:00
MELBOURNE,2018,11,461965,473126,935091,2018-11-01T00:00:00
MELBOURNE,2018,12,481836,562958,1044794,2018-12-01T00:00:00
MELBOURNE,2019,1,568799,501288,1070087,2019-01-01T00:00:00
MELBOURNE,2019,2,483548,405796,889344,2019-02-01T00:00:00
MELBOURNE,2019,3,441993,443824,885817,2019-03-01T00:00:00
MELBOURNE,2019,4,454777,480480,935257,2019-04-01T00:00:00
MELBOURNE,2019,5,414406,429113,843519,2019-05-01T00:00:00
MELBOURNE,2019,6,413493,488023,901516,2019-06-01T00:00:00
MELBOURNE,2019,7,532482,460719,993201,2019-07-01T00:00:00
MELBOURNE,2019,8,469163,473554,942717,2019-08-01T00:00:00
MELBOURNE,2019,9,459116,468307,927423,2019-09-01T00:00:00
MELBOURNE,2019,10,504030,427549,931579,2019-10-01T00:00:00
MELBOURNE,2019,11,460493,466560,927053,2019-11-01T00:00:00
MELBOURNE,2019,12,495779,575352,1071131,2019-12-01T00:00:00
MELBOURNE,2020,1,581276,514803,1096079,2020-01-01T00:00:00
MELBOURNE,2020,2,408642,334254,742896,2020-02-01T00:00:00
MELBOURNE,2020,3,244268,227490,471758,2020-03-01T00:00:00
MELBOURNE,2020,4,5448,12355,17803,2020-04-01T00:00:00
MELBOURNE,2020,5,5643,9003,14646,2020-05-01T00:00:00
MELBOURNE,2020,6,6431,9456,15887,2020-06-01T00:00:00
MELBOURNE,2020,7,49,12705,12754,2020-07-01T00:00:00
MELBOURNE,2020,8,0,14761,14761,2020-08-01T00:00:00
MELBOURNE,2020,9,0,12320,12320,2020-09-01T00:00:00
MELBOURNE,2020,10,0,10603,10603,2020-10-01T00:00:00
MELBOURNE,2020,11,511,8346,8857,2020-11-01T00:00:00
MELBOURNE,2020,12,5098,10989,16087,2020-12-01T00:00:00
MELBOURNE,2021,1,6753,10340,17093,2021-01-01T00:00:00
MELBOURNE,2021,2,3119,8122,11241,2021-02-01T00:00:00
MELBOURNE,2021,3,1798,8153,9951,2021-03-01T00:00:00
MELBOURNE,2021,4,10375,16770,27145,2021-04-01T00:00:00
MELBOURNE,2021,5,25732,24656,50388,2021-05-01T00:00:00
MELBOURNE,2021,6,10613,14502,25115,2021-06-01T00:00:00
MELBOURNE,2021,7,22227,26795,49022,2021-07-01T00:00:00
MELBOURNE,2021,8,3681,8033,11714,2021-08-01T00:00:00
MELBOURNE,2021,9,2201,7918,10119,2021-09-01T00:00:00
MELBOURNE,2021,10,2111,9855,11966,2021-10-01T00:00:00
MELBOURNE,2021,11,19788,25339,45127,2021-11-01T00:00:00
MELBOURNE,2021,12,64060,63649,127709,2021-12-01T00:00:00
MELBOURNE,2022,1,84811,58865,143676,2022-01-01T00:00:00
MELBOURNE,2022,2,89738,54225,143963,2022-02-01T00:00:00
MELBOURNE,2022,3,107926,95493,203419,2022-03-01T00:00:00
MELBOURNE,2022,4,157741,163915,321656,2022-04-01T00:00:00
MELBOURNE,2022,5,182478,180486,362964,2022-05-01T00:00:00
MELBOURNE,2022,6,211256,253957,465213,2022-06-01T00:00:00
MELBOURNE,2022,7,318139,273435,591574,2022-07-01T00:00:00
MELBOURNE,2022,8,289587,260606,550193,2022-08-01T00:00:00
MELBOURNE,2022,9,300395,284303,584698,2022-09-01T00:00:00
MELBOURNE,2022,10,335167,273556,608723,2022-10-01T00:00:00
MELBOURNE,2022,11,333340,322667,656007,2022-11-01T00:00:00
MELBOURNE,2022,12,353353,422088,775441,2022-12-01T00:00:00
MELBOURNE,2023,1,445135,385246,830381,2023-01-01T00:00:00
MELBOURNE,2023,2,381441,282806,664247,2023-02-01T00:00:00
MELBOURNE,2023,3,370815,352659,723474,2023-03-01T00:00:00
MELBOURNE,2023,4,380077,397622,777699,2023-04-01T00:00:00
MELBOURNE,2023,5,356854,382672,739526,2023-05-01T00:00:00
MELBOURNE,2023,6,376556,443993,820549,2023-06-01T00:00:00
MELBOURNE,2023,7,499513,416165,915678,2023-07-01T00:00:00
MELBOURNE,2023,8,430491,418894,849385,2023-08-01T00:00:00
MELBOURNE,2023,9,453183,438763,891946,2023-09-01T00:00:00
MELBOURNE,2023,10,481237,403512,884749,2023-10-01T00:00:00
MELBOURNE,2023,11,434191,441269,875460,2023-11-01T00:00:00
MELBOURNE,2023,12,471322,557543,1028865,2023-12-01T00:00:00
MELBOURNE,2024,1,596727,486240,1082967,2024-01-01T00:00:00
MELBOURNE,2024,2,505353,406356,911709,2024-02-01T00:00:00
MELBOURNE,2024,3,443524,468982,912506,2024-03-01T00:00:00
MELBOURNE,2024,4,447712,432555,880267,2024-04-01T00:00:00
MELBOURNE,2024,5,393502,425979,819481,2024-05-01T00:00:00
MELBOURNE,2024,6,422064,497667,919731,2024-06-01T00:00:00
MELBOURNE,2024,7,541813,454904,996717,2024-07-01T00:00:00
MELBOURNE,2024,8,457352,464979,922331,2024-08-01T00:00:00
MELBOURNE,2024,9,478422,498163,976585,2024-09-01T00:00:00
MELBOURNE,2024,10,529782,440179,969961,2024-10-01T00:00:00
MELBOURNE,2024,11,465419,484580,949999,2024-11-01T00:00:00
MELBOURNE,2024,12,517804,635978,1153782,2024-12-01T00:00:00
MELBOURNE,2025,1,677817,575267,1253084,2025-01-01T00:00:00
MELBOURNE,2025,2,528877,409925,938802,2025-02-01T00:00:00
MELBOURNE,2025,3,468957,462316,931273,2025-03-01T00:00:00
MELBOURNE,2025,4,493707,528917,1022624,2025-04-01T00:00:00
MELBOURNE,2025,5,449863,460578,910441,2025-05-01T00:00:00
MELBOURNE,2025,6,438513,499735,938248,2025-06-01T00:00:00
NEWCASTLE,1985,1,0,0,0,1985-01-01T00:00:00
NEWCASTLE,1985,2,0,0,0,1985-02-01T00:00:00
NEWCASTLE,1985,3,0,0,0,1985-03-01T00:00:00
NEWCASTLE,1985,4,0,0,0,1985-04-01T00:00:00
NEWCASTLE,1985,5,0,0,0,1985-05-01T00:00:00
NEWCASTLE,1985,6,0,0,0,1985-06-01T00:00:00
NEWCASTLE,1985,7,0,0,0,1985-07-01T00:00:00
NEWCASTLE,1985,8,0,0,0,1985-08-01T00:00:00
NEWCASTLE,1985,9,0,0,0,1985-09-01T00:00:00
NEWCASTLE,1985,10,0,0,0,1985-10-01T00:00:00
NEWCASTLE,1985,11,0,0,0,1985-11-01T00:00:00
NEWCASTLE,1985,12,0,0,0,1985-12-01T00:00:00
NEWCASTLE,1986,1,0,0,0,1986-01-01T00:00:00
NEWCASTLE,1986,2,0,0,0,1986-02-01T00:00:00
NEWCASTLE,1986,3,0,0,0,1986-03-01T00:00:00
NEWCASTLE,1986,4,0,0,0,1986-04-01T00:00:00
NEWCASTLE,1986,5,0,0,0,1986-05-01T00:00:00
NEWCASTLE,1986,6,0,0,0,1986-06-01T00:00:00
NEWCASTLE,1986,7,0,0,0,1986-07-01T00:00:00
NEWCASTLE,1986,8,0,0,0,1986-08-01T00:00:00
NEWCASTLE,1986,9,0,0,0,1986-09-01T00:00:00
NEWCASTLE,1986,10,0,0,0,1986-10-01T00:00:00
NEWCASTLE,1986,11,0,0,0,1986-11-01T00:00:00
NEWCASTLE,1986,12,0,0,0,1986-12-01T00:00:00
NEWCASTLE,1987,1,0,0,0,1987-01-01T00:00:00
NEWCASTLE,1987,2,0,0,0,1987-02-01T00:00:00
NEWCASTLE,1987,3,0,0,0,1987-03-01T00:00:00
NEWCASTLE,1987,4,0,0,0,1987-04-01T00:00:00
NEWCASTLE,1987,5,0,0,0,1987-05-01T00:00:00
NEWCASTLE,1987,6,0,0,0,1987-06-01T00:00:00
NEWCASTLE,1987,7,0,0,0,1987-07-01T00:00:00
NEWCASTLE,1987,8,0,0,0,1987-08-01T00:00:00
NEWCASTLE,1987,9,0,0,0,1987-09-01T00:00:00
NEWCASTLE,1987,10,0,0,0,1987-10-01T00:00:00
NEWCASTLE,1987,11,0,0,0,1987-11-01T00:00:00
NEWCASTLE,1987,12,0,0,0,1987-12-01T00:00:00
NEWCASTLE,1988,1,0,0,0,1988-01-01T00:00:00
NEWCASTLE,1988,2,0,0,0,1988-02-01T00:00:00
NEWCASTLE,1988,3,0,0,0,1988-03-01T00:00:00
NEWCASTLE,1988,4,0,0,0,1988-04-01T00:00:00
NEWCASTLE,1988,5,0,0,0,1988-05-01T00:00:00
NEWCASTLE,1988,6,0,0,0,1988-06-01T00:00:00
NEWCASTLE,1988,7,0,0,0,1988-07-01T00:00:00
NEWCASTLE,1988,8,0,0,0,1988-08-01T00:00:00
NEWCASTLE,1988,9,0,0,0,1988-09-01T00:00:00
NEWCASTLE,1988,10,0,0,0,1988-10-01T00:00:00
NEWCASTLE,1988,11,0,0,0,1988-11-01T00:00:00
NEWCASTLE,1988,12,0,0,0,1988-12-01T00:00:00
NEWCASTLE,1989,1,0,0,0,1989-01-01T00:00:00
NEWCASTLE,1989,2,0,0,0,1989-02-01T00:00:00
NEWCASTLE,1989,3,0,0,0,1989-03-01T00:00:00
NEWCASTLE,1989,4,0,0,0,1989-04-01T00:00:00
NEWCASTLE,1989,5,0,0,0,1989-05-01T00:00:00
NEWCASTLE,1989,6,0,0,0,1989-06-01T00:00:00
NEWCASTLE,1989,7,0,0,0,1989-07-01T00:00:00
NEWCASTLE,1989,8,0,0,0,1989-08-01T00:00:00
NEWCASTLE,1989,9,0,0,0,1989-09-01T00:00:00
NEWCASTLE,1989,10,0,0,0,1989-10-01T00:00:00
NEWCASTLE,1989,11,0,0,0,1989-11-01T00:00:00
NEWCASTLE,1989,12,0,0,0,1989-12-01T00:00:00
NEWCASTLE,1990,1,0,0,0,1990-01-01T00:00:00
NEWCASTLE,1990,2,0,0,0,1990-02-01T00:00:00
NEWCASTLE,1990,3,0,0,0,1990-03-01T00:00:00
NEWCASTLE,1990,4,0,0,0,1990-04-01T00:00:00
NEWCASTLE,1990,5,0,0,0,1990-05-01T00:00:00
NEWCASTLE,1990,6,0,0,0,1990-06-01T00:00:00
NEWCASTLE,1990,7,0,0,0,1990-07-01T00:00:00
NEWCASTLE,1990,8,0,0,0,1990-08-01T00:00:00
NEWCASTLE,1990,9,0,0,0,1990-09-01T00:00:00
NEWCASTLE,1990,10,0,0,0,1990-10-01T00:00:00
NEWCASTLE,1990,11,0,0,0,1990-11-01T00:00:00
NEWCASTLE,1990,12,0,0,0,1990-12-01T00:00:00
NEWCASTLE,1991,1,0,0,0,1991-01-01T00:00:00
NEWCASTLE,1991,2,0,0,0,1991-02-01T00:00:00
NEWCASTLE,1991,3,0,0,0,1991-03-01T00:00:00
NEWCASTLE,1991,4,0,0,0,1991-04-01T00:00:00
NEWCASTLE,1991,5,0,0,0,1991-05-01T00:00:00
NEWCASTLE,1991,6,0,0,0,1991-06-01T00:00:00
NEWCASTLE,1991,7,0,0,0,1991-07-01T00:00:00
NEWCASTLE,1991,8,0,0,0,1991-08-01T00:00:00
NEWCASTLE,1991,9,0,0,0,1991-09-01T00:00:00
NEWCASTLE,1991,10,0,0,0,1991-10-01T00:00:00
NEWCASTLE,1991,11,0,0,0,1991-11-01T00:00:00
NEWCASTLE,1991,12,0,0,0,1991-12-01T00:00:00
NEWCASTLE,1992,1,0,0,0,1992-01-01T00:00:00
NEWCASTLE,1992,2,0,0,0,1992-02-01T00:00:00
NEWCASTLE,1992,3,0,0,0,1992-03-01T00:00:00
NEWCASTLE,1992,4,0,0,0,1992-04-01T00:00:00
NEWCASTLE,1992,5,0,0,0,1992-05-01T00:00:00
NEWCASTLE,1992,6,0,0,0,1992-06-01T00:00:00
NEWCASTLE,1992,7,0,0,0,1992-07-01T00:00:00
NEWCASTLE,1992,8,0,0,0,1992-08-01T00:00:00
NEWCASTLE,1992,9,0,0,0,1992-09-01T00:00:00
NEWCASTLE,1992,10,0,0,0,1992-10-01T00:00:00
NEWCASTLE,1992,11,0,0,0,1992-11-01T00:00:00
NEWCASTLE,1992,12,0,0,0,1992-12-01T00:00:00
NEWCASTLE,1993,1,0,0,0,1993-01-01T00:00:00
NEWCASTLE,1993,2,0,0,0,1993-02-01T00:00:00
NEWCASTLE,1993,3,0,0,0,1993-03-01T00:00:00
NEWCASTLE,1993,4,0,0,0,1993-04-01T00:00:00
NEWCASTLE,1993,5,0,0,0,1993-05-01T00:00:00
NEWCASTLE,1993,6,0,0,0,1993-06-01T00:00:00
NEWCASTLE,1993,7,0,0,0,1993-07-01T00:00:00
NEWCASTLE,1993,8,0,0,0,1993-08-01T00:00:00
NEWCASTLE,1993,9,0,0,0,1993-09-01T00:00:00
NEWCASTLE,1993,10,0,0,0,1993-10-01T00:00:00
NEWCASTLE,1993,11,0,0,0,1993-11-01T00:00:00
NEWCASTLE,1993,12,0,0,0,1993-12-01T00:00:00
NEWCASTLE,1994,1,0,0,0,1994-01-01T00:00:00
NEWCASTLE,1994,2,0,0,0,1994-02-01T00:00:00
NEWCASTLE,1994,3,0,0,0,1994-03-01T00:00:00
NEWCASTLE,1994,4,0,0,0,1994-04-01T00:00:00
NEWCASTLE,1994,5,0,0,0,1994-05-01T00:00:00
NEWCASTLE,1994,6,0,0,0,1994-06-01T00:00:00
NEWCASTLE,1994,7,0,0,0,1994-07-01T00:00:00
NEWCASTLE,1994,8,0,0,0,1994-08-01T00:00:00
NEWCASTLE,1994,9,0,0,0,1994-09-01T00:00:00
NEWCASTLE,1994,10,0,0,0,1994-10-01T00:00:00
NEWCASTLE,1994,11,0,0,0,1994-11-01T00:00:00
NEWCASTLE,1994,12,0,0,0,1994-12-01T00:00:00
NEWCASTLE,1995,1,0,0,0,1995-01-01T00:00:00
NEWCASTLE,1995,2,0,0,0,1995-02-01T00:00:00
NEWCASTLE,1995,3,0,0,0,1995-03-01T00:00:00
NEWCASTLE,1995,4,0,0,0,1995-04-01T00:00:00
NEWCASTLE,1995,5,0,0,0,1995-05-01T00:00:00
NEWCASTLE,1995,6,0,0,0,1995-06-01T00:00:00
NEWCASTLE,1995,7,0,0,0,1995-07-01T00:00:00
NEWCASTLE,1995,8,0,0,0,1995-08-01T00:00:00
NEWCASTLE,1995,9,0,0,0,1995-09-01T00:00:00
NEWCASTLE,1995,10,0,0,0,1995-10-01T00:00:00
NEWCASTLE,1995,11,0,0,0,1995-11-01T00:00:00
NEWCASTLE,1995,12,0,0,0,1995-12-01T00:00:00
NEWCASTLE,1996,1,0,0,0,1996-01-01T00:00:00
NEWCASTLE,1996,2,0,0,0,1996-02-01T00:00:00
NEWCASTLE,1996,3,0,0,0,1996-03-01T00:00:00
NEWCASTLE,1996,4,0,0,0,1996-04-01T00:00:00
NEWCASTLE,1996,5,0,0,0,1996-05-01T00:00:00
NEWCASTLE,1996,6,0,0,0,1996-06-01T00:00:00
NEWCASTLE,1996,7,0,0,0,1996-07-01T00:00:00
NEWCASTLE,1996,8,0,0,0,1996-08-01T00:00:00
NEWCASTLE,1996,9,0,0,0,1996-09-01T00:00:00
NEWCASTLE,1996,10,0,0,0,1996-10-01T00:00:00
NEWCASTLE,1996,11,0,0,0,1996-11-01T00:00:00
NEWCASTLE,1996,12,0,0,0,1996-12-01T00:00:00
NEWCASTLE,1997,1,0,0,0,1997-01-01T00:00:00
NEWCASTLE,1997,2,0,0,0,1997-02-01T00:00:00
NEWCASTLE,1997,3,0,0,0,1997-03-01T00:00:00
NEWCASTLE,1997,4,0,0,0,1997-04-01T00:00:00
NEWCASTLE,1997,5,0,0,0,1997-05-01T00:00:00
NEWCASTLE,1997,6,0,0,0,1997-06-01T00:00:00
NEWCASTLE,1997,7,0,0,0,1997-07-01T00:00:00
NEWCASTLE,1997,8,0,0,0,1997-08-01T00:00:00
NEWCASTLE,1997,9,0,0,0,1997-09-01T00:00:00
NEWCASTLE,1997,10,0,0,0,1997-10-01T00:00:00
NEWCASTLE,1997,11,0,0,0,1997-11-01T00:00:00
NEWCASTLE,1997,12,0,0,0,1997-12-01T00:00:00
NEWCASTLE,1998,1,0,0,0,1998-01-01T00:00:00
NEWCASTLE,1998,2,0,0,0,1998-02-01T00:00:00
NEWCASTLE,1998,3,0,0,0,1998-03-01T00:00:00
NEWCASTLE,1998,4,0,0,0,1998-04-01T00:00:00
NEWCASTLE,1998,5,0,0,0,1998-05-01T00:00:00
NEWCASTLE,1998,6,0,0,0,1998-06-01T00:00:00
NEWCASTLE,1998,7,0,0,0,1998-07-01T00:00:00
NEWCASTLE,1998,8,0,0,0,1998-08-01T00:00:00
NEWCASTLE,1998,9,0,0,0,1998-09-01T00:00:00
NEWCASTLE,1998,10,0,0,0,1998-10-01T00:00:00
NEWCASTLE,1998,11,0,0,0,1998-11-01T00:00:00
NEWCASTLE,1998,12,0,0,0,1998-12-01T00:00:00
NEWCASTLE,1999,1,0,0,0,1999-01-01T00:00:00
NEWCASTLE,1999,2,0,0,0,1999-02-01T00:00:00
NEWCASTLE,1999,3,0,0,0,1999-03-01T00:00:00
NEWCASTLE,1999,4,0,0,0,1999-04-01T00:00:00
NEWCASTLE,1999,5,0,0,0,1999-05-01T00:00:00
NEWCASTLE,1999,6,0,0,0,1999-06-01T00:00:00
NEWCASTLE,1999,7,0,0,0,1999-07-01T00:00:00
NEWCASTLE,1999,8,0,0,0,1999-08-01T00:00:00
NEWCASTLE,1999,9,0,0,0,1999-09-01T00:00:00
NEWCASTLE,1999,10,0,0,0,1999-10-01T00:00:00
NEWCASTLE,1999,11,0,0,0,1999-11-01T00:00:00
NEWCASTLE,1999,12,0,0,0,1999-12-01T00:00:00
NEWCASTLE,2000,1,0,0,0,2000-01-01T00:00:00
NEWCASTLE,2000,2,0,0,0,2000-02-01T00:00:00
NEWCASTLE,2000,3,0,0,0,2000-03-01T00:00:00
NEWCASTLE,2000,4,0,0,0,2000-04-01T00:00:00
NEWCASTLE,2000,5,0,0,0,2000-05-01T00:00:00
NEWCASTLE,2000,6,0,0,0,2000-06-01T00:00:00
NEWCASTLE,2000,7,0,0,0,2000-07-01T00:00:00
NEWCASTLE,2000,8,0,0,0,2000-08-01T00:00:00
NEWCASTLE,2000,9,0,0,0,2000-09-01T00:00:00
NEWCASTLE,2000,10,0,0,0,2000-10-01T00:00:00
NEWCASTLE,2000,11,0,0,0,2000-11-01T00:00:00
NEWCASTLE,2000,12,0,0,0,2000-12-01T00:00:00
NEWCASTLE,2001,1,0,0,0,2001-01-01T00:00:00
NEWCASTLE,2001,2,0,0,0,2001-02-01T00:00:00
NEWCASTLE,2001,3,0,0,0,2001-03-01T00:00:00
NEWCASTLE,2001,4,0,0,0,2001-04-01T00:00:00
NEWCASTLE,2001,5,0,0,0,2001-05-01T00:00:00
NEWCASTLE,2001,6,0,0,0,2001-06-01T00:00:00
NEWCASTLE,2001,7,0,0,0,2001-07-01T00:00:00
NEWCASTLE,2001,8,0,0,0,2001-08-01T00:00:00
NEWCASTLE,2001,9,0,0,0,2001-09-01T00:00:00
NEWCASTLE,2001,10,0,0,0,2001-10-01T00:00:00
NEWCASTLE,2001,11,0,0,0,2001-11-01T00:00:00
NEWCASTLE,2001,12,493,561,1054,2001-12-01T00:00:00
NEWCASTLE,2002,1,805,876,1681,2002-01-01T00:00:00
NEWCASTLE,2002,2,616,636,1252,2002-02-01T00:00:00
NEWCASTLE,2002,3,697,690,1387,2002-03-01T00:00:00
NEWCASTLE,2002,4,865,754,1619,2002-04-01T00:00:00
NEWCASTLE,2002,5,412,307,719,2002-05-01T00:00:00
NEWCASTLE,2002,6,415,358,773,2002-06-01T00:00:00
NEWCASTLE,2002,7,547,570,1117,2002-07-01T00:00:00
NEWCASTLE,2002,8,456,383,839,2002-08-01T00:00:00
NEWCASTLE,2002,9,63,57,120,2002-09-01T00:00:00
NEWCASTLE,2002,10,0,0,0,2002-10-01T00:00:00
NEWCASTLE,2002,11,0,0,0,2002-11-01T00:00:00
NEWCASTLE,2002,12,0,0,0,2002-12-01T00:00:00
NEWCASTLE,2003,1,0,0,0,2003-01-01T00:00:00
NEWCASTLE,2003,2,0,0,0,2003-02-01T00:00:00
NEWCASTLE,2003,3,0,0,0,2003-03-01T00:00:00
NEWCASTLE,2003,4,0,0,0,2003-04-01T00:00:00
NEWCASTLE,2003,5,0,0,0,2003-05-01T00:00:00
NEWCASTLE,2003,6,0,0,0,2003-06-01T00:00:00
NEWCASTLE,2003,7,0,0,0,2003-07-01T00:00:00
NEWCASTLE,2003,8,0,0,0,2003-08-01T00:00:00
NEWCASTLE,2003,9,0,0,0,2003-09-01T00:00:00
NEWCASTLE,2003,10,0,0,0,2003-10-01T00:00:00
NEWCASTLE,2003,11,0,0,0,2003-11-01T00:00:00
NEWCASTLE,2003,12,0,0,0,2003-12-01T00:00:00
NEWCASTLE,2004,1,0,0,0,2004-01-01T00:00:00
NEWCASTLE,2004,2,0,0,0,2004-02-01T00:00:00
NEWCASTLE,2004,3,0,0,0,2004-03-01T00:00:00
NEWCASTLE,2004,4,0,0,0,2004-04-01T00:00:00
NEWCASTLE,2004,5,0,0,0,2004-05-01T00:00:00
NEWCASTLE,2004,6,0,0,0,2004-06-01T00:00:00
NEWCASTLE,2004,7,0,0,0,2004-07-01T00:00:00
NEWCASTLE,2004,8,0,0,0,2004-08-01T00:00:00
NEWCASTLE,2004,9,0,0,0,2004-09-01T00:00:00
NEWCASTLE,2004,10,0,0,0,2004-10-01T00:00:00
NEWCASTLE,2004,11,0,0,0,2004-11-01T00:00:00
NEWCASTLE,2004,12,0,0,0,2004-12-01T00:00:00
NEWCASTLE,2005,1,0,0,0,2005-01-01T00:00:00
NEWCASTLE,2005,2,0,0,0,2005-02-01T00:00:00
NEWCASTLE,2005,3,0,0,0,2005-03-01T00:00:00
NEWCASTLE,2005,4,0,0,0,2005-04-01T00:00:00
NEWCASTLE,2005,5,0,0,0,2005-05-01T00:00:00
NEWCASTLE,2005,6,0,0,0,2005-06-01T00:00:00
NEWCASTLE,2005,7,0,0,0,2005-07-01T00:00:00
NEWCASTLE,2005,8,0,0,0,2005-08-01T00:00:00
NEWCASTLE,2005,9,0,0,0,2005-09-01T00:00:00
NEWCASTLE,2005,10,0,0,0,2005-10-01T00:00:00
NEWCASTLE,2005,11,0,0,0,2005-11-01T00:00:00
NEWCASTLE,2005,12,0,0,0,2005-12-01T00:00:00
NEWCASTLE,2006,1,0,0,0,2006-01-01T00:00:00
NEWCASTLE,2006,2,0,0,0,2006-02-01T00:00:00
NEWCASTLE,2006,3,0,0,0,2006-03-01T00:00:00
NEWCASTLE,2006,4,0,0,0,2006-04-01T00:00:00
NEWCASTLE,2006,5,0,0,0,2006-05-01T00:00:00
NEWCASTLE,2006,6,0,0,0,2006-06-01T00:00:00
NEWCASTLE,2006,7,0,0,0,2006-07-01T00:00:00
NEWCASTLE,2006,8,0,0,0,2006-08-01T00:00:00
NEWCASTLE,2006,9,0,0,0,2006-09-01T00:00:00
NEWCASTLE,2006,10,0,0,0,2006-10-01T00:00:00
NEWCASTLE,2006,11,0,0,0,2006-11-01T00:00:00
NEWCASTLE,2006,12,0,0,0,2006-12-01T00:00:00
NEWCASTLE,2007,1,0,0,0,2007-01-01T00:00:00
NEWCASTLE,2007,2,0,0,0,2007-02-01T00:00:00
NEWCASTLE,2007,3,0,0,0,2007-03-01T00:00:00
NEWCASTLE,2007,4,0,0,0,2007-04-01T00:00:00
NEWCASTLE,2007,5,0,0,0,2007-05-01T00:00:00
NEWCASTLE,2007,6,0,0,0,2007-06-01T00:00:00
NEWCASTLE,2007,7,0,0,0,2007-07-01T00:00:00
NEWCASTLE,2007,8,0,0,0,2007-08-01T00:00:00
NEWCASTLE,2007,9,0,0,0,2007-09-01T00:00:00
NEWCASTLE,2007,10,0,0,0,2007-10-01T00:00:00
NEWCASTLE,2007,11,0,0,0,2007-11-01T00:00:00
NEWCASTLE,2007,12,0,0,0,2007-12-01T00:00:00
NEWCASTLE,2008,1,0,0,0,2008-01-01T00:00:00
NEWCASTLE,2008,2,0,0,0,2008-02-01T00:00:00
NEWCASTLE,2008,3,0,0,0,2008-03-01T00:00:00
NEWCASTLE,2008,4,0,0,0,2008-04-01T00:00:00
NEWCASTLE,2008,5,0,0,0,2008-05-01T00:00:00
NEWCASTLE,2008,6,0,0,0,2008-06-01T00:00:00
NEWCASTLE,2008,7,0,0,0,2008-07-01T00:00:00
NEWCASTLE,2008,8,0,0,0,2008-08-01T00:00:00
NEWCASTLE,2008,9,0,0,0,2008-09-01T00:00:00
NEWCASTLE,2008,10,0,0,0,2008-10-01T00:00:00
NEWCASTLE,2008,11,0,0,0,2008-11-01T00:00:00
NEWCASTLE,2008,12,0,0,0,2008-12-01T00:00:00
NEWCASTLE,2009,1,0,0,0,2009-01-01T00:00:00
NEWCASTLE,2009,2,0,0,0,2009-02-01T00:00:00
NEWCASTLE,2009,3,0,0,0,2009-03-01T00:00:00
NEWCASTLE,2009,4,0,0,0,2009-04-01T00:00:00
NEWCASTLE,2009,5,0,0,0,2009-05-01T00:00:00
NEWCASTLE,2009,6,0,0,0,2009-06-01T00:00:00
NEWCASTLE,2009,7,0,0,0,2009-07-01T00:00:00
NEWCASTLE,2009,8,0,0,0,2009-08-01T00:00:00
NEWCASTLE,2009,9,0,0,0,2009-09-01T00:00:00
NEWCASTLE,2009,10,0,0,0,2009-10-01T00:00:00
NEWCASTLE,2009,11,0,0,0,2009-11-01T00:00:00
NEWCASTLE,2009,12,0,0,0,2009-12-01T00:00:00
NEWCASTLE,2010,1,0,0,0,2010-01-01T00:00:00
NEWCASTLE,2010,2,0,0,0,2010-02-01T00:00:00
NEWCASTLE,2010,3,0,0,0,2010-03-01T00:00:00
NEWCASTLE,2010,4,0,0,0,2010-04-01T00:00:00
NEWCASTLE,2010,5,0,0,0,2010-05-01T00:00:00
NEWCASTLE,2010,6,0,0,0,2010-06-01T00:00:00
NEWCASTLE,2010,7,0,0,0,2010-07-01T00:00:00
NEWCASTLE,2010,8,0,0,0,2010-08-01T00:00:00
NEWCASTLE,2010,9,0,0,0,2010-09-01T00:00:00
NEWCASTLE,2010,10,0,0,0,2010-10-01T00:00:00
NEWCASTLE,2010,11,0,0,0,2010-11-01T00:00:00
NEWCASTLE,2010,12,0,0,0,2010-12-01T00:00:00
NEWCASTLE,2011,1,0,0,0,2011-01-01T00:00:00
NEWCASTLE,2011,2,0,0,0,2011-02-01T00:00:00
NEWCASTLE,2011,3,0,0,0,2011-03-01T00:00:00
NEWCASTLE,2011,4,0,0,0,2011-04-01T00:00:00
NEWCASTLE,2011,5,0,0,0,2011-05-01T00:00:00
NEWCASTLE,2011,6,0,0,0,2011-06-01T00:00:00
NEWCASTLE,2011,7,0,0,0,2011-07-01T00:00:00
NEWCASTLE,2011,8,0,0,0,2011-08-01T00:00:00
NEWCASTLE,2011,9,0,0,0,2011-09-01T00:00:00
NEWCASTLE,2011,10,0,0,0,2011-10-01T00:00:00
NEWCASTLE,2011,11,0,0,0,2011-11-01T00:00:00
NEWCASTLE,2011,12,0,0,0,2011-12-01T00:00:00
NEWCASTLE,2012,1,0,0,0,2012-01-01T00:00:00
NEWCASTLE,2012,2,0,0,0,2012-02-01T00:00:00
NEWCASTLE,2012,3,0,0,0,2012-03-01T00:00:00
NEWCASTLE,2012,4,0,0,0,2012-04-01T00:00:00
NEWCASTLE,2012,5,0,0,0,2012-05-01T00:00:00
NEWCASTLE,2012,6,0,0,0,2012-06-01T00:00:00
NEWCASTLE,2012,7,0,0,0,2012-07-01T00:00:00
NEWCASTLE,2012,8,0,0,0,2012-08-01T00:00:00
NEWCASTLE,2012,9,0,0,0,2012-09-01T00:00:00
NEWCASTLE,2012,10,0,0,0,2012-10-01T00:00:00
NEWCASTLE,2012,11,0,0,0,2012-11-01T00:00:00
NEWCASTLE,2012,12,0,0,0,2012-12-01T00:00:00
NEWCASTLE,2013,1,0,0,0,2013-01-01T00:00:00
NEWCASTLE,2013,2,0,0,0,2013-02-01T00:00:00
NEWCASTLE,2013,3,0,0,0,2013-03-01T00:00:00
NEWCASTLE,2013,4,0,0,0,2013-04-01T00:00:00
NEWCASTLE,2013,5,0,0,0,2013-05-01T00:00:00
NEWCASTLE,2013,6,0,0,0,2013-06-01T00:00:00
NEWCASTLE,2013,7,0,0,0,2013-07-01T00:00:00
NEWCASTLE,2013,8,0,0,0,2013-08-01T00:00:00
NEWCASTLE,2013,9,0,0,0,2013-09-01T00:00:00
NEWCASTLE,2013,10,0,0,0,2013-10-01T00:00:00
NEWCASTLE,2013,11,0,0,0,2013-11-01T00:00:00
NEWCASTLE,2013,12,0,0,0,2013-12-01T00:00:00
NEWCASTLE,2014,1,0,0,0,2014-01-01T00:00:00
NEWCASTLE,2014,2,0,0,0,2014-02-01T00:00:00
NEWCASTLE,2014,3,0,0,0,2014-03-01T00:00:00
NEWCASTLE,2014,4,0,0,0,2014-04-01T00:00:00
NEWCASTLE,2014,5,0,0,0,2014-05-01T00:00:00
NEWCASTLE,2014,6,0,0,0,2014-06-01T00:00:00
NEWCASTLE,2014,7,0,0,0,2014-07-01T00:00:00
NEWCASTLE,2014,8,0,0,0,2014-08-01T00:00:00
NEWCASTLE,2014,9,0,0,0,2014-09-01T00:00:00
NEWCASTLE,2014,10,0,0,0,2014-10-01T00:00:00
NEWCASTLE,2014,11,0,0,0,2014-11-01T00:00:00
NEWCASTLE,2014,12,0,0,0,2014-12-01T00:00:00
NEWCASTLE,2015,1,0,0,0,2015-01-01T00:00:00
NEWCASTLE,2015,2,0,0,0,2015-02-01T00:00:00
NEWCASTLE,2015,3,0,0,0,2015-03-01T00:00:00
NEWCASTLE,2015,4,0,0,0,2015-04-01T00:00:00
NEWCASTLE,2015,5,0,0,0,2015-05-01T00:00:00
NEWCASTLE,2015,6,0,0,0,2015-06-01T00:00:00
NEWCASTLE,2015,7,0,0,0,2015-07-01T00:00:00
NEWCASTLE,2015,8,0,0,0,2015-08-01T00:00:00
NEWCASTLE,2015,9,0,0,0,2015-09-01T00:00:00
NEWCASTLE,2015,10,0,0,0,2015-10-01T00:00:00
NEWCASTLE,2015,11,0,0,0,2015-11-01T00:00:00
NEWCASTLE,2015,12,0,0,0,2015-12-01T00:00:00
NEWCASTLE,2016,1,0,0,0,2016-01-01T00:00:00
NEWCASTLE,2016,2,0,0,0,2016-02-01T00:00:00
NEWCASTLE,2016,3,0,0,0,2016-03-01T00:00:00
NEWCASTLE,2016,4,0,0,0,2016-04-01T00:00:00
NEWCASTLE,2016,5,0,0,0,2016-05-01T00:00:00
NEWCASTLE,2016,6,0,0,0,2016-06-01T00:00:00
NEWCASTLE,2016,7,0,0,0,2016-07-01T00:00:00
NEWCASTLE,2016,8,0,0,0,2016-08-01T00:00:00
NEWCASTLE,2016,9,0,0,0,2016-09-01T00:00:00
NEWCASTLE,2016,10,0,0,0,2016-10-01T00:00:00
NEWCASTLE,2016,11,0,0,0,2016-11-01T00:00:00
NEWCASTLE,2016,12,0,0,0,2016-12-01T00:00:00
NEWCASTLE,2017,1,0,0,0,2017-01-01T00:00:00
NEWCASTLE,2017,2,0,0,0,2017-02-01T00:00:00
NEWCASTLE,2017,3,0,0,0,2017-03-01T00:00:00
NEWCASTLE,2017,4,0,0,0,2017-04-01T00:00:00
NEWCASTLE,2017,5,0,0,0,2017-05-01T00:00:00
NEWCASTLE,2017,6,0,0,0,2017-06-01T00:00:00
NEWCASTLE,2017,7,0,0,0,2017-07-01T00:00:00
NEWCASTLE,2017,8,0,0,0,2017-08-01T00:00:00
NEWCASTLE,2017,9,0,0,0,2017-09-01T00:00:00
NEWCASTLE,2017,10,0,0,0,2017-10-01T00:00:00
NEWCASTLE,2017,11,0,0,0,2017-11-01T00:00:00
NEWCASTLE,2017,12,0,0,0,2017-12-01T00:00:00
NEWCASTLE,2018,1,0,0,0,2018-01-01T00:00:00
NEWCASTLE,2018,2,0,0,0,2018-02-01T00:00:00
NEWCASTLE,2018,3,0,0,0,2018-03-01T00:00:00
NEWCASTLE,2018,4,0,0,0,2018-04-01T00:00:00
NEWCASTLE,2018,5,0,0,0,2018-05-01T00:00:00
NEWCASTLE,2018,6,0,0,0,2018-06-01T00:00:00
NEWCASTLE,2018,7,0,0,0,2018-07-01T00:00:00
NEWCASTLE,2018,8,0,0,0,2018-08-01T00:00:00
NEWCASTLE,2018,9,0,0,0,2018-09-01T00:00:00
NEWCASTLE,2018,10,0,0,0,2018-10-01T00:00:00
NEWCASTLE,2018,11,295,279,574,2018-11-01T00:00:00
NEWCASTLE,2018,12,1004,1162,2166,2018-12-01T00:00:00
NEWCASTLE,2019,1,1575,1278,2853,2019-01-01T00:00:00
NEWCASTLE,2019,2,619,475,1094,2019-02-01T00:00:00
NEWCASTLE,2019,3,0,0,0,2019-03-01T00:00:00
NEWCASTLE,2019,4,0,0,0,2019-04-01T00:00:00
NEWCASTLE,2019,5,0,0,0,2019-05-01T00:00:00
NEWCASTLE,2019,6,0,0,0,2019-06-01T00:00:00
NEWCASTLE,2019,7,0,0,0,2019-07-01T00:00:00
NEWCASTLE,2019,8,0,0,0,2019-08-01T00:00:00
NEWCASTLE,2019,9,0,0,0,2019-09-01T00:00:00
NEWCASTLE,2019,10,0,0,0,2019-10-01T00:00:00
NEWCASTLE,2019,11,265,364,629,2019-11-01T00:00:00
NEWCASTLE,2019,12,1225,1323,2548,2019-12-01T00:00:00
NEWCASTLE,2020,1,1665,1425,3090,2020-01-01T00:00:00
NEWCASTLE,2020,2,625,479,1104,2020-02-01T00:00:00
NEWCASTLE,2020,3,0,0,0,2020-03-01T00:00:00
NEWCASTLE,2020,4,0,0,0,2020-04-01T00:00:00
NEWCASTLE,2020,5,0,0,0,2020-05-01T00:00:00
NEWCASTLE,2020,6,0,0,0,2020-06-01T00:00:00
NEWCASTLE,2020,7,0,0,0,2020-07-01T00:00:00
NEWCASTLE,2020,8,0,0,0,2020-08-01T00:00:00
NEWCASTLE,2020,9,0,0,0,2020-09-01T00:00:00
NEWCASTLE,2020,10,0,0,0,2020-10-01T00:00:00
NEWCASTLE,2020,11,0,0,0,2020-11-01T00:00:00
NEWCASTLE,2020,12,0,0,0,2020-12-01T00:00:00
NEWCASTLE,2021,1,0,0,0,2021-01-01T00:00:00
NEWCASTLE,2021,2,0,0,0,2021-02-01T00:00:00
NEWCASTLE,2021,3,0,0,0,2021-03-01T00:00:00
NEWCASTLE,2021,4,0,0,0,2021-04-01T00:00:00
NEWCASTLE,2021,5,0,0,0,2021-05-01T00:00:00
NEWCASTLE,2021,6,0,0,0,2021-06-01T00:00:00
NEWCASTLE,2021,7,0,0,0,2021-07-01T00:00:00
NEWCASTLE,2021,8,0,0,0,2021-08-01T00:00:00
NEWCASTLE,2021,9,0,0,0,2021-09-01T00:00:00
NEWCASTLE,2021,10,0,0,0,2021-10-01T00:00:00
NEWCASTLE,2021,11,0,0,0,2021-11-01T00:00:00
NEWCASTLE,2021,12,0,0,0,2021-12-01T00:00:00
NEWCASTLE,2022,1,0,0,0,2022-01-01T00:00:00
NEWCASTLE,2022,2,0,0,0,2022-02-01T00:00:00
NEWCASTLE,2022,3,0,0,0,2022-03-01T00:00:00
NEWCASTLE,2022,4,0,0,0,2022-04-01T00:00:00
NEWCASTLE,2022,5,0,0,0,2022-05-01T00:00:00
NEWCASTLE,2022,6,0,0,0,2022-06-01T00:00:00
NEWCASTLE,2022,7,0,0,0,2022-07-01T00:00:00
NEWCASTLE,2022,8,0,0,0,2022-08-01T00:00:00
NEWCASTLE,2022,9,0,0,0,2022-09-01T00:00:00
NEWCASTLE,2022,10,0,0,0,2022-10-01T00:00:00
NEWCASTLE,2022,11,0,0,0,2022-11-01T00:00:00
NEWCASTLE,2022,12,0,0,0,2022-12-01T00:00:00
NEWCASTLE,2023,1,0,0,0,2023-01-01T00:00:00
NEWCASTLE,2023,2,0,0,0,2023-02-01T00:00:00
NEWCASTLE,2023,3,0,0,0,2023-03-01T00:00:00
NEWCASTLE,2023,4,0,0,0,2023-04-01T00:00:00
NEWCASTLE,2023,5,0,0,0,2023-05-01T00:00:00
NEWCASTLE,2023,6,0,0,0,2023-06-01T00:00:00
NEWCASTLE,2023,7,0,0,0,2023-07-01T00:00:00
NEWCASTLE,2023,8,0,0,0,2023-08-01T00:00:00
NEWCASTLE,2023,9,0,0,0,2023-09-01T00:00:00
NEWCASTLE,2023,10,0,0,0,2023-10-01T00:00:00
NEWCASTLE,2023,11,0,0,0,2023-11-01T00:00:00
NEWCASTLE,2023,12,0,0,0,2023-12-01T00:00:00
NEWCASTLE,2024,1,0,0,0,2024-01-01T00:00:00
NEWCASTLE,2024,2,0,0,0,2024-02-01T00:00:00
NEWCASTLE,2024,3,0,0,0,2024-03-01T00:00:00
NEWCASTLE,2024,4,0,0,0,2024-04-01T00:00:00
NEWCASTLE,2024,5,0,0,0,2024-05-01T00:00:00
NEWCASTLE,2024,6,0,0,0,2024-06-01T00:00:00
NEWCASTLE,2024,7,0,0,0,2024-07-01T00:00:00
NEWCASTLE,2024,8,0,0,0,2024-08-01T00:00:00
NEWCASTLE,2024,9,0,0,0,2024-09-01T00:00:00
NEWCASTLE,2024,10,0,0,0,2024-10-01T00:00:00
NEWCASTLE,2024,11,0,0,0,2024-11-01T00:00:00
NEWCASTLE,2024,12,0,0,0,2024-12-01T00:00:00
NEWCASTLE,2025,1,0,0,0,2025-01-01T00:00:00
NEWCASTLE,2025,2,0,0,0,2025-02-01T00:00:00
NEWCASTLE,2025,3,0,0,0,2025-03-01T00:00:00
NEWCASTLE,2025,4,0,0,0,2025-04-01T00:00:00
NEWCASTLE,2025,5,0,0,0,2025-05-01T00:00:00
NEWCASTLE,2025,6,0,0,0,2025-06-01T00:00:00
PERTH,1985,1,22914,21799,44713,1985-01-01T00:00:00
PERTH,1985,2,22745,17663,40408,1985-02-01T00:00:00
PERTH,1985,3,19693,21932,41625,1985-03-01T00:00:00
PERTH,1985,4,16688,20041,36729,1985-04-01T00:00:00
PERTH,1985,5,17868,22092,39960,1985-05-01T00:00:00
PERTH,1985,6,19507,20815,40322,1985-06-01T00:00:00
PERTH,1985,7,18260,18739,36999,1985-07-01T00:00:00
PERTH,1985,8,20118,20182,40300,1985-08-01T00:00:00
PERTH,1985,9,25371,20212,45583,1985-09-01T00:00:00
PERTH,1985,10,24289,16178,40467,1985-10-01T00:00:00
PERTH,1985,11,23092,19499,42591,1985-11-01T00:00:00
PERTH,1985,12,24710,26475,51185,1985-12-01T00:00:00
PERTH,1986,1,28384,24512,52896,1986-01-01T00:00:00
PERTH,1986,2,22103,18410,40513,1986-02-01T00:00:00
PERTH,1986,3,21815,22514,44329,1986-03-01T00:00:00
PERTH,1986,4,18767,22238,41005,1986-04-01T00:00:00
PERTH,1986,5,16965,20301,37266,1986-05-01T00:00:00
PERTH,1986,6,20645,25231,45876,1986-06-01T00:00:00
PERTH,1986,7,25304,21016,46320,1986-07-01T00:00:00
PERTH,1986,8,24098,21551,45649,1986-08-01T00:00:00
PERTH,1986,9,26677,24114,50791,1986-09-01T00:00:00
PERTH,1986,10,29826,20966,50792,1986-10-01T00:00:00
PERTH,1986,11,27844,22763,50607,1986-11-01T00:00:00
PERTH,1986,12,30322,30000,60322,1986-12-01T00:00:00
PERTH,1987,1,35226,29316,64542,1987-01-01T00:00:00
PERTH,1987,2,25925,25080,51005,1987-02-01T00:00:00
PERTH,1987,3,25261,27855,53116,1987-03-01T00:00:00
PERTH,1987,4,24749,27062,51811,1987-04-01T00:00:00
PERTH,1987,5,20390,25210,45600,1987-05-01T00:00:00
PERTH,1987,6,22793,25479,48272,1987-06-01T00:00:00
PERTH,1987,7,29103,26376,55479,1987-07-01T00:00:00
PERTH,1987,8,27336,26269,53605,1987-08-01T00:00:00
PERTH,1987,9,27352,25294,52646,1987-09-01T00:00:00
PERTH,1987,10,33317,23558,56875,1987-10-01T00:00:00
PERTH,1987,11,28402,23324,51726,1987-11-01T00:00:00
PERTH,1987,12,31799,32723,64522,1987-12-01T00:00:00
PERTH,1988,1,35832,31669,67501,1988-01-01T00:00:00
PERTH,1988,2,31128,24153,55281,1988-02-01T00:00:00
PERTH,1988,3,29025,28863,57888,1988-03-01T00:00:00
PERTH,1988,4,26830,28318,55148,1988-04-01T00:00:00
PERTH,1988,5,22053,26595,48648,1988-05-01T00:00:00
PERTH,1988,6,24480,29396,53876,1988-06-01T00:00:00
PERTH,1988,7,33827,27505,61332,1988-07-01T00:00:00
PERTH,1988,8,29077,27122,56199,1988-08-01T00:00:00
PERTH,1988,9,31478,29259,60737,1988-09-01T00:00:00
PERTH,1988,10,36134,24652,60786,1988-10-01T00:00:00
PERTH,1988,11,33665,27848,61513,1988-11-01T00:00:00
PERTH,1988,12,36543,38659,75202,1988-12-01T00:00:00
PERTH,1989,1,38174,34352,72526,1989-01-01T00:00:00
PERTH,1989,2,33452,26297,59749,1989-02-01T00:00:00
PERTH,1989,3,32277,33538,65815,1989-03-01T00:00:00
PERTH,1989,4,32430,34241,66671,1989-04-01T00:00:00
PERTH,1989,5,25898,30010,55908,1989-05-01T00:00:00
PERTH,1989,6,29653,30710,60363,1989-06-01T00:00:00
PERTH,1989,7,36394,34417,70811,1989-07-01T00:00:00
PERTH,1989,8,33369,32338,65707,1989-08-01T00:00:00
PERTH,1989,9,36754,34230,70984,1989-09-01T00:00:00
PERTH,1989,10,40160,30411,70571,1989-10-01T00:00:00
PERTH,1989,11,37292,32333,69625,1989-11-01T00:00:00
PERTH,1989,12,38572,44452,83024,1989-12-01T00:00:00
PERTH,1990,1,41545,38177,79722,1990-01-01T00:00:00
PERTH,1990,2,36608,27494,64102,1990-02-01T00:00:00
PERTH,1990,3,33315,35236,68551,1990-03-01T00:00:00
PERTH,1990,4,36039,37639,73678,1990-04-01T00:00:00
PERTH,1990,5,28069,33292,61361,1990-05-01T00:00:00
PERTH,1990,6,29971,35038,65009,1990-06-01T00:00:00
PERTH,1990,7,39916,36946,76862,1990-07-01T00:00:00
PERTH,1990,8,36507,33963,70470,1990-08-01T00:00:00
PERTH,1990,9,36038,35474,71512,1990-09-01T00:00:00
PERTH,1990,10,43147,30951,74098,1990-10-01T00:00:00
PERTH,1990,11,38343,33148,71491,1990-11-01T00:00:00
PERTH,1990,12,39828,44132,83960,1990-12-01T00:00:00
PERTH,1991,1,42055,36059,78114,1991-01-01T00:00:00
PERTH,1991,2,33211,27533,60744,1991-02-01T00:00:00
PERTH,1991,3,30812,31796,62608,1991-03-01T00:00:00
PERTH,1991,4,32339,35004,67343,1991-04-01T00:00:00
PERTH,1991,5,28437,30475,58912,1991-05-01T00:00:00
PERTH,1991,6,31795,34782,66577,1991-06-01T00:00:00
PERTH,1991,7,35465,33082,68547,1991-07-01T00:00:00
PERTH,1991,8,31836,30692,62528,1991-08-01T00:00:00
PERTH,1991,9,35493,32439,67932,1991-09-01T00:00:00
PERTH,1991,10,42364,30995,73359,1991-10-01T00:00:00
PERTH,1991,11,38439,35873,74312,1991-11-01T00:00:00
PERTH,1991,12,39857,43339,83196,1991-12-01T00:00:00
PERTH,1992,1,41898,35561,77459,1992-01-01T00:00:00
PERTH,1992,2,38161,31105,69266,1992-02-01T00:00:00
PERTH,1992,3,33724,36025,69749,1992-03-01T00:00:00
PERTH,1992,4,36156,37305,73461,1992-04-01T00:00:00
PERTH,1992,5,25823,31782,57605,1992-05-01T00:00:00
PERTH,1992,6,29346,33795,63141,1992-06-01T00:00:00
PERTH,1992,7,41597,37969,79566,1992-07-01T00:00:00
PERTH,1992,8,36919,35265,72184,1992-08-01T00:00:00
PERTH,1992,9,41507,40050,81557,1992-09-01T00:00:00
PERTH,1992,10,47647,34960,82607,1992-10-01T00:00:00
PERTH,1992,11,40652,36943,77595,1992-11-01T00:00:00
PERTH,1992,12,43503,49597,93100,1992-12-01T00:00:00
PERTH,1993,1,50360,43010,93370,1993-01-01T00:00:00
PERTH,1993,2,37773,29067,66840,1993-02-01T00:00:00
PERTH,1993,3,40685,38324,79009,1993-03-01T00:00:00
PERTH,1993,4,37545,42525,80070,1993-04-01T00:00:00
PERTH,1993,5,32055,35821,67876,1993-05-01T00:00:00
PERTH,1993,6,35159,40645,75804,1993-06-01T00:00:00
PERTH,1993,7,46560,42983,89543,1993-07-01T00:00:00
PERTH,1993,8,40687,38854,79541,1993-08-01T00:00:00
PERTH,1993,9,43765,38775,82540,1993-09-01T00:00:00
PERTH,1993,10,53671,41937,95608,1993-10-01T00:00:00
PERTH,1993,11,45021,42514,87535,1993-11-01T00:00:00
PERTH,1993,12,49694,53439,103133,1993-12-01T00:00:00
PERTH,1994,1,51394,44949,96343,1994-01-01T00:00:00
PERTH,1994,2,46854,39232,86086,1994-02-01T00:00:00
PERTH,1994,3,50284,47779,98063,1994-03-01T00:00:00
PERTH,1994,4,42409,47238,89647,1994-04-01T00:00:00
PERTH,1994,5,36190,41107,77297,1994-05-01T00:00:00
PERTH,1994,6,39572,43465,83037,1994-06-01T00:00:00
PERTH,1994,7,53962,49119,103081,1994-07-01T00:00:00
PERTH,1994,8,45538,42381,87919,1994-08-01T00:00:00
PERTH,1994,9,47137,43693,90830,1994-09-01T00:00:00
PERTH,1994,10,56081,42709,98790,1994-10-01T00:00:00
PERTH,1994,11,49611,45697,95308,1994-11-01T00:00:00
PERTH,1994,12,55513,59132,114645,1994-12-01T00:00:00
PERTH,1995,1,56244,50272,106516,1995-01-01T00:00:00
PERTH,1995,2,49223,40143,89366,1995-02-01T00:00:00
PERTH,1995,3,48580,51582,100162,1995-03-01T00:00:00
PERTH,1995,4,45465,48049,93514,1995-04-01T00:00:00
PERTH,1995,5,39776,43116,82892,1995-05-01T00:00:00
PERTH,1995,6,43904,49123,93027,1995-06-01T00:00:00
PERTH,1995,7,53114,48441,101555,1995-07-01T00:00:00
PERTH,1995,8,48664,45324,93988,1995-08-01T00:00:00
PERTH,1995,9,50028,47882,97910,1995-09-01T00:00:00
PERTH,1995,10,60377,46042,106419,1995-10-01T00:00:00
PERTH,1995,11,53531,47754,101285,1995-11-01T00:00:00
PERTH,1995,12,60414,63789,124203,1995-12-01T00:00:00
PERTH,1996,1,57567,51274,108841,1996-01-01T00:00:00
PERTH,1996,2,57417,46466,103883,1996-02-01T00:00:00
PERTH,1996,3,48592,53734,102326,1996-03-01T00:00:00
PERTH,1996,4,51685,51397,103082,1996-04-01T00:00:00
PERTH,1996,5,40675,47602,88277,1996-05-01T00:00:00
PERTH,1996,6,48176,56146,104322,1996-06-01T00:00:00
PERTH,1996,7,58363,52150,110513,1996-07-01T00:00:00
PERTH,1996,8,53259,51605,104864,1996-08-01T00:00:00
PERTH,1996,9,55184,53068,108252,1996-09-01T00:00:00
PERTH,1996,10,66160,49709,115869,1996-10-01T00:00:00
PERTH,1996,11,58520,50944,109464,1996-11-01T00:00:00
PERTH,1996,12,64288,68146,132434,1996-12-01T00:00:00
PERTH,1997,1,64790,57369,122159,1997-01-01T00:00:00
PERTH,1997,2,59244,49266,108510,1997-02-01T00:00:00
PERTH,1997,3,56087,55135,111222,1997-03-01T00:00:00
PERTH,1997,4,53115,56935,110050,1997-04-01T00:00:00
PERTH,1997,5,46133,55704,101837,1997-05-01T00:00:00
PERTH,1997,6,51540,58023,109563,1997-06-01T00:00:00
PERTH,1997,7,65967,59957,125924,1997-07-01T00:00:00
PERTH,1997,8,56706,54534,111240,1997-08-01T00:00:00
PERTH,1997,9,60945,57902,118847,1997-09-01T00:00:00
PERTH,1997,10,73624,54988,128612,1997-10-01T00:00:00
PERTH,1997,11,61527,58073,119600,1997-11-01T00:00:00
PERTH,1997,12,64357,67593,131950,1997-12-01T00:00:00
PERTH,1998,1,67064,59051,126115,1998-01-01T00:00:00
PERTH,1998,2,57027,48614,105641,1998-02-01T00:00:00
PERTH,1998,3,54942,57670,112612,1998-03-01T00:00:00
PERTH,1998,4,57655,60635,118290,1998-04-01T00:00:00
PERTH,1998,5,51800,59566,111366,1998-05-01T00:00:00
PERTH,1998,6,54037,57758,111795,1998-06-01T00:00:00
PERTH,1998,7,64652,56857,121509,1998-07-01T00:00:00
PERTH,1998,8,58803,58496,117299,1998-08-01T00:00:00
PERTH,1998,9,63312,58014,121326,1998-09-01T00:00:00
PERTH,1998,10,73330,59697,133027,1998-10-01T00:00:00
PERTH,1998,11,65005,56690,121695,1998-11-01T00:00:00
PERTH,1998,12,65957,67445,133402,1998-12-01T00:00:00
PERTH,1999,1,69618,65200,134818,1999-01-01T00:00:00
PERTH,1999,2,62094,49586,111680,1999-02-01T00:00:00
PERTH,1999,3,61531,60851,122382,1999-03-01T00:00:00
PERTH,1999,4,56074,60447,116521,1999-04-01T00:00:00
PERTH,1999,5,51762,53992,105754,1999-05-01T00:00:00
PERTH,1999,6,52459,62042,114501,1999-06-01T00:00:00
PERTH,1999,7,68054,58327,126381,1999-07-01T00:00:00
PERTH,1999,8,61379,62213,123592,1999-08-01T00:00:00
PERTH,1999,9,67598,61027,128625,1999-09-01T00:00:00
PERTH,1999,10,77195,57410,134605,1999-10-01T00:00:00
PERTH,1999,11,66618,60317,126935,1999-11-01T00:00:00
PERTH,1999,12,60732,68372,129104,1999-12-01T00:00:00
PERTH,2000,1,72336,64484,136820,2000-01-01T00:00:00
PERTH,2000,2,66068,52829,118897,2000-02-01T00:00:00
PERTH,2000,3,62341,66451,128792,2000-03-01T00:00:00
PERTH,2000,4,66159,66943,133102,2000-04-01T00:00:00
PERTH,2000,5,50973,59270,110243,2000-05-01T00:00:00
PERTH,2000,6,55167,64579,119746,2000-06-01T00:00:00
PERTH,2000,7,72134,59338,131472,2000-07-01T00:00:00
PERTH,2000,8,63905,62378,126283,2000-08-01T00:00:00
PERTH,2000,9,65804,62096,127900,2000-09-01T00:00:00
PERTH,2000,10,80981,62148,143129,2000-10-01T00:00:00
PERTH,2000,11,74412,69788,144200,2000-11-01T00:00:00
PERTH,2000,12,80718,79320,160038,2000-12-01T00:00:00
PERTH,2001,1,78222,75406,153628,2001-01-01T00:00:00
PERTH,2001,2,66945,51049,117994,2001-02-01T00:00:00
PERTH,2001,3,66823,67993,134816,2001-03-01T00:00:00
PERTH,2001,4,62964,67451,130415,2001-04-01T00:00:00
PERTH,2001,5,51849,59795,111644,2001-05-01T00:00:00
PERTH,2001,6,58802,67064,125866,2001-06-01T00:00:00
PERTH,2001,7,72886,62759,135645,2001-07-01T00:00:00
PERTH,2001,8,66192,65246,131438,2001-08-01T00:00:00
PERTH,2001,9,71776,66339,138115,2001-09-01T00:00:00
PERTH,2001,10,77573,58859,136432,2001-10-01T00:00:00
PERTH,2001,11,64610,57426,122036,2001-11-01T00:00:00
PERTH,2001,12,75393,73957,149350,2001-12-01T00:00:00
PERTH,2002,1,74537,71902,146439,2002-01-01T00:00:00
PERTH,2002,2,69733,55801,125534,2002-02-01T00:00:00
PERTH,2002,3,72426,67876,140302,2002-03-01T00:00:00
PERTH,2002,4,56825,68791,125616,2002-04-01T00:00:00
PERTH,2002,5,57756,62436,120192,2002-05-01T00:00:00
PERTH,2002,6,59217,67405,126622,2002-06-01T00:00:00
PERTH,2002,7,74196,63105,137301,2002-07-01T00:00:00
PERTH,2002,8,67477,67349,134826,2002-08-01T00:00:00
PERTH,2002,9,72429,68170,140599,2002-09-01T00:00:00
PERTH,2002,10,83677,60706,144383,2002-10-01T00:00:00
PERTH,2002,11,71636,64282,135918,2002-11-01T00:00:00
PERTH,2002,12,77846,80844,158690,2002-12-01T00:00:00
PERTH,2003,1,78546,72174,150720,2003-01-01T00:00:00
PERTH,2003,2,71789,56256,128045,2003-02-01T00:00:00
PERTH,2003,3,64852,65621,130473,2003-03-01T00:00:00
PERTH,2003,4,52889,56287,109176,2003-04-01T00:00:00
PERTH,2003,5,45320,50501,95821,2003-05-01T00:00:00
PERTH,2003,6,51203,56388,107591,2003-06-01T00:00:00
PERTH,2003,7,72230,60336,132566,2003-07-01T00:00:00
PERTH,2003,8,62888,63434,126322,2003-08-01T00:00:00
PERTH,2003,9,74790,68555,143345,2003-09-01T00:00:00
PERTH,2003,10,85503,63909,149412,2003-10-01T00:00:00
PERTH,2003,11,72981,69922,142903,2003-11-01T00:00:00
PERTH,2003,12,84625,85623,170248,2003-12-01T00:00:00
PERTH,2004,1,89842,86044,175886,2004-01-01T00:00:00
PERTH,2004,2,78288,60862,139150,2004-02-01T00:00:00
PERTH,2004,3,71796,74164,145960,2004-03-01T00:00:00
PERTH,2004,4,71155,77719,148874,2004-04-01T00:00:00
PERTH,2004,5,57656,66660,124316,2004-05-01T00:00:00
PERTH,2004,6,63867,71389,135256,2004-06-01T00:00:00
PERTH,2004,7,83609,72545,156154,2004-07-01T00:00:00
PERTH,2004,8,73432,72063,145495,2004-08-01T00:00:00
PERTH,2004,9,75466,65991,141457,2004-09-01T00:00:00
PERTH,2004,10,89361,73702,163063,2004-10-01T00:00:00
PERTH,2004,11,84746,78693,163439,2004-11-01T00:00:00
PERTH,2004,12,91475,96864,188339,2004-12-01T00:00:00
PERTH,2005,1,99674,88862,188536,2005-01-01T00:00:00
PERTH,2005,2,86176,70692,156868,2005-02-01T00:00:00
PERTH,2005,3,89020,86186,175206,2005-03-01T00:00:00
PERTH,2005,4,74527,85781,160308,2005-04-01T00:00:00
PERTH,2005,5,67369,77161,144530,2005-05-01T00:00:00
PERTH,2005,6,75313,86978,162291,2005-06-01T00:00:00
PERTH,2005,7,94033,79644,173677,2005-07-01T00:00:00
PERTH,2005,8,79714,79578,159292,2005-08-01T00:00:00
PERTH,2005,9,86221,79796,166017,2005-09-01T00:00:00
PERTH,2005,10,97595,71530,169125,2005-10-01T00:00:00
PERTH,2005,11,80761,78913,159674,2005-11-01T00:00:00
PERTH,2005,12,91838,99663,191501,2005-12-01T00:00:00
PERTH,2006,1,102499,86673,189172,2006-01-01T00:00:00
PERTH,2006,2,84447,68749,153196,2006-02-01T00:00:00
PERTH,2006,3,77375,80277,157652,2006-03-01T00:00:00
PERTH,2006,4,79272,89197,168469,2006-04-01T00:00:00
PERTH,2006,5,65666,73398,139064,2006-05-01T00:00:00
PERTH,2006,6,70329,82582,152911,2006-06-01T00:00:00
PERTH,2006,7,96083,80422,176505,2006-07-01T00:00:00
PERTH,2006,8,80202,76904,157106,2006-08-01T00:00:00
PERTH,2006,9,83593,77106,160699,2006-09-01T00:00:00
PERTH,2006,10,105339,80122,185461,2006-10-01T00:00:00
PERTH,2006,11,88605,81909,170514,2006-11-01T00:00:00
PERTH,2006,12,109355,114773,224128,2006-12-01T00:00:00
PERTH,2007,1,116820,99440,216260,2007-01-01T00:00:00
PERTH,2007,2,96188,76677,172865,2007-02-01T00:00:00
PERTH,2007,3,91010,93496,184506,2007-03-01T00:00:00
PERTH,2007,4,91680,100841,192521,2007-04-01T00:00:00
PERTH,2007,5,77954,87480,165434,2007-05-01T00:00:00
PERTH,2007,6,85112,100610,185722,2007-06-01T00:00:00
PERTH,2007,7,118158,96690,214848,2007-07-01T00:00:00
PERTH,2007,8,96078,94491,190569,2007-08-01T00:00:00
PERTH,2007,9,102537,97623,200160,2007-09-01T00:00:00
PERTH,2007,10,122294,91943,214237,2007-10-01T00:00:00
PERTH,2007,11,101676,93373,195049,2007-11-01T00:00:00
PERTH,2007,12,113436,127961,241397,2007-12-01T00:00:00
PERTH,2008,1,132455,108628,241083,2008-01-01T00:00:00
PERTH,2008,2,110164,85160,195324,2008-02-01T00:00:00
PERTH,2008,3,104167,102936,207103,2008-03-01T00:00:00
PERTH,2008,4,96530,105857,202387,2008-04-01T00:00:00
PERTH,2008,5,84799,95206,180005,2008-05-01T00:00:00
PERTH,2008,6,92915,102743,195658,2008-06-01T00:00:00
PERTH,2008,7,123325,100960,224285,2008-07-01T00:00:00
PERTH,2008,8,101784,98531,200315,2008-08-01T00:00:00
PERTH,2008,9,104803,102062,206865,2008-09-01T00:00:00
PERTH,2008,10,129204,96292,225496,2008-10-01T00:00:00
PERTH,2008,11,104018,98251,202269,2008-11-01T00:00:00
PERTH,2008,12,115682,136550,252232,2008-12-01T00:00:00
PERTH,2009,1,145541,115339,260880,2009-01-01T00:00:00
PERTH,2009,2,108734,82162,190896,2009-02-01T00:00:00
PERTH,2009,3,101113,102056,203169,2009-03-01T00:00:00
PERTH,2009,4,108813,114652,223465,2009-04-01T00:00:00
PERTH,2009,5,91788,105108,196896,2009-05-01T00:00:00
PERTH,2009,6,98608,114593,213201,2009-06-01T00:00:00
PERTH,2009,7,128152,112281,240433,2009-07-01T00:00:00
PERTH,2009,8,110726,106906,217632,2009-08-01T00:00:00
PERTH,2009,9,121982,120913,242895,2009-09-01T00:00:00
PERTH,2009,10,143712,114485,258197,2009-10-01T00:00:00
PERTH,2009,11,124069,119648,243717,2009-11-01T00:00:00
PERTH,2009,12,128445,154911,283356,2009-12-01T00:00:00
PERTH,2010,1,162965,132416,295381,2010-01-01T00:00:00
PERTH,2010,2,121055,104937,225992,2010-02-01T00:00:00
PERTH,2010,3,123514,128335,251849,2010-03-01T00:00:00
PERTH,2010,4,120962,123936,244898,2010-04-01T00:00:00
PERTH,2010,5,104309,114443,218752,2010-05-01T00:00:00
PERTH,2010,6,115473,143302,258775,2010-06-01T00:00:00
PERTH,2010,7,152709,129033,281742,2010-07-01T00:00:00
PERTH,2010,8,124979,124766,249745,2010-08-01T00:00:00
PERTH,2010,9,135453,138472,273925,2010-09-01T00:00:00
PERTH,2010,10,159154,123118,282272,2010-10-01T00:00:00
PERTH,2010,11,126434,125609,252043,2010-11-01T00:00:00
PERTH,2010,12,132438,165897,298335,2010-12-01T00:00:00
PERTH,2011,1,181208,142653,323861,2011-01-01T00:00:00
PERTH,2011,2,132824,109037,241861,2011-02-01T00:00:00
PERTH,2011,3,123725,124375,248100,2011-03-01T00:00:00
PERTH,2011,4,128507,145585,274092,2011-04-01T00:00:00
PERTH,2011,5,126487,127062,253549,2011-05-01T00:00:00
PERTH,2011,6,122825,142806,265631,2011-06-01T00:00:00
PERTH,2011,7,161562,144998,306560,2011-07-01T00:00:00
PERTH,2011,8,139530,127583,267113,2011-08-01T00:00:00
PERTH,2011,9,140559,144486,285045,2011-09-01T00:00:00
PERTH,2011,10,165756,135565,301321,2011-10-01T00:00:00
PERTH,2011,11,137757,132561,270318,2011-11-01T00:00:00
PERTH,2011,12,136199,175818,312017,2011-12-01T00:00:00
PERTH,2012,1,188945,147847,336792,2012-01-01T00:00:00
PERTH,2012,2,144942,116154,261096,2012-02-01T00:00:00
PERTH,2012,3,139493,142470,281963,2012-03-01T00:00:00
PERTH,2012,4,146446,153732,300178,2012-04-01T00:00:00
PERTH,2012,5,123171,135126,258297,2012-05-01T00:00:00
PERTH,2012,6,134790,154268,289058,2012-06-01T00:00:00
PERTH,2012,7,173443,149645,323088,2012-07-01T00:00:00
PERTH,2012,8,144289,142521,286810,2012-08-01T00:00:00
PERTH,2012,9,155108,155652,310760,2012-09-01T00:00:00
PERTH,2012,10,183232,146786,330018,2012-10-01T00:00:00
PERTH,2012,11,147270,146048,293318,2012-11-01T00:00:00
PERTH,2012,12,150447,196943,347390,2012-12-01T00:00:00
PERTH,2013,1,208925,159037,367962,2013-01-01T00:00:00
PERTH,2013,2,152007,126370,278377,2013-02-01T00:00:00
PERTH,2013,3,151995,151384,303379,2013-03-01T00:00:00
PERTH,2013,4,143640,162889,306529,2013-04-01T00:00:00
PERTH,2013,5,144424,147124,291548,2013-05-01T00:00:00
PERTH,2013,6,141523,160898,302421,2013-06-01T00:00:00
PERTH,2013,7,187095,169847,356942,2013-07-01T00:00:00
PERTH,2013,8,161495,159005,320500,2013-08-01T00:00:00
PERTH,2013,9,166260,169413,335673,2013-09-01T00:00:00
PERTH,2013,10,196425,152043,348468,2013-10-01T00:00:00
PERTH,2013,11,156917,153245,310162,2013-11-01T00:00:00
PERTH,2013,12,170531,227348,397879,2013-12-01T00:00:00
PERTH,2014,1,244756,188565,433321,2014-01-01T00:00:00
PERTH,2014,2,165809,138879,304688,2014-02-01T00:00:00
PERTH,2014,3,157118,158112,315230,2014-03-01T00:00:00
PERTH,2014,4,174325,184451,358776,2014-04-01T00:00:00
PERTH,2014,5,142723,158400,301123,2014-05-01T00:00:00
PERTH,2014,6,145966,170833,316799,2014-06-01T00:00:00
PERTH,2014,7,205965,178812,384777,2014-07-01T00:00:00
PERTH,2014,8,163905,166519,330424,2014-08-01T00:00:00
PERTH,2014,9,179961,181406,361367,2014-09-01T00:00:00
PERTH,2014,10,204204,158932,363136,2014-10-01T00:00:00
PERTH,2014,11,158386,156950,315336,2014-11-01T00:00:00
PERTH,2014,12,173480,221950,395430,2014-12-01T00:00:00
PERTH,2015,1,238626,184382,423008,2015-01-01T00:00:00
PERTH,2015,2,169685,144653,314338,2015-02-01T00:00:00
PERTH,2015,3,160418,167454,327872,2015-03-01T00:00:00
PERTH,2015,4,168302,173956,342258,2015-04-01T00:00:00
PERTH,2015,5,143271,158138,301409,2015-05-01T00:00:00
PERTH,2015,6,147906,177716,325622,2015-06-01T00:00:00
PERTH,2015,7,204453,182039,386492,2015-07-01T00:00:00
PERTH,2015,8,168066,167076,335142,2015-08-01T00:00:00
PERTH,2015,9,175801,178626,354427,2015-09-01T00:00:00
PERTH,2015,10,201257,159865,361122,2015-10-01T00:00:00
PERTH,2015,11,161118,156852,317970,2015-11-01T00:00:00
PERTH,2015,12,177833,225340,403173,2015-12-01T00:00:00
PERTH,2016,1,239957,194026,433983,2016-01-01T00:00:00
PERTH,2016,2,183022,150969,333991,2016-02-01T00:00:00
PERTH,2016,3,169100,174373,343473,2016-03-01T00:00:00
PERTH,2016,4,172768,180423,353191,2016-04-01T00:00:00
PERTH,2016,5,149078,158887,307965,2016-05-01T00:00:00
PERTH,2016,6,153342,186840,340182,2016-06-01T00:00:00
PERTH,2016,7,217460,185918,403378,2016-07-01T00:00:00
PERTH,2016,8,172310,168899,341209,2016-08-01T00:00:00
PERTH,2016,9,187478,191734,379212,2016-09-01T00:00:00
PERTH,2016,10,212243,166592,378835,2016-10-01T00:00:00
PERTH,2016,11,168867,172050,340917,2016-11-01T00:00:00
PERTH,2016,12,188630,234209,422839,2016-12-01T00:00:00
PERTH,2017,1,239999,196653,436652,2017-01-01T00:00:00
PERTH,2017,2,181235,146779,328014,2017-02-01T00:00:00
PERTH,2017,3,168813,174935,343748,2017-03-01T00:00:00
PERTH,2017,4,185833,193652,379485,2017-04-01T00:00:00
PERTH,2017,5,155396,165738,321134,2017-05-01T00:00:00
PERTH,2017,6,158255,190155,348410,2017-06-01T00:00:00
PERTH,2017,7,211701,182304,394005,2017-07-01T00:00:00
PERTH,2017,8,174162,171298,345460,2017-08-01T00:00:00
PERTH,2017,9,183141,189091,372232,2017-09-01T00:00:00
PERTH,2017,10,209573,167158,376731,2017-10-01T00:00:00
PERTH,2017,11,166263,164421,330684,2017-11-01T00:00:00
PERTH,2017,12,183881,225031,408912,2017-12-01T00:00:00
PERTH,2018,1,230724,190208,420932,2018-01-01T00:00:00
PERTH,2018,2,173590,147109,320699,2018-02-01T00:00:00
PERTH,2018,3,172623,178886,351509,2018-03-01T00:00:00
PERTH,2018,4,171396,184847,356243,2018-04-01T00:00:00
PERTH,2018,5,156686,164906,321592,2018-05-01T00:00:00
PERTH,2018,6,160492,195155,355647,2018-06-01T00:00:00
PERTH,2018,7,216000,180045,396045,2018-07-01T00:00:00
PERTH,2018,8,178516,178586,357102,2018-08-01T00:00:00
PERTH,2018,9,182920,187834,370754,2018-09-01T00:00:00
PERTH,2018,10,199858,160469,360327,2018-10-01T00:00:00
PERTH,2018,11,168215,169049,337264,2018-11-01T00:00:00
PERTH,2018,12,187566,230291,417857,2018-12-01T00:00:00
PERTH,2019,1,230405,191656,422061,2019-01-01T00:00:00
PERTH,2019,2,177469,147449,324918,2019-02-01T00:00:00
PERTH,2019,3,163843,169358,333201,2019-03-01T00:00:00
PERTH,2019,4,171753,185698,357451,2019-04-01T00:00:00
PERTH,2019,5,158107,163144,321251,2019-05-01T00:00:00
PERTH,2019,6,155018,180664,335682,2019-06-01T00:00:00
PERTH,2019,7,203301,180135,383436,2019-07-01T00:00:00
PERTH,2019,8,180370,178650,359020,2019-08-01T00:00:00
PERTH,2019,9,180961,185024,365985,2019-09-01T00:00:00
PERTH,2019,10,205797,171561,377358,2019-10-01T00:00:00
PERTH,2019,11,180935,176849,357784,2019-11-01T00:00:00
PERTH,2019,12,190795,234238,425033,2019-12-01T00:00:00
PERTH,2020,1,238157,204575,442732,2020-01-01T00:00:00
PERTH,2020,2,169482,135267,304749,2020-02-01T00:00:00
PERTH,2020,3,93680,84820,178500,2020-03-01T00:00:00
PERTH,2020,4,1696,5422,7118,2020-04-01T00:00:00
PERTH,2020,5,1141,2285,3426,2020-05-01T00:00:00
PERTH,2020,6,1652,2469,4121,2020-06-01T00:00:00
PERTH,2020,7,2702,3866,6568,2020-07-01T00:00:00
PERTH,2020,8,2038,4142,6180,2020-08-01T00:00:00
PERTH,2020,9,2038,2786,4824,2020-09-01T00:00:00
PERTH,2020,10,3497,3203,6700,2020-10-01T00:00:00
PERTH,2020,11,3648,2905,6553,2020-11-01T00:00:00
PERTH,2020,12,4096,3393,7489,2020-12-01T00:00:00
PERTH,2021,1,2997,2688,5685,2021-01-01T00:00:00
PERTH,2021,2,2249,2109,4358,2021-02-01T00:00:00
PERTH,2021,3,3573,2357,5930,2021-03-01T00:00:00
PERTH,2021,4,4569,3900,8469,2021-04-01T00:00:00
PERTH,2021,5,5451,6428,11879,2021-05-01T00:00:00
PERTH,2021,6,6887,6448,13335,2021-06-01T00:00:00
PERTH,2021,7,6570,7980,14550,2021-07-01T00:00:00
PERTH,2021,8,2894,2954,5848,2021-08-01T00:00:00
PERTH,2021,9,1316,2728,4044,2021-09-01T00:00:00
PERTH,2021,10,1436,3048,4484,2021-10-01T00:00:00
PERTH,2021,11,1295,4178,5473,2021-11-01T00:00:00
PERTH,2021,12,1660,4936,6596,2021-12-01T00:00:00
PERTH,2022,1,916,5815,6731,2022-01-01T00:00:00
PERTH,2022,2,1334,6318,7652,2022-02-01T00:00:00
PERTH,2022,3,26166,19622,45788,2022-03-01T00:00:00
PERTH,2022,4,49607,50958,100565,2022-04-01T00:00:00
PERTH,2022,5,56675,62118,118793,2022-05-01T00:00:00
PERTH,2022,6,71995,88871,160866,2022-06-01T00:00:00
PERTH,2022,7,106979,99663,206642,2022-07-01T00:00:00
PERTH,2022,8,108969,97490,206459,2022-08-01T00:00:00
PERTH,2022,9,115510,109928,225438,2022-09-01T00:00:00
PERTH,2022,10,128126,104582,232708,2022-10-01T00:00:00
PERTH,2022,11,131657,129121,260778,2022-11-01T00:00:00
PERTH,2022,12,132960,165623,298583,2022-12-01T00:00:00
PERTH,2023,1,177450,145653,323103,2023-01-01T00:00:00
PERTH,2023,2,156832,116727,273559,2023-02-01T00:00:00
PERTH,2023,3,151270,150223,301493,2023-03-01T00:00:00
PERTH,2023,4,146858,155633,302491,2023-04-01T00:00:00
PERTH,2023,5,142937,152065,295002,2023-05-01T00:00:00
PERTH,2023,6,144937,167385,312322,2023-06-01T00:00:00
PERTH,2023,7,180536,159180,339716,2023-07-01T00:00:00
PERTH,2023,8,172116,161123,333239,2023-08-01T00:00:00
PERTH,2023,9,172558,172998,345556,2023-09-01T00:00:00
PERTH,2023,10,186428,154767,341195,2023-10-01T00:00:00
PERTH,2023,11,168455,169862,338317,2023-11-01T00:00:00
PERTH,2023,12,170872,208971,379843,2023-12-01T00:00:00
PERTH,2024,1,223269,182147,405416,2024-01-01T00:00:00
PERTH,2024,2,189649,159940,349589,2024-02-01T00:00:00
PERTH,2024,3,176149,191162,367311,2024-03-01T00:00:00
PERTH,2024,4,188116,182632,370748,2024-04-01T00:00:00
PERTH,2024,5,170679,186609,357288,2024-05-01T00:00:00
PERTH,2024,6,183043,219045,402088,2024-06-01T00:00:00
PERTH,2024,7,233759,189965,423724,2024-07-01T00:00:00
PERTH,2024,8,198859,197349,396208,2024-08-01T00:00:00
PERTH,2024,9,213763,219710,433473,2024-09-01T00:00:00
PERTH,2024,10,234066,189287,423353,2024-10-01T00:00:00
PERTH,2024,11,197747,203555,401302,2024-11-01T00:00:00
PERTH,2024,12,202524,266002,468526,2024-12-01T00:00:00
PERTH,2025,1,280543,228726,509269,2025-01-01T00:00:00
PERTH,2025,2,221141,177760,398901,2025-02-01T00:00:00
PERTH,2025,3,200335,191990,392325,2025-03-01T00:00:00
PERTH,2025,4,210300,234811,445111,2025-04-01T00:00:00
PERTH,2025,5,201195,206834,408029,2025-05-01T00:00:00
PERTH,2025,6,200712,229257,429969,2025-06-01T00:00:00
PROSERPINE,2009,1,0,0,0,2009-01-01T00:00:00
PROSERPINE,2009,2,0,0,0,2009-02-01T00:00:00
PROSERPINE,2009,3,0,0,0,2009-03-01T00:00:00
PROSERPINE,2009,4,0,0,0,2009-04-01T00:00:00
PROSERPINE,2009,5,0,0,0,2009-05-01T00:00:00
PROSERPINE,2009,6,0,0,0,2009-06-01T00:00:00
PROSERPINE,2009,7,0,0,0,2009-07-01T00:00:00
PROSERPINE,2009,8,0,0,0,2009-08-01T00:00:00
PROSERPINE,2009,9,0,0,0,2009-09-01T00:00:00
PROSERPINE,2009,10,0,0,0,2009-10-01T00:00:00
PROSERPINE,2009,11,0,0,0,2009-11-01T00:00:00
PROSERPINE,2009,12,0,0,0,2009-12-01T00:00:00
PROSERPINE,2010,1,0,0,0,2010-01-01T00:00:00
PROSERPINE,2010,2,0,0,0,2010-02-01T00:00:00
PROSERPINE,2010,3,0,0,0,2010-03-01T00:00:00
PROSERPINE,2010,4,0,0,0,2010-04-01T00:00:00
PROSERPINE,2010,5,0,0,0,2010-05-01T00:00:00
PROSERPINE,2010,6,0,0,0,2010-06-01T00:00:00
PROSERPINE,2010,7,0,0,0,2010-07-01T00:00:00
PROSERPINE,2010,8,0,0,0,2010-08-01T00:00:00
PROSERPINE,2010,9,0,0,0,2010-09-01T00:00:00
PROSERPINE,2010,10,0,0,0,2010-10-01T00:00:00
PROSERPINE,2010,11,0,0,0,2010-11-01T00:00:00
PROSERPINE,2010,12,0,0,0,2010-12-01T00:00:00
PROSERPINE,2011,1,0,0,0,2011-01-01T00:00:00
PROSERPINE,2011,2,0,0,0,2011-02-01T00:00:00
PROSERPINE,2011,3,0,0,0,2011-03-01T00:00:00
PROSERPINE,2011,4,0,0,0,2011-04-01T00:00:00
PROSERPINE,2011,5,0,0,0,2011-05-01T00:00:00
PROSERPINE,2011,6,0,0,0,2011-06-01T00:00:00
PROSERPINE,2011,7,0,0,0,2011-07-01T00:00:00
PROSERPINE,2011,8,0,0,0,2011-08-01T00:00:00
PROSERPINE,2011,9,0,0,0,2011-09-01T00:00:00
PROSERPINE,2011,10,0,0,0,2011-10-01T00:00:00
PROSERPINE,2011,11,0,0,0,2011-11-01T00:00:00
PROSERPINE,2011,12,0,0,0,2011-12-01T00:00:00
PROSERPINE,2012,1,0,0,0,2012-01-01T00:00:00
PROSERPINE,2012,2,0,0,0,2012-02-01T00:00:00
PROSERPINE,2012,3,0,0,0,2012-03-01T00:00:00
PROSERPINE,2012,4,0,0,0,2012-04-01T00:00:00
PROSERPINE,2012,5,0,0,0,2012-05-01T00:00:00
PROSERPINE,2012,6,0,0,0,2012-06-01T00:00:00
PROSERPINE,2012,7,0,0,0,2012-07-01T00:00:00
PROSERPINE,2012,8,0,0,0,2012-08-01T00:00:00
PROSERPINE,2012,9,0,0,0,2012-09-01T00:00:00
PROSERPINE,2012,10,0,0,0,2012-10-01T00:00:00
PROSERPINE,2012,11,0,0,0,2012-11-01T00:00:00
PROSERPINE,2012,12,0,0,0,2012-12-01T00:00:00
PROSERPINE,2013,1,0,0,0,2013-01-01T00:00:00
PROSERPINE,2013,2,0,0,0,2013-02-01T00:00:00
PROSERPINE,2013,3,0,0,0,2013-03-01T00:00:00
PROSERPINE,2013,4,0,0,0,2013-04-01T00:00:00
PROSERPINE,2013,5,0,0,0,2013-05-01T00:00:00
PROSERPINE,2013,6,0,0,0,2013-06-01T00:00:00
PROSERPINE,2013,7,0,0,0,2013-07-01T00:00:00
PROSERPINE,2013,8,0,0,0,2013-08-01T00:00:00
PROSERPINE,2013,9,0,0,0,2013-09-01T00:00:00
PROSERPINE,2013,10,0,0,0,2013-10-01T00:00:00
PROSERPINE,2013,11,0,0,0,2013-11-01T00:00:00
PROSERPINE,2013,12,0,0,0,2013-12-01T00:00:00
PROSERPINE,2014,1,0,0,0,2014-01-01T00:00:00
PROSERPINE,2014,2,0,0,0,2014-02-01T00:00:00
PROSERPINE,2014,3,0,0,0,2014-03-01T00:00:00
PROSERPINE,2014,4,0,0,0,2014-04-01T00:00:00
PROSERPINE,2014,5,0,0,0,2014-05-01T00:00:00
PROSERPINE,2014,6,0,0,0,2014-06-01T00:00:00
PROSERPINE,2014,7,0,0,0,2014-07-01T00:00:00
PROSERPINE,2014,8,0,0,0,2014-08-01T00:00:00
PROSERPINE,2014,9,0,0,0,2014-09-01T00:00:00
PROSERPINE,2014,10,0,0,0,2014-10-01T00:00:00
PROSERPINE,2014,11,0,0,0,2014-11-01T00:00:00
PROSERPINE,2014,12,0,0,0,2014-12-01T00:00:00
PROSERPINE,2015,1,0,0,0,2015-01-01T00:00:00
PROSERPINE,2015,2,0,0,0,2015-02-01T00:00:00
PROSERPINE,2015,3,0,0,0,2015-03-01T00:00:00
PROSERPINE,2015,4,0,0,0,2015-04-01T00:00:00
PROSERPINE,2015,5,0,0,0,2015-05-01T00:00:00
PROSERPINE,2015,6,0,0,0,2015-06-01T00:00:00
PROSERPINE,2015,7,0,0,0,2015-07-01T00:00:00
PROSERPINE,2015,8,0,0,0,2015-08-01T00:00:00
PROSERPINE,2015,9,0,0,0,2015-09-01T00:00:00
PROSERPINE,2015,10,0,0,0,2015-10-01T00:00:00
PROSERPINE,2015,11,0,0,0,2015-11-01T00:00:00
PROSERPINE,2015,12,0,0,0,2015-12-01T00:00:00
PROSERPINE,2016,1,0,0,0,2016-01-01T00:00:00
PROSERPINE,2016,2,0,0,0,2016-02-01T00:00:00
PROSERPINE,2016,3,0,0,0,2016-03-01T00:00:00
PROSERPINE,2016,4,0,0,0,2016-04-01T00:00:00
PROSERPINE,2016,5,0,0,0,2016-05-01T00:00:00
PROSERPINE,2016,6,0,0,0,2016-06-01T00:00:00
PROSERPINE,2016,7,0,0,0,2016-07-01T00:00:00
PROSERPINE,2016,8,0,0,0,2016-08-01T00:00:00
PROSERPINE,2016,9,0,0,0,2016-09-01T00:00:00
PROSERPINE,2016,10,0,0,0,2016-10-01T00:00:00
PROSERPINE,2016,11,0,0,0,2016-11-01T00:00:00
PROSERPINE,2016,12,0,0,0,2016-12-01T00:00:00
PROSERPINE,2017,1,0,0,0,2017-01-01T00:00:00
PROSERPINE,2017,2,0,0,0,2017-02-01T00:00:00
PROSERPINE,2017,3,0,0,0,2017-03-01T00:00:00
PROSERPINE,2017,4,0,0,0,2017-04-01T00:00:00
PROSERPINE,2017,5,0,0,0,2017-05-01T00:00:00
PROSERPINE,2017,6,0,0,0,2017-06-01T00:00:00
PROSERPINE,2017,7,0,0,0,2017-07-01T00:00:00
PROSERPINE,2017,8,0,0,0,2017-08-01T00:00:00
PROSERPINE,2017,9,0,0,0,2017-09-01T00:00:00
PROSERPINE,2017,10,0,0,0,2017-10-01T00:00:00
PROSERPINE,2017,11,0,0,0,2017-11-01T00:00:00
PROSERPINE,2017,12,0,0,0,2017-12-01T00:00:00
PROSERPINE,2018,1,0,0,0,2018-01-01T00:00:00
PROSERPINE,2018,2,0,0,0,2018-02-01T00:00:00
PROSERPINE,2018,3,0,0,0,2018-03-01T00:00:00
PROSERPINE,2018,4,0,0,0,2018-04-01T00:00:00
PROSERPINE,2018,5,0,0,0,2018-05-01T00:00:00
PROSERPINE,2018,6,0,0,0,2018-06-01T00:00:00
PROSERPINE,2018,7,0,0,0,2018-07-01T00:00:00
PROSERPINE,2018,8,0,0,0,2018-08-01T00:00:00
PROSERPINE,2018,9,0,0,0,2018-09-01T00:00:00
PROSERPINE,2018,10,0,0,0,2018-10-01T00:00:00
PROSERPINE,2018,11,0,0,0,2018-11-01T00:00:00
PROSERPINE,2018,12,0,0,0,2018-12-01T00:00:00
PROSERPINE,2019,1,0,0,0,2019-01-01T00:00:00
PROSERPINE,2019,2,0,0,0,2019-02-01T00:00:00
PROSERPINE,2019,3,0,0,0,2019-03-01T00:00:00
PROSERPINE,2019,4,0,0,0,2019-04-01T00:00:00
PROSERPINE,2019,5,0,0,0,2019-05-01T00:00:00
PROSERPINE,2019,6,0,0,0,2019-06-01T00:00:00
PROSERPINE,2019,7,0,0,0,2019-07-01T00:00:00
PROSERPINE,2019,8,0,0,0,2019-08-01T00:00:00
PROSERPINE,2019,9,0,0,0,2019-09-01T00:00:00
PROSERPINE,2019,10,0,0,0,2019-10-01T00:00:00
PROSERPINE,2019,11,0,0,0,2019-11-01T00:00:00
PROSERPINE,2019,12,0,0,0,2019-12-01T00:00:00
PROSERPINE,2020,1,0,0,0,2020-01-01T00:00:00
PROSERPINE,2020,2,0,0,0,2020-02-01T00:00:00
PROSERPINE,2020,3,0,0,0,2020-03-01T00:00:00
PROSERPINE,2020,4,0,0,0,2020-04-01T00:00:00
PROSERPINE,2020,5,0,0,0,2020-05-01T00:00:00
PROSERPINE,2020,6,0,0,0,2020-06-01T00:00:00
PROSERPINE,2020,7,0,0,0,2020-07-01T00:00:00
PROSERPINE,2020,8,0,0,0,2020-08-01T00:00:00
PROSERPINE,2020,9,0,0,0,2020-09-01T00:00:00
PROSERPINE,2020,10,0,0,0,2020-10-01T00:00:00
PROSERPINE,2020,11,0,0,0,2020-11-01T00:00:00
PROSERPINE,2020,12,0,0,0,2020-12-01T00:00:00
PROSERPINE,2021,1,0,0,0,2021-01-01T00:00:00
PROSERPINE,2021,2,0,0,0,2021-02-01T00:00:00
PROSERPINE,2021,3,0,0,0,2021-03-01T00:00:00
PROSERPINE,2021,4,0,0,0,2021-04-01T00:00:00
PROSERPINE,2021,5,0,0,0,2021-05-01T00:00:00
PROSERPINE,2021,6,0,0,0,2021-06-01T00:00:00
PROSERPINE,2021,7,0,0,0,2021-07-01T00:00:00
PROSERPINE,2021,8,0,0,0,2021-08-01T00:00:00
PROSERPINE,2021,9,0,0,0,2021-09-01T00:00:00
PROSERPINE,2021,10,0,0,0,2021-10-01T00:00:00
PROSERPINE,2021,11,0,0,0,2021-11-01T00:00:00
PROSERPINE,2021,12,0,0,0,2021-12-01T00:00:00
PROSERPINE,2022,1,0,0,0,2022-01-01T00:00:00
PROSERPINE,2022,2,0,0,0,2022-02-01T00:00:00
PROSERPINE,2022,3,0,0,0,2022-03-01T00:00:00
PROSERPINE,2022,4,0,0,0,2022-04-01T00:00:00
PROSERPINE,2022,5,0,0,0,2022-05-01T00:00:00
PROSERPINE,2022,6,0,0,0,2022-06-01T00:00:00
PROSERPINE,2022,7,0,0,0,2022-07-01T00:00:00
PROSERPINE,2022,8,0,0,0,2022-08-01T00:00:00
PROSERPINE,2022,9,0,0,0,2022-09-01T00:00:00
PROSERPINE,2022,10,0,0,0,2022-10-01T00:00:00
PROSERPINE,2022,11,0,0,0,2022-11-01T00:00:00
PROSERPINE,2022,12,0,0,0,2022-12-01T00:00:00
PROSERPINE,2023,1,0,0,0,2023-01-01T00:00:00
PROSERPINE,2023,2,0,0,0,2023-02-01T00:00:00
PROSERPINE,2023,3,0,0,0,2023-03-01T00:00:00
PROSERPINE,2023,4,0,0,0,2023-04-01T00:00:00
PROSERPINE,2023,5,0,0,0,2023-05-01T00:00:00
PROSERPINE,2023,6,0,0,0,2023-06-01T00:00:00
PROSERPINE,2023,7,0,0,0,2023-07-01T00:00:00
PROSERPINE,2023,8,0,0,0,2023-08-01T00:00:00
PROSERPINE,2023,9,0,0,0,2023-09-01T00:00:00
PROSERPINE,2023,10,0,0,0,2023-10-01T00:00:00
PROSERPINE,2023,11,0,0,0,2023-11-01T00:00:00
PROSERPINE,2023,12,0,0,0,2023-12-01T00:00:00
PROSERPINE,2024,1,0,0,0,2024-01-01T00:00:00
PROSERPINE,2024,2,0,0,0,2024-02-01T00:00:00
PROSERPINE,2024,3,0,0,0,2024-03-01T00:00:00
PROSERPINE,2024,4,0,0,0,2024-04-01T00:00:00
PROSERPINE,2024,5,0,0,0,2024-05-01T00:00:00
PROSERPINE,2024,6,0,0,0,2024-06-01T00:00:00
PROSERPINE,2024,7,0,0,0,2024-07-01T00:00:00
PROSERPINE,2024,8,0,0,0,2024-08-01T00:00:00
PROSERPINE,2024,9,0,0,0,2024-09-01T00:00:00
PROSERPINE,2024,10,0,0,0,2024-10-01T00:00:00
PROSERPINE,2024,11,0,0,0,2024-11-01T00:00:00
PROSERPINE,2024,12,0,0,0,2024-12-01T00:00:00
PROSERPINE,2025,1,0,0,0,2025-01-01T00:00:00
PROSERPINE,2025,2,0,0,0,2025-02-01T00:00:00
PROSERPINE,2025,3,0,0,0,2025-03-01T00:00:00
PROSERPINE,2025,4,0,0,0,2025-04-01T00:00:00
PROSERPINE,2025,5,0,0,0,2025-05-01T00:00:00
PROSERPINE,2025,6,0,0,0,2025-06-01T00:00:00
ROCKHAMPTON,1985,1,0,0,0,1985-01-01T00:00:00
ROCKHAMPTON,1985,2,0,0,0,1985-02-01T00:00:00
ROCKHAMPTON,1985,3,0,0,0,1985-03-01T00:00:00
ROCKHAMPTON,1985,4,0,0,0,1985-04-01T00:00:00
ROCKHAMPTON,1985,5,0,0,0,1985-05-01T00:00:00
ROCKHAMPTON,1985,6,0,0,0,1985-06-01T00:00:00
ROCKHAMPTON,1985,7,0,0,0,1985-07-01T00:00:00
ROCKHAMPTON,1985,8,0,0,0,1985-08-01T00:00:00
ROCKHAMPTON,1985,9,0,0,0,1985-09-01T00:00:00
ROCKHAMPTON,1985,10,0,0,0,1985-10-01T00:00:00
ROCKHAMPTON,1985,11,0,0,0,1985-11-01T00:00:00
ROCKHAMPTON,1985,12,0,0,0,1985-12-01T00:00:00
ROCKHAMPTON,1986,1,0,0,0,1986-01-01T00:00:00
ROCKHAMPTON,1986,2,0,0,0,1986-02-01T00:00:00
ROCKHAMPTON,1986,3,0,0,0,1986-03-01T00:00:00
ROCKHAMPTON,1986,4,0,0,0,1986-04-01T00:00:00
ROCKHAMPTON,1986,5,0,0,0,1986-05-01T00:00:00
ROCKHAMPTON,1986,6,0,0,0,1986-06-01T00:00:00
ROCKHAMPTON,1986,7,0,0,0,1986-07-01T00:00:00
ROCKHAMPTON,1986,8,0,0,0,1986-08-01T00:00:00
ROCKHAMPTON,1986,9,0,0,0,1986-09-01T00:00:00
ROCKHAMPTON,1986,10,0,0,0,1986-10-01T00:00:00
ROCKHAMPTON,1986,11,0,0,0,1986-11-01T00:00:00
ROCKHAMPTON,1986,12,0,0,0,1986-12-01T00:00:00
ROCKHAMPTON,1987,1,0,0,0,1987-01-01T00:00:00
ROCKHAMPTON,1987,2,0,0,0,1987-02-01T00:00:00
ROCKHAMPTON,1987,3,0,0,0,1987-03-01T00:00:00
ROCKHAMPTON,1987,4,0,0,0,1987-04-01T00:00:00
ROCKHAMPTON,1987,5,0,0,0,1987-05-01T00:00:00
ROCKHAMPTON,1987,6,0,0,0,1987-06-01T00:00:00
ROCKHAMPTON,1987,7,0,0,0,1987-07-01T00:00:00
ROCKHAMPTON,1987,8,0,0,0,1987-08-01T00:00:00
ROCKHAMPTON,1987,9,0,0,0,1987-09-01T00:00:00
ROCKHAMPTON,1987,10,0,0,0,1987-10-01T00:00:00
ROCKHAMPTON,1987,11,0,0,0,1987-11-01T00:00:00
ROCKHAMPTON,1987,12,0,0,0,1987-12-01T00:00:00
ROCKHAMPTON,1988,1,0,0,0,1988-01-01T00:00:00
ROCKHAMPTON,1988,2,0,0,0,1988-02-01T00:00:00
ROCKHAMPTON,1988,3,0,0,0,1988-03-01T00:00:00
ROCKHAMPTON,1988,4,0,0,0,1988-04-01T00:00:00
ROCKHAMPTON,1988,5,0,0,0,1988-05-01T00:00:00
ROCKHAMPTON,1988,6,0,0,0,1988-06-01T00:00:00
ROCKHAMPTON,1988,7,0,0,0,1988-07-01T00:00:00
ROCKHAMPTON,1988,8,0,0,0,1988-08-01T00:00:00
ROCKHAMPTON,1988,9,0,0,0,1988-09-01T00:00:00
ROCKHAMPTON,1988,10,0,0,0,1988-10-01T00:00:00
ROCKHAMPTON,1988,11,0,0,0,1988-11-01T00:00:00
ROCKHAMPTON,1988,12,0,0,0,1988-12-01T00:00:00
ROCKHAMPTON,1989,1,0,0,0,1989-01-01T00:00:00
ROCKHAMPTON,1989,2,0,0,0,1989-02-01T00:00:00
ROCKHAMPTON,1989,3,0,0,0,1989-03-01T00:00:00
ROCKHAMPTON,1989,4,0,0,0,1989-04-01T00:00:00
ROCKHAMPTON,1989,5,0,0,0,1989-05-01T00:00:00
ROCKHAMPTON,1989,6,0,0,0,1989-06-01T00:00:00
ROCKHAMPTON,1989,7,0,0,0,1989-07-01T00:00:00
ROCKHAMPTON,1989,8,0,0,0,1989-08-01T00:00:00
ROCKHAMPTON,1989,9,0,0,0,1989-09-01T00:00:00
ROCKHAMPTON,1989,10,0,0,0,1989-10-01T00:00:00
ROCKHAMPTON,1989,11,0,0,0,1989-11-01T00:00:00
ROCKHAMPTON,1989,12,0,0,0,1989-12-01T00:00:00
ROCKHAMPTON,1990,1,0,0,0,1990-01-01T00:00:00
ROCKHAMPTON,1990,2,0,0,0,1990-02-01T00:00:00
ROCKHAMPTON,1990,3,0,0,0,1990-03-01T00:00:00
ROCKHAMPTON,1990,4,0,0,0,1990-04-01T00:00:00
ROCKHAMPTON,1990,5,0,0,0,1990-05-01T00:00:00
ROCKHAMPTON,1990,6,0,0,0,1990-06-01T00:00:00
ROCKHAMPTON,1990,7,0,0,0,1990-07-01T00:00:00
ROCKHAMPTON,1990,8,0,0,0,1990-08-01T00:00:00
ROCKHAMPTON,1990,9,0,0,0,1990-09-01T00:00:00
ROCKHAMPTON,1990,10,0,0,0,1990-10-01T00:00:00
ROCKHAMPTON,1990,11,0,0,0,1990-11-01T00:00:00
ROCKHAMPTON,1990,12,0,0,0,1990-12-01T00:00:00
ROCKHAMPTON,1991,1,0,0,0,1991-01-01T00:00:00
ROCKHAMPTON,1991,2,0,0,0,1991-02-01T00:00:00
ROCKHAMPTON,1991,3,0,0,0,1991-03-01T00:00:00
ROCKHAMPTON,1991,4,0,0,0,1991-04-01T00:00:00
ROCKHAMPTON,1991,5,0,0,0,1991-05-01T00:00:00
ROCKHAMPTON,1991,6,0,0,0,1991-06-01T00:00:00
ROCKHAMPTON,1991,7,0,0,0,1991-07-01T00:00:00
ROCKHAMPTON,1991,8,0,0,0,1991-08-01T00:00:00
ROCKHAMPTON,1991,9,0,0,0,1991-09-01T00:00:00
ROCKHAMPTON,1991,10,0,0,0,1991-10-01T00:00:00
ROCKHAMPTON,1991,11,0,0,0,1991-11-01T00:00:00
ROCKHAMPTON,1991,12,0,0,0,1991-12-01T00:00:00
ROCKHAMPTON,1992,1,0,0,0,1992-01-01T00:00:00
ROCKHAMPTON,1992,2,0,0,0,1992-02-01T00:00:00
ROCKHAMPTON,1992,3,0,0,0,1992-03-01T00:00:00
ROCKHAMPTON,1992,4,0,0,0,1992-04-01T00:00:00
ROCKHAMPTON,1992,5,0,0,0,1992-05-01T00:00:00
ROCKHAMPTON,1992,6,0,0,0,1992-06-01T00:00:00
ROCKHAMPTON,1992,7,0,0,0,1992-07-01T00:00:00
ROCKHAMPTON,1992,8,0,0,0,1992-08-01T00:00:00
ROCKHAMPTON,1992,9,0,0,0,1992-09-01T00:00:00
ROCKHAMPTON,1992,10,0,0,0,1992-10-01T00:00:00
ROCKHAMPTON,1992,11,0,0,0,1992-11-01T00:00:00
ROCKHAMPTON,1992,12,0,0,0,1992-12-01T00:00:00
ROCKHAMPTON,1993,1,0,0,0,1993-01-01T00:00:00
ROCKHAMPTON,1993,2,0,0,0,1993-02-01T00:00:00
ROCKHAMPTON,1993,3,0,0,0,1993-03-01T00:00:00
ROCKHAMPTON,1993,4,0,0,0,1993-04-01T00:00:00
ROCKHAMPTON,1993,5,0,0,0,1993-05-01T00:00:00
ROCKHAMPTON,1993,6,0,0,0,1993-06-01T00:00:00
ROCKHAMPTON,1993,7,0,0,0,1993-07-01T00:00:00
ROCKHAMPTON,1993,8,0,0,0,1993-08-01T00:00:00
ROCKHAMPTON,1993,9,0,0,0,1993-09-01T00:00:00
ROCKHAMPTON,1993,10,0,0,0,1993-10-01T00:00:00
ROCKHAMPTON,1993,11,0,0,0,1993-11-01T00:00:00
ROCKHAMPTON,1993,12,0,0,0,1993-12-01T00:00:00
ROCKHAMPTON,1994,1,0,0,0,1994-01-01T00:00:00
ROCKHAMPTON,1994,2,0,0,0,1994-02-01T00:00:00
ROCKHAMPTON,1994,3,0,0,0,1994-03-01T00:00:00
ROCKHAMPTON,1994,4,0,0,0,1994-04-01T00:00:00
ROCKHAMPTON,1994,5,0,0,0,1994-05-01T00:00:00
ROCKHAMPTON,1994,6,0,0,0,1994-06-01T00:00:00
ROCKHAMPTON,1994,7,0,0,0,1994-07-01T00:00:00
ROCKHAMPTON,1994,8,0,0,0,1994-08-01T00:00:00
ROCKHAMPTON,1994,9,0,0,0,1994-09-01T00:00:00
ROCKHAMPTON,1994,10,0,0,0,1994-10-01T00:00:00
ROCKHAMPTON,1994,11,0,0,0,1994-11-01T00:00:00
ROCKHAMPTON,1994,12,0,0,0,1994-12-01T00:00:00
ROCKHAMPTON,1995,1,0,0,0,1995-01-01T00:00:00
ROCKHAMPTON,1995,2,0,0,0,1995-02-01T00:00:00
ROCKHAMPTON,1995,3,0,0,0,1995-03-01T00:00:00
ROCKHAMPTON,1995,4,0,0,0,1995-04-01T00:00:00
ROCKHAMPTON,1995,5,0,0,0,1995-05-01T00:00:00
ROCKHAMPTON,1995,6,0,0,0,1995-06-01T00:00:00
ROCKHAMPTON,1995,7,0,0,0,1995-07-01T00:00:00
ROCKHAMPTON,1995,8,0,0,0,1995-08-01T00:00:00
ROCKHAMPTON,1995,9,0,0,0,1995-09-01T00:00:00
ROCKHAMPTON,1995,10,0,0,0,1995-10-01T00:00:00
ROCKHAMPTON,1995,11,0,0,0,1995-11-01T00:00:00
ROCKHAMPTON,1995,12,0,0,0,1995-12-01T00:00:00
ROCKHAMPTON,1996,1,0,0,0,1996-01-01T00:00:00
ROCKHAMPTON,1996,2,0,0,0,1996-02-01T00:00:00
ROCKHAMPTON,1996,3,0,0,0,1996-03-01T00:00:00
ROCKHAMPTON,1996,4,0,0,0,1996-04-01T00:00:00
ROCKHAMPTON,1996,5,0,0,0,1996-05-01T00:00:00
ROCKHAMPTON,1996,6,0,0,0,1996-06-01T00:00:00
ROCKHAMPTON,1996,7,0,0,0,1996-07-01T00:00:00
ROCKHAMPTON,1996,8,0,0,0,1996-08-01T00:00:00
ROCKHAMPTON,1996,9,0,0,0,1996-09-01T00:00:00
ROCKHAMPTON,1996,10,0,0,0,1996-10-01T00:00:00
ROCKHAMPTON,1996,11,0,0,0,1996-11-01T00:00:00
ROCKHAMPTON,1996,12,0,0,0,1996-12-01T00:00:00
ROCKHAMPTON,1997,1,0,0,0,1997-01-01T00:00:00
ROCKHAMPTON,1997,2,0,0,0,1997-02-01T00:00:00
ROCKHAMPTON,1997,3,0,0,0,1997-03-01T00:00:00
ROCKHAMPTON,1997,4,0,0,0,1997-04-01T00:00:00
ROCKHAMPTON,1997,5,0,0,0,1997-05-01T00:00:00
ROCKHAMPTON,1997,6,0,0,0,1997-06-01T00:00:00
ROCKHAMPTON,1997,7,0,0,0,1997-07-01T00:00:00
ROCKHAMPTON,1997,8,0,0,0,1997-08-01T00:00:00
ROCKHAMPTON,1997,9,0,0,0,1997-09-01T00:00:00
ROCKHAMPTON,1997,10,0,0,0,1997-10-01T00:00:00
ROCKHAMPTON,1997,11,0,0,0,1997-11-01T00:00:00
ROCKHAMPTON,1997,12,0,0,0,1997-12-01T00:00:00
ROCKHAMPTON,1998,1,0,0,0,1998-01-01T00:00:00
ROCKHAMPTON,1998,2,0,0,0,1998-02-01T00:00:00
ROCKHAMPTON,1998,3,0,0,0,1998-03-01T00:00:00
ROCKHAMPTON,1998,4,0,0,0,1998-04-01T00:00:00
ROCKHAMPTON,1998,5,0,0,0,1998-05-01T00:00:00
ROCKHAMPTON,1998,6,0,0,0,1998-06-01T00:00:00
ROCKHAMPTON,1998,7,0,0,0,1998-07-01T00:00:00
ROCKHAMPTON,1998,8,0,0,0,1998-08-01T00:00:00
ROCKHAMPTON,1998,9,0,0,0,1998-09-01T00:00:00
ROCKHAMPTON,1998,10,0,0,0,1998-10-01T00:00:00
ROCKHAMPTON,1998,11,0,0,0,1998-11-01T00:00:00
ROCKHAMPTON,1998,12,0,0,0,1998-12-01T00:00:00
ROCKHAMPTON,1999,1,0,0,0,1999-01-01T00:00:00
ROCKHAMPTON,1999,2,0,0,0,1999-02-01T00:00:00
ROCKHAMPTON,1999,3,0,0,0,1999-03-01T00:00:00
ROCKHAMPTON,1999,4,0,0,0,1999-04-01T00:00:00
ROCKHAMPTON,1999,5,0,0,0,1999-05-01T00:00:00
ROCKHAMPTON,1999,6,0,0,0,1999-06-01T00:00:00
ROCKHAMPTON,1999,7,0,0,0,1999-07-01T00:00:00
ROCKHAMPTON,1999,8,0,0,0,1999-08-01T00:00:00
ROCKHAMPTON,1999,9,0,0,0,1999-09-01T00:00:00
ROCKHAMPTON,1999,10,0,0,0,1999-10-01T00:00:00
ROCKHAMPTON,1999,11,0,0,0,1999-11-01T00:00:00
ROCKHAMPTON,1999,12,0,0,0,1999-12-01T00:00:00
ROCKHAMPTON,2000,1,0,0,0,2000-01-01T00:00:00
ROCKHAMPTON,2000,2,0,0,0,2000-02-01T00:00:00
ROCKHAMPTON,2000,3,0,0,0,2000-03-01T00:00:00
ROCKHAMPTON,2000,4,0,0,0,2000-04-01T00:00:00
ROCKHAMPTON,2000,5,0,0,0,2000-05-01T00:00:00
ROCKHAMPTON,2000,6,0,0,0,2000-06-01T00:00:00
ROCKHAMPTON,2000,7,0,0,0,2000-07-01T00:00:00
ROCKHAMPTON,2000,8,0,0,0,2000-08-01T00:00:00
ROCKHAMPTON,2000,9,0,0,0,2000-09-01T00:00:00
ROCKHAMPTON,2000,10,0,0,0,2000-10-01T00:00:00
ROCKHAMPTON,2000,11,0,0,0,2000-11-01T00:00:00
ROCKHAMPTON,2000,12,0,0,0,2000-12-01T00:00:00
ROCKHAMPTON,2001,1,0,0,0,2001-01-01T00:00:00
ROCKHAMPTON,2001,2,0,0,0,2001-02-01T00:00:00
ROCKHAMPTON,2001,3,0,0,0,2001-03-01T00:00:00
ROCKHAMPTON,2001,4,0,0,0,2001-04-01T00:00:00
ROCKHAMPTON,2001,5,0,0,0,2001-05-01T00:00:00
ROCKHAMPTON,2001,6,0,0,0,2001-06-01T00:00:00
ROCKHAMPTON,2001,7,0,0,0,2001-07-01T00:00:00
ROCKHAMPTON,2001,8,0,0,0,2001-08-01T00:00:00
ROCKHAMPTON,2001,9,0,0,0,2001-09-01T00:00:00
ROCKHAMPTON,2001,10,0,0,0,2001-10-01T00:00:00
ROCKHAMPTON,2001,11,0,0,0,2001-11-01T00:00:00
ROCKHAMPTON,2001,12,0,0,0,2001-12-01T00:00:00
ROCKHAMPTON,2002,1,0,0,0,2002-01-01T00:00:00
ROCKHAMPTON,2002,2,0,0,0,2002-02-01T00:00:00
ROCKHAMPTON,2002,3,0,0,0,2002-03-01T00:00:00
ROCKHAMPTON,2002,4,0,0,0,2002-04-01T00:00:00
ROCKHAMPTON,2002,5,0,0,0,2002-05-01T00:00:00
ROCKHAMPTON,2002,6,0,0,0,2002-06-01T00:00:00
ROCKHAMPTON,2002,7,0,0,0,2002-07-01T00:00:00
ROCKHAMPTON,2002,8,0,0,0,2002-08-01T00:00:00
ROCKHAMPTON,2002,9,0,0,0,2002-09-01T00:00:00
ROCKHAMPTON,2002,10,0,0,0,2002-10-01T00:00:00
ROCKHAMPTON,2002,11,0,0,0,2002-11-01T00:00:00
ROCKHAMPTON,2002,12,0,0,0,2002-12-01T00:00:00
ROCKHAMPTON,2003,1,0,0,0,2003-01-01T00:00:00
ROCKHAMPTON,2003,2,0,0,0,2003-02-01T00:00:00
ROCKHAMPTON,2003,3,0,0,0,2003-03-01T00:00:00
ROCKHAMPTON,2003,4,0,0,0,2003-04-01T00:00:00
ROCKHAMPTON,2003,5,0,0,0,2003-05-01T00:00:00
ROCKHAMPTON,2003,6,0,0,0,2003-06-01T00:00:00
ROCKHAMPTON,2003,7,0,0,0,2003-07-01T00:00:00
ROCKHAMPTON,2003,8,0,0,0,2003-08-01T00:00:00
ROCKHAMPTON,2003,9,0,0,0,2003-09-01T00:00:00
ROCKHAMPTON,2003,10,0,0,0,2003-10-01T00:00:00
ROCKHAMPTON,2003,11,0,0,0,2003-11-01T00:00:00
ROCKHAMPTON,2003,12,0,0,0,2003-12-01T00:00:00
ROCKHAMPTON,2004,1,0,0,0,2004-01-01T00:00:00
ROCKHAMPTON,2004,2,0,0,0,2004-02-01T00:00:00
ROCKHAMPTON,2004,3,0,0,0,2004-03-01T00:00:00
ROCKHAMPTON,2004,4,0,0,0,2004-04-01T00:00:00
ROCKHAMPTON,2004,5,0,0,0,2004-05-01T00:00:00
ROCKHAMPTON,2004,6,0,0,0,2004-06-01T00:00:00
ROCKHAMPTON,2004,7,0,0,0,2004-07-01T00:00:00
ROCKHAMPTON,2004,8,0,0,0,2004-08-01T00:00:00
ROCKHAMPTON,2004,9,0,0,0,2004-09-01T00:00:00
ROCKHAMPTON,2004,10,0,0,0,2004-10-01T00:00:00
ROCKHAMPTON,2004,11,0,0,0,2004-11-01T00:00:00
ROCKHAMPTON,2004,12,0,0,0,2004-12-01T00:00:00
ROCKHAMPTON,2005,1,0,0,0,2005-01-01T00:00:00
ROCKHAMPTON,2005,2,0,0,0,2005-02-01T00:00:00
ROCKHAMPTON,2005,3,0,0,0,2005-03-01T00:00:00
ROCKHAMPTON,2005,4,0,0,0,2005-04-01T00:00:00
ROCKHAMPTON,2005,5,0,0,0,2005-05-01T00:00:00
ROCKHAMPTON,2005,6,0,0,0,2005-06-01T00:00:00
ROCKHAMPTON,2005,7,0,0,0,2005-07-01T00:00:00
ROCKHAMPTON,2005,8,0,0,0,2005-08-01T00:00:00
ROCKHAMPTON,2005,9,0,0,0,2005-09-01T00:00:00
ROCKHAMPTON,2005,10,0,0,0,2005-10-01T00:00:00
ROCKHAMPTON,2005,11,0,0,0,2005-11-01T00:00:00
ROCKHAMPTON,2005,12,0,0,0,2005-12-01T00:00:00
ROCKHAMPTON,2006,1,0,0,0,2006-01-01T00:00:00
ROCKHAMPTON,2006,2,0,0,0,2006-02-01T00:00:00
ROCKHAMPTON,2006,3,0,0,0,2006-03-01T00:00:00
ROCKHAMPTON,2006,4,0,0,0,2006-04-01T00:00:00
ROCKHAMPTON,2006,5,0,0,0,2006-05-01T00:00:00
ROCKHAMPTON,2006,6,0,0,0,2006-06-01T00:00:00
ROCKHAMPTON,2006,7,0,0,0,2006-07-01T00:00:00
ROCKHAMPTON,2006,8,0,0,0,2006-08-01T00:00:00
ROCKHAMPTON,2006,9,0,0,0,2006-09-01T00:00:00
ROCKHAMPTON,2006,10,0,0,0,2006-10-01T00:00:00
ROCKHAMPTON,2006,11,0,0,0,2006-11-01T00:00:00
ROCKHAMPTON,2006,12,0,0,0,2006-12-01T00:00:00
ROCKHAMPTON,2007,1,0,0,0,2007-01-01T00:00:00
ROCKHAMPTON,2007,2,0,0,0,2007-02-01T00:00:00
ROCKHAMPTON,2007,3,0,0,0,2007-03-01T00:00:00
ROCKHAMPTON,2007,4,0,0,0,2007-04-01T00:00:00
ROCKHAMPTON,2007,5,0,0,0,2007-05-01T00:00:00
ROCKHAMPTON,2007,6,0,0,0,2007-06-01T00:00:00
ROCKHAMPTON,2007,7,0,0,0,2007-07-01T00:00:00
ROCKHAMPTON,2007,8,0,0,0,2007-08-01T00:00:00
ROCKHAMPTON,2007,9,0,0,0,2007-09-01T00:00:00
ROCKHAMPTON,2007,10,0,0,0,2007-10-01T00:00:00
ROCKHAMPTON,2007,11,0,0,0,2007-11-01T00:00:00
ROCKHAMPTON,2007,12,0,0,0,2007-12-01T00:00:00
ROCKHAMPTON,2008,1,0,0,0,2008-01-01T00:00:00
ROCKHAMPTON,2008,2,0,0,0,2008-02-01T00:00:00
ROCKHAMPTON,2008,3,0,0,0,2008-03-01T00:00:00
ROCKHAMPTON,2008,4,0,0,0,2008-04-01T00:00:00
ROCKHAMPTON,2008,5,0,0,0,2008-05-01T00:00:00
ROCKHAMPTON,2008,6,0,0,0,2008-06-01T00:00:00
ROCKHAMPTON,2008,7,0,0,0,2008-07-01T00:00:00
ROCKHAMPTON,2008,8,0,0,0,2008-08-01T00:00:00
ROCKHAMPTON,2008,9,0,0,0,2008-09-01T00:00:00
ROCKHAMPTON,2008,10,0,0,0,2008-10-01T00:00:00
ROCKHAMPTON,2008,11,0,0,0,2008-11-01T00:00:00
ROCKHAMPTON,2008,12,0,0,0,2008-12-01T00:00:00
ROCKHAMPTON,2009,1,0,0,0,2009-01-01T00:00:00
ROCKHAMPTON,2009,2,0,0,0,2009-02-01T00:00:00
ROCKHAMPTON,2009,3,0,0,0,2009-03-01T00:00:00
ROCKHAMPTON,2009,4,0,0,0,2009-04-01T00:00:00
ROCKHAMPTON,2009,5,0,0,0,2009-05-01T00:00:00
ROCKHAMPTON,2009,6,0,0,0,2009-06-01T00:00:00
ROCKHAMPTON,2009,7,0,0,0,2009-07-01T00:00:00
ROCKHAMPTON,2009,8,0,0,0,2009-08-01T00:00:00
ROCKHAMPTON,2009,9,0,0,0,2009-09-01T00:00:00
ROCKHAMPTON,2009,10,0,0,0,2009-10-01T00:00:00
ROCKHAMPTON,2009,11,0,0,0,2009-11-01T00:00:00
ROCKHAMPTON,2009,12,0,0,0,2009-12-01T00:00:00
ROCKHAMPTON,2010,1,0,0,0,2010-01-01T00:00:00
ROCKHAMPTON,2010,2,0,0,0,2010-02-01T00:00:00
ROCKHAMPTON,2010,3,0,0,0,2010-03-01T00:00:00
ROCKHAMPTON,2010,4,0,0,0,2010-04-01T00:00:00
ROCKHAMPTON,2010,5,0,0,0,2010-05-01T00:00:00
ROCKHAMPTON,2010,6,0,0,0,2010-06-01T00:00:00
ROCKHAMPTON,2010,7,0,0,0,2010-07-01T00:00:00
ROCKHAMPTON,2010,8,0,0,0,2010-08-01T00:00:00
ROCKHAMPTON,2010,9,0,0,0,2010-09-01T00:00:00
ROCKHAMPTON,2010,10,0,0,0,2010-10-01T00:00:00
ROCKHAMPTON,2010,11,0,0,0,2010-11-01T00:00:00
ROCKHAMPTON,2010,12,0,0,0,2010-12-01T00:00:00
ROCKHAMPTON,2011,1,0,0,0,2011-01-01T00:00:00
ROCKHAMPTON,2011,2,0,0,0,2011-02-01T00:00:00
ROCKHAMPTON,2011,3,0,0,0,2011-03-01T00:00:00
ROCKHAMPTON,2011,4,0,0,0,2011-04-01T00:00:00
ROCKHAMPTON,2011,5,0,0,0,2011-05-01T00:00:00
ROCKHAMPTON,2011,6,0,0,0,2011-06-01T00:00:00
ROCKHAMPTON,2011,7,0,0,0,2011-07-01T00:00:00
ROCKHAMPTON,2011,8,0,0,0,2011-08-01T00:00:00
ROCKHAMPTON,2011,9,0,0,0,2011-09-01T00:00:00
ROCKHAMPTON,2011,10,0,0,0,2011-10-01T00:00:00
ROCKHAMPTON,2011,11,0,0,0,2011-11-01T00:00:00
ROCKHAMPTON,2011,12,0,0,0,2011-12-01T00:00:00
ROCKHAMPTON,2012,1,0,0,0,2012-01-01T00:00:00
ROCKHAMPTON,2012,2,0,0,0,2012-02-01T00:00:00
ROCKHAMPTON,2012,3,0,0,0,2012-03-01T00:00:00
ROCKHAMPTON,2012,4,0,0,0,2012-04-01T00:00:00
ROCKHAMPTON,2012,5,0,0,0,2012-05-01T00:00:00
ROCKHAMPTON,2012,6,0,0,0,2012-06-01T00:00:00
ROCKHAMPTON,2012,7,0,0,0,2012-07-01T00:00:00
ROCKHAMPTON,2012,8,0,0,0,2012-08-01T00:00:00
ROCKHAMPTON,2012,9,0,0,0,2012-09-01T00:00:00
ROCKHAMPTON,2012,10,0,0,0,2012-10-01T00:00:00
ROCKHAMPTON,2012,11,0,0,0,2012-11-01T00:00:00
ROCKHAMPTON,2012,12,0,0,0,2012-12-01T00:00:00
ROCKHAMPTON,2013,1,0,0,0,2013-01-01T00:00:00
ROCKHAMPTON,2013,2,0,0,0,2013-02-01T00:00:00
ROCKHAMPTON,2013,3,0,0,0,2013-03-01T00:00:00
ROCKHAMPTON,2013,4,0,0,0,2013-04-01T00:00:00
ROCKHAMPTON,2013,5,0,0,0,2013-05-01T00:00:00
ROCKHAMPTON,2013,6,0,0,0,2013-06-01T00:00:00
ROCKHAMPTON,2013,7,0,0,0,2013-07-01T00:00:00
ROCKHAMPTON,2013,8,0,0,0,2013-08-01T00:00:00
ROCKHAMPTON,2013,9,0,0,0,2013-09-01T00:00:00
ROCKHAMPTON,2013,10,0,0,0,2013-10-01T00:00:00
ROCKHAMPTON,2013,11,0,0,0,2013-11-01T00:00:00
ROCKHAMPTON,2013,12,0,0,0,2013-12-01T00:00:00
ROCKHAMPTON,2014,1,0,0,0,2014-01-01T00:00:00
ROCKHAMPTON,2014,2,0,0,0,2014-02-01T00:00:00
ROCKHAMPTON,2014,3,0,0,0,2014-03-01T00:00:00
ROCKHAMPTON,2014,4,0,0,0,2014-04-01T00:00:00
ROCKHAMPTON,2014,5,0,0,0,2014-05-01T00:00:00
ROCKHAMPTON,2014,6,0,0,0,2014-06-01T00:00:00
ROCKHAMPTON,2014,7,0,0,0,2014-07-01T00:00:00
ROCKHAMPTON,2014,8,0,0,0,2014-08-01T00:00:00
ROCKHAMPTON,2014,9,0,0,0,2014-09-01T00:00:00
ROCKHAMPTON,2014,10,0,0,0,2014-10-01T00:00:00
ROCKHAMPTON,2014,11,0,0,0,2014-11-01T00:00:00
ROCKHAMPTON,2014,12,0,0,0,2014-12-01T00:00:00
ROCKHAMPTON,2015,1,0,0,0,2015-01-01T00:00:00
ROCKHAMPTON,2015,2,0,0,0,2015-02-01T00:00:00
ROCKHAMPTON,2015,3,0,0,0,2015-03-01T00:00:00
ROCKHAMPTON,2015,4,0,0,0,2015-04-01T00:00:00
ROCKHAMPTON,2015,5,0,0,0,2015-05-01T00:00:00
ROCKHAMPTON,2015,6,0,0,0,2015-06-01T00:00:00
ROCKHAMPTON,2015,7,0,0,0,2015-07-01T00:00:00
ROCKHAMPTON,2015,8,0,0,0,2015-08-01T00:00:00
ROCKHAMPTON,2015,9,0,0,0,2015-09-01T00:00:00
ROCKHAMPTON,2015,10,0,0,0,2015-10-01T00:00:00
ROCKHAMPTON,2015,11,0,0,0,2015-11-01T00:00:00
ROCKHAMPTON,2015,12,0,0,0,2015-12-01T00:00:00
ROCKHAMPTON,2016,1,0,0,0,2016-01-01T00:00:00
ROCKHAMPTON,2016,2,0,0,0,2016-02-01T00:00:00
ROCKHAMPTON,2016,3,0,0,0,2016-03-01T00:00:00
ROCKHAMPTON,2016,4,0,0,0,2016-04-01T00:00:00
ROCKHAMPTON,2016,5,0,0,0,2016-05-01T00:00:00
ROCKHAMPTON,2016,6,0,0,0,2016-06-01T00:00:00
ROCKHAMPTON,2016,7,0,0,0,2016-07-01T00:00:00
ROCKHAMPTON,2016,8,0,0,0,2016-08-01T00:00:00
ROCKHAMPTON,2016,9,0,0,0,2016-09-01T00:00:00
ROCKHAMPTON,2016,10,0,0,0,2016-10-01T00:00:00
ROCKHAMPTON,2016,11,0,0,0,2016-11-01T00:00:00
ROCKHAMPTON,2016,12,0,0,0,2016-12-01T00:00:00
ROCKHAMPTON,2017,1,0,0,0,2017-01-01T00:00:00
ROCKHAMPTON,2017,2,0,0,0,2017-02-01T00:00:00
ROCKHAMPTON,2017,3,0,0,0,2017-03-01T00:00:00
ROCKHAMPTON,2017,4,0,0,0,2017-04-01T00:00:00
ROCKHAMPTON,2017,5,0,0,0,2017-05-01T00:00:00
ROCKHAMPTON,2017,6,0,0,0,2017-06-01T00:00:00
ROCKHAMPTON,2017,7,0,0,0,2017-07-01T00:00:00
ROCKHAMPTON,2017,8,0,0,0,2017-08-01T00:00:00
ROCKHAMPTON,2017,9,0,0,0,2017-09-01T00:00:00
ROCKHAMPTON,2017,10,0,0,0,2017-10-01T00:00:00
ROCKHAMPTON,2017,11,0,0,0,2017-11-01T00:00:00
ROCKHAMPTON,2017,12,0,0,0,2017-12-01T00:00:00
ROCKHAMPTON,2018,1,0,0,0,2018-01-01T00:00:00
ROCKHAMPTON,2018,2,0,0,0,2018-02-01T00:00:00
ROCKHAMPTON,2018,3,0,0,0,2018-03-01T00:00:00
ROCKHAMPTON,2018,4,0,0,0,2018-04-01T00:00:00
ROCKHAMPTON,2018,5,0,0,0,2018-05-01T00:00:00
ROCKHAMPTON,2018,6,0,0,0,2018-06-01T00:00:00
ROCKHAMPTON,2018,7,0,0,0,2018-07-01T00:00:00
ROCKHAMPTON,2018,8,0,0,0,2018-08-01T00:00:00
ROCKHAMPTON,2018,9,0,0,0,2018-09-01T00:00:00
ROCKHAMPTON,2018,10,0,0,0,2018-10-01T00:00:00
ROCKHAMPTON,2018,11,0,0,0,2018-11-01T00:00:00
ROCKHAMPTON,2018,12,0,0,0,2018-12-01T00:00:00
ROCKHAMPTON,2019,1,0,0,0,2019-01-01T00:00:00
ROCKHAMPTON,2019,2,0,0,0,2019-02-01T00:00:00
ROCKHAMPTON,2019,3,0,0,0,2019-03-01T00:00:00
ROCKHAMPTON,2019,4,0,0,0,2019-04-01T00:00:00
ROCKHAMPTON,2019,5,0,0,0,2019-05-01T00:00:00
ROCKHAMPTON,2019,6,0,0,0,2019-06-01T00:00:00
ROCKHAMPTON,2019,7,0,0,0,2019-07-01T00:00:00
ROCKHAMPTON,2019,8,0,0,0,2019-08-01T00:00:00
ROCKHAMPTON,2019,9,0,0,0,2019-09-01T00:00:00
ROCKHAMPTON,2019,10,0,0,0,2019-10-01T00:00:00
ROCKHAMPTON,2019,11,0,0,0,2019-11-01T00:00:00
ROCKHAMPTON,2019,12,0,0,0,2019-12-01T00:00:00
ROCKHAMPTON,2020,1,0,0,0,2020-01-01T00:00:00
ROCKHAMPTON,2020,2,0,0,0,2020-02-01T00:00:00
ROCKHAMPTON,2020,3,0,0,0,2020-03-01T00:00:00
ROCKHAMPTON,2020,4,0,0,0,2020-04-01T00:00:00
ROCKHAMPTON,2020,5,0,0,0,2020-05-01T00:00:00
ROCKHAMPTON,2020,6,0,0,0,2020-06-01T00:00:00
ROCKHAMPTON,2020,7,0,0,0,2020-07-01T00:00:00
ROCKHAMPTON,2020,8,0,0,0,2020-08-01T00:00:00
ROCKHAMPTON,2020,9,0,0,0,2020-09-01T00:00:00
ROCKHAMPTON,2020,10,0,0,0,2020-10-01T00:00:00
ROCKHAMPTON,2020,11,0,0,0,2020-11-01T00:00:00
ROCKHAMPTON,2020,12,0,0,0,2020-12-01T00:00:00
ROCKHAMPTON,2021,1,0,0,0,2021-01-01T00:00:00
ROCKHAMPTON,2021,2,0,0,0,2021-02-01T00:00:00
ROCKHAMPTON,2021,3,0,0,0,2021-03-01T00:00:00
ROCKHAMPTON,2021,4,0,0,0,2021-04-01T00:00:00
ROCKHAMPTON,2021,5,0,0,0,2021-05-01T00:00:00
ROCKHAMPTON,2021,6,0,0,0,2021-06-01T00:00:00
ROCKHAMPTON,2021,7,0,0,0,2021-07-01T00:00:00
ROCKHAMPTON,2021,8,0,0,0,2021-08-01T00:00:00
ROCKHAMPTON,2021,9,0,0,0,2021-09-01T00:00:00
ROCKHAMPTON,2021,10,0,0,0,2021-10-01T00:00:00
ROCKHAMPTON,2021,11,0,0,0,2021-11-01T00:00:00
ROCKHAMPTON,2021,12,0,0,0,2021-12-01T00:00:00
ROCKHAMPTON,2022,1,0,0,0,2022-01-01T00:00:00
ROCKHAMPTON,2022,2,0,0,0,2022-02-01T00:00:00
ROCKHAMPTON,2022,3,0,0,0,2022-03-01T00:00:00
ROCKHAMPTON,2022,4,0,0,0,2022-04-01T00:00:00
ROCKHAMPTON,2022,5,0,0,0,2022-05-01T00:00:00
ROCKHAMPTON,2022,6,0,0,0,2022-06-01T00:00:00
ROCKHAMPTON,2022,7,0,0,0,2022-07-01T00:00:00
ROCKHAMPTON,2022,8,0,0,0,2022-08-01T00:00:00
ROCKHAMPTON,2022,9,0,0,0,2022-09-01T00:00:00
ROCKHAMPTON,2022,10,0,0,0,2022-10-01T00:00:00
ROCKHAMPTON,2022,11,0,0,0,2022-11-01T00:00:00
ROCKHAMPTON,2022,12,0,0,0,2022-12-01T00:00:00
ROCKHAMPTON,2023,1,0,0,0,2023-01-01T00:00:00
ROCKHAMPTON,2023,2,0,0,0,2023-02-01T00:00:00
ROCKHAMPTON,2023,3,0,0,0,2023-03-01T00:00:00
ROCKHAMPTON,2023,4,0,0,0,2023-04-01T00:00:00
ROCKHAMPTON,2023,5,0,0,0,2023-05-01T00:00:00
ROCKHAMPTON,2023,6,0,0,0,2023-06-01T00:00:00
ROCKHAMPTON,2023,7,0,0,0,2023-07-01T00:00:00
ROCKHAMPTON,2023,8,0,0,0,2023-08-01T00:00:00
ROCKHAMPTON,2023,9,0,0,0,2023-09-01T00:00:00
ROCKHAMPTON,2023,10,0,0,0,2023-10-01T00:00:00
ROCKHAMPTON,2023,11,0,0,0,2023-11-01T00:00:00
ROCKHAMPTON,2023,12,0,0,0,2023-12-01T00:00:00
ROCKHAMPTON,2024,1,0,0,0,2024-01-01T00:00:00
ROCKHAMPTON,2024,2,0,0,0,2024-02-01T00:00:00
ROCKHAMPTON,2024,3,0,0,0,2024-03-01T00:00:00
ROCKHAMPTON,2024,4,0,0,0,2024-04-01T00:00:00
ROCKHAMPTON,2024,5,0,0,0,2024-05-01T00:00:00
ROCKHAMPTON,2024,6,0,0,0,2024-06-01T00:00:00
ROCKHAMPTON,2024,7,0,0,0,2024-07-01T00:00:00
ROCKHAMPTON,2024,8,0,0,0,2024-08-01T00:00:00
ROCKHAMPTON,2024,9,0,0,0,2024-09-01T00:00:00
ROCKHAMPTON,2024,10,0,0,0,2024-10-01T00:00:00
ROCKHAMPTON,2024,11,0,0,0,2024-11-01T00:00:00
ROCKHAMPTON,2024,12,0,0,0,2024-12-01T00:00:00
ROCKHAMPTON,2025,1,0,0,0,2025-01-01T00:00:00
ROCKHAMPTON,2025,2,0,0,0,2025-02-01T00:00:00
ROCKHAMPTON,2025,3,0,0,0,2025-03-01T00:00:00
ROCKHAMPTON,2025,4,0,0,0,2025-04-01T00:00:00
ROCKHAMPTON,2025,5,0,0,0,2025-05-01T00:00:00
ROCKHAMPTON,2025,6,0,0,0,2025-06-01T00:00:00
SUNSHINE COAST,1985,1,0,0,0,1985-01-01T00:00:00
SUNSHINE COAST,1985,2,0,0,0,1985-02-01T00:00:00
SUNSHINE COAST,1985,3,0,0,0,1985-03-01T00:00:00
SUNSHINE COAST,1985,4,0,0,0,1985-04-01T00:00:00
SUNSHINE COAST,1985,5,0,0,0,1985-05-01T00:00:00
SUNSHINE COAST,1985,6,0,0,0,1985-06-01T00:00:00
SUNSHINE COAST,1985,7,0,0,0,1985-07-01T00:00:00
SUNSHINE COAST,1985,8,0,0,0,1985-08-01T00:00:00
SUNSHINE COAST,1985,9,0,0,0,1985-09-01T00:00:00
SUNSHINE COAST,1985,10,0,0,0,1985-10-01T00:00:00
SUNSHINE COAST,1985,11,0,0,0,1985-11-01T00:00:00
SUNSHINE COAST,1985,12,0,0,0,1985-12-01T00:00:00
SUNSHINE COAST,1986,1,0,0,0,1986-01-01T00:00:00
SUNSHINE COAST,1986,2,0,0,0,1986-02-01T00:00:00
SUNSHINE COAST,1986,3,0,0,0,1986-03-01T00:00:00
SUNSHINE COAST,1986,4,0,0,0,1986-04-01T00:00:00
SUNSHINE COAST,1986,5,0,0,0,1986-05-01T00:00:00
SUNSHINE COAST,1986,6,0,0,0,1986-06-01T00:00:00
SUNSHINE COAST,1986,7,0,0,0,1986-07-01T00:00:00
SUNSHINE COAST,1986,8,0,0,0,1986-08-01T00:00:00
SUNSHINE COAST,1986,9,0,0,0,1986-09-01T00:00:00
SUNSHINE COAST,1986,10,0,0,0,1986-10-01T00:00:00
SUNSHINE COAST,1986,11,0,0,0,1986-11-01T00:00:00
SUNSHINE COAST,1986,12,0,0,0,1986-12-01T00:00:00
SUNSHINE COAST,1987,1,0,0,0,1987-01-01T00:00:00
SUNSHINE COAST,1987,2,0,0,0,1987-02-01T00:00:00
SUNSHINE COAST,1987,3,0,0,0,1987-03-01T00:00:00
SUNSHINE COAST,1987,4,0,0,0,1987-04-01T00:00:00
SUNSHINE COAST,1987,5,0,0,0,1987-05-01T00:00:00
SUNSHINE COAST,1987,6,0,0,0,1987-06-01T00:00:00
SUNSHINE COAST,1987,7,0,0,0,1987-07-01T00:00:00
SUNSHINE COAST,1987,8,0,0,0,1987-08-01T00:00:00
SUNSHINE COAST,1987,9,0,0,0,1987-09-01T00:00:00
SUNSHINE COAST,1987,10,0,0,0,1987-10-01T00:00:00
SUNSHINE COAST,1987,11,0,0,0,1987-11-01T00:00:00
SUNSHINE COAST,1987,12,0,0,0,1987-12-01T00:00:00
SUNSHINE COAST,1988,1,0,0,0,1988-01-01T00:00:00
SUNSHINE COAST,1988,2,0,0,0,1988-02-01T00:00:00
SUNSHINE COAST,1988,3,0,0,0,1988-03-01T00:00:00
SUNSHINE COAST,1988,4,0,0,0,1988-04-01T00:00:00
SUNSHINE COAST,1988,5,0,0,0,1988-05-01T00:00:00
SUNSHINE COAST,1988,6,0,0,0,1988-06-01T00:00:00
SUNSHINE COAST,1988,7,0,0,0,1988-07-01T00:00:00
SUNSHINE COAST,1988,8,0,0,0,1988-08-01T00:00:00
SUNSHINE COAST,1988,9,0,0,0,1988-09-01T00:00:00
SUNSHINE COAST,1988,10,0,0,0,1988-10-01T00:00:00
SUNSHINE COAST,1988,11,0,0,0,1988-11-01T00:00:00
SUNSHINE COAST,1988,12,0,0,0,1988-12-01T00:00:00
SUNSHINE COAST,1989,1,0,0,0,1989-01-01T00:00:00
SUNSHINE COAST,1989,2,0,0,0,1989-02-01T00:00:00
SUNSHINE COAST,1989,3,0,0,0,1989-03-01T00:00:00
SUNSHINE COAST,1989,4,0,0,0,1989-04-01T00:00:00
SUNSHINE COAST,1989,5,0,0,0,1989-05-01T00:00:00
SUNSHINE COAST,1989,6,0,0,0,1989-06-01T00:00:00
SUNSHINE COAST,1989,7,0,0,0,1989-07-01T00:00:00
SUNSHINE COAST,1989,8,0,0,0,1989-08-01T00:00:00
SUNSHINE COAST,1989,9,0,0,0,1989-09-01T00:00:00
SUNSHINE COAST,1989,10,0,0,0,1989-10-01T00:00:00
SUNSHINE COAST,1989,11,0,0,0,1989-11-01T00:00:00
SUNSHINE COAST,1989,12,0,0,0,1989-12-01T00:00:00
SUNSHINE COAST,1990,1,0,0,0,1990-01-01T00:00:00
SUNSHINE COAST,1990,2,0,0,0,1990-02-01T00:00:00
SUNSHINE COAST,1990,3,0,0,0,1990-03-01T00:00:00
SUNSHINE COAST,1990,4,0,0,0,1990-04-01T00:00:00
SUNSHINE COAST,1990,5,0,0,0,1990-05-01T00:00:00
SUNSHINE COAST,1990,6,0,0,0,1990-06-01T00:00:00
SUNSHINE COAST,1990,7,0,0,0,1990-07-01T00:00:00
SUNSHINE COAST,1990,8,0,0,0,1990-08-01T00:00:00
SUNSHINE COAST,1990,9,0,0,0,1990-09-01T00:00:00
SUNSHINE COAST,1990,10,0,0,0,1990-10-01T00:00:00
SUNSHINE COAST,1990,11,0,0,0,1990-11-01T00:00:00
SUNSHINE COAST,1990,12,0,0,0,1990-12-01T00:00:00
SUNSHINE COAST,1991,1,0,0,0,1991-01-01T00:00:00
SUNSHINE COAST,1991,2,0,0,0,1991-02-01T00:00:00
SUNSHINE COAST,1991,3,0,0,0,1991-03-01T00:00:00
SUNSHINE COAST,1991,4,0,0,0,1991-04-01T00:00:00
SUNSHINE COAST,1991,5,0,0,0,1991-05-01T00:00:00
SUNSHINE COAST,1991,6,0,0,0,1991-06-01T00:00:00
SUNSHINE COAST,1991,7,0,0,0,1991-07-01T00:00:00
SUNSHINE COAST,1991,8,0,0,0,1991-08-01T00:00:00
SUNSHINE COAST,1991,9,0,0,0,1991-09-01T00:00:00
SUNSHINE COAST,1991,10,0,0,0,1991-10-01T00:00:00
SUNSHINE COAST,1991,11,0,0,0,1991-11-01T00:00:00
SUNSHINE COAST,1991,12,0,0,0,1991-12-01T00:00:00
SUNSHINE COAST,1992,1,0,0,0,1992-01-01T00:00:00
SUNSHINE COAST,1992,2,0,0,0,1992-02-01T00:00:00
SUNSHINE COAST,1992,3,0,0,0,1992-03-01T00:00:00
SUNSHINE COAST,1992,4,0,0,0,1992-04-01T00:00:00
SUNSHINE COAST,1992,5,0,0,0,1992-05-01T00:00:00
SUNSHINE COAST,1992,6,0,0,0,1992-06-01T00:00:00
SUNSHINE COAST,1992,7,0,0,0,1992-07-01T00:00:00
SUNSHINE COAST,1992,8,0,0,0,1992-08-01T00:00:00
SUNSHINE COAST,1992,9,0,0,0,1992-09-01T00:00:00
SUNSHINE COAST,1992,10,0,0,0,1992-10-01T00:00:00
SUNSHINE COAST,1992,11,0,0,0,1992-11-01T00:00:00
SUNSHINE COAST,1992,12,0,0,0,1992-12-01T00:00:00
SUNSHINE COAST,1993,1,0,0,0,1993-01-01T00:00:00
SUNSHINE COAST,1993,2,0,0,0,1993-02-01T00:00:00
SUNSHINE COAST,1993,3,0,0,0,1993-03-01T00:00:00
SUNSHINE COAST,1993,4,0,0,0,1993-04-01T00:00:00
SUNSHINE COAST,1993,5,0,0,0,1993-05-01T00:00:00
SUNSHINE COAST,1993,6,0,0,0,1993-06-01T00:00:00
SUNSHINE COAST,1993,7,0,0,0,1993-07-01T00:00:00
SUNSHINE COAST,1993,8,0,0,0,1993-08-01T00:00:00
SUNSHINE COAST,1993,9,0,0,0,1993-09-01T00:00:00
SUNSHINE COAST,1993,10,0,0,0,1993-10-01T00:00:00
SUNSHINE COAST,1993,11,0,0,0,1993-11-01T00:00:00
SUNSHINE COAST,1993,12,0,0,0,1993-12-01T00:00:00
SUNSHINE COAST,1994,1,0,0,0,1994-01-01T00:00:00
SUNSHINE COAST,1994,2,0,0,0,1994-02-01T00:00:00
SUNSHINE COAST,1994,3,0,0,0,1994-03-01T00:00:00
SUNSHINE COAST,1994,4,0,0,0,1994-04-01T00:00:00
SUNSHINE COAST,1994,5,0,0,0,1994-05-01T00:00:00
SUNSHINE COAST,1994,6,0,0,0,1994-06-01T00:00:00
SUNSHINE COAST,1994,7,0,0,0,1994-07-01T00:00:00
SUNSHINE COAST,1994,8,0,0,0,1994-08-01T00:00:00
SUNSHINE COAST,1994,9,0,0,0,1994-09-01T00:00:00
SUNSHINE COAST,1994,10,0,0,0,1994-10-01T00:00:00
SUNSHINE COAST,1994,11,0,0,0,1994-11-01T00:00:00
SUNSHINE COAST,1994,12,0,0,0,1994-12-01T00:00:00
SUNSHINE COAST,1995,1,0,0,0,1995-01-01T00:00:00
SUNSHINE COAST,1995,2,0,0,0,1995-02-01T00:00:00
SUNSHINE COAST,1995,3,0,0,0,1995-03-01T00:00:00
SUNSHINE COAST,1995,4,0,0,0,1995-04-01T00:00:00
SUNSHINE COAST,1995,5,0,0,0,1995-05-01T00:00:00
SUNSHINE COAST,1995,6,0,0,0,1995-06-01T00:00:00
SUNSHINE COAST,1995,7,0,0,0,1995-07-01T00:00:00
SUNSHINE COAST,1995,8,0,0,0,1995-08-01T00:00:00
SUNSHINE COAST,1995,9,0,0,0,1995-09-01T00:00:00
SUNSHINE COAST,1995,10,0,0,0,1995-10-01T00:00:00
SUNSHINE COAST,1995,11,0,0,0,1995-11-01T00:00:00
SUNSHINE COAST,1995,12,0,0,0,1995-12-01T00:00:00
SUNSHINE COAST,1996,1,0,0,0,1996-01-01T00:00:00
SUNSHINE COAST,1996,2,0,0,0,1996-02-01T00:00:00
SUNSHINE COAST,1996,3,0,0,0,1996-03-01T00:00:00
SUNSHINE COAST,1996,4,0,0,0,1996-04-01T00:00:00
SUNSHINE COAST,1996,5,0,0,0,1996-05-01T00:00:00
SUNSHINE COAST,1996,6,0,0,0,1996-06-01T00:00:00
SUNSHINE COAST,1996,7,0,0,0,1996-07-01T00:00:00
SUNSHINE COAST,1996,8,0,0,0,1996-08-01T00:00:00
SUNSHINE COAST,1996,9,0,0,0,1996-09-01T00:00:00
SUNSHINE COAST,1996,10,0,0,0,1996-10-01T00:00:00
SUNSHINE COAST,1996,11,0,0,0,1996-11-01T00:00:00
SUNSHINE COAST,1996,12,0,0,0,1996-12-01T00:00:00
SUNSHINE COAST,1997,1,0,0,0,1997-01-01T00:00:00
SUNSHINE COAST,1997,2,0,0,0,1997-02-01T00:00:00
SUNSHINE COAST,1997,3,0,0,0,1997-03-01T00:00:00
SUNSHINE COAST,1997,4,0,0,0,1997-04-01T00:00:00
SUNSHINE COAST,1997,5,0,0,0,1997-05-01T00:00:00
SUNSHINE COAST,1997,6,0,0,0,1997-06-01T00:00:00
SUNSHINE COAST,1997,7,0,0,0,1997-07-01T00:00:00
SUNSHINE COAST,1997,8,0,0,0,1997-08-01T00:00:00
SUNSHINE COAST,1997,9,0,0,0,1997-09-01T00:00:00
SUNSHINE COAST,1997,10,0,0,0,1997-10-01T00:00:00
SUNSHINE COAST,1997,11,0,0,0,1997-11-01T00:00:00
SUNSHINE COAST,1997,12,0,0,0,1997-12-01T00:00:00
SUNSHINE COAST,1998,1,0,0,0,1998-01-01T00:00:00
SUNSHINE COAST,1998,2,0,0,0,1998-02-01T00:00:00
SUNSHINE COAST,1998,3,0,0,0,1998-03-01T00:00:00
SUNSHINE COAST,1998,4,0,0,0,1998-04-01T00:00:00
SUNSHINE COAST,1998,5,0,0,0,1998-05-01T00:00:00
SUNSHINE COAST,1998,6,0,0,0,1998-06-01T00:00:00
SUNSHINE COAST,1998,7,0,0,0,1998-07-01T00:00:00
SUNSHINE COAST,1998,8,0,0,0,1998-08-01T00:00:00
SUNSHINE COAST,1998,9,0,0,0,1998-09-01T00:00:00
SUNSHINE COAST,1998,10,0,0,0,1998-10-01T00:00:00
SUNSHINE COAST,1998,11,0,0,0,1998-11-01T00:00:00
SUNSHINE COAST,1998,12,0,0,0,1998-12-01T00:00:00
SUNSHINE COAST,1999,1,0,0,0,1999-01-01T00:00:00
SUNSHINE COAST,1999,2,0,0,0,1999-02-01T00:00:00
SUNSHINE COAST,1999,3,0,0,0,1999-03-01T00:00:00
SUNSHINE COAST,1999,4,0,0,0,1999-04-01T00:00:00
SUNSHINE COAST,1999,5,0,0,0,1999-05-01T00:00:00
SUNSHINE COAST,1999,6,0,0,0,1999-06-01T00:00:00
SUNSHINE COAST,1999,7,0,0,0,1999-07-01T00:00:00
SUNSHINE COAST,1999,8,0,0,0,1999-08-01T00:00:00
SUNSHINE COAST,1999,9,0,0,0,1999-09-01T00:00:00
SUNSHINE COAST,1999,10,0,0,0,1999-10-01T00:00:00
SUNSHINE COAST,1999,11,0,0,0,1999-11-01T00:00:00
SUNSHINE COAST,1999,12,0,0,0,1999-12-01T00:00:00
SUNSHINE COAST,2000,1,0,0,0,2000-01-01T00:00:00
SUNSHINE COAST,2000,2,0,0,0,2000-02-01T00:00:00
SUNSHINE COAST,2000,3,0,0,0,2000-03-01T00:00:00
SUNSHINE COAST,2000,4,0,0,0,2000-04-01T00:00:00
SUNSHINE COAST,2000,5,0,0,0,2000-05-01T00:00:00
SUNSHINE COAST,2000,6,0,0,0,2000-06-01T00:00:00
SUNSHINE COAST,2000,7,0,0,0,2000-07-01T00:00:00
SUNSHINE COAST,2000,8,0,0,0,2000-08-01T00:00:00
SUNSHINE COAST,2000,9,0,0,0,2000-09-01T00:00:00
SUNSHINE COAST,2000,10,0,0,0,2000-10-01T00:00:00
SUNSHINE COAST,2000,11,0,0,0,2000-11-01T00:00:00
SUNSHINE COAST,2000,12,0,0,0,2000-12-01T00:00:00
SUNSHINE COAST,2001,1,0,0,0,2001-01-01T00:00:00
SUNSHINE COAST,2001,2,0,0,0,2001-02-01T00:00:00
SUNSHINE COAST,2001,3,0,0,0,2001-03-01T00:00:00
SUNSHINE COAST,2001,4,0,0,0,2001-04-01T00:00:00
SUNSHINE COAST,2001,5,0,0,0,2001-05-01T00:00:00
SUNSHINE COAST,2001,6,0,0,0,2001-06-01T00:00:00
SUNSHINE COAST,2001,7,0,0,0,2001-07-01T00:00:00
SUNSHINE COAST,2001,8,0,0,0,2001-08-01T00:00:00
SUNSHINE COAST,2001,9,0,0,0,2001-09-01T00:00:00
SUNSHINE COAST,2001,10,0,0,0,2001-10-01T00:00:00
SUNSHINE COAST,2001,11,0,0,0,2001-11-01T00:00:00
SUNSHINE COAST,2001,12,0,0,0,2001-12-01T00:00:00
SUNSHINE COAST,2002,1,0,0,0,2002-01-01T00:00:00
SUNSHINE COAST,2002,2,0,0,0,2002-02-01T00:00:00
SUNSHINE COAST,2002,3,0,0,0,2002-03-01T00:00:00
SUNSHINE COAST,2002,4,0,0,0,2002-04-01T00:00:00
SUNSHINE COAST,2002,5,0,0,0,2002-05-01T00:00:00
SUNSHINE COAST,2002,6,0,0,0,2002-06-01T00:00:00
SUNSHINE COAST,2002,7,0,0,0,2002-07-01T00:00:00
SUNSHINE COAST,2002,8,0,0,0,2002-08-01T00:00:00
SUNSHINE COAST,2002,9,0,0,0,2002-09-01T00:00:00
SUNSHINE COAST,2002,10,0,0,0,2002-10-01T00:00:00
SUNSHINE COAST,2002,11,0,0,0,2002-11-01T00:00:00
SUNSHINE COAST,2002,12,0,0,0,2002-12-01T00:00:00
SUNSHINE COAST,2003,1,0,0,0,2003-01-01T00:00:00
SUNSHINE COAST,2003,2,0,0,0,2003-02-01T00:00:00
SUNSHINE COAST,2003,3,0,0,0,2003-03-01T00:00:00
SUNSHINE COAST,2003,4,0,0,0,2003-04-01T00:00:00
SUNSHINE COAST,2003,5,0,0,0,2003-05-01T00:00:00
SUNSHINE COAST,2003,6,0,0,0,2003-06-01T00:00:00
SUNSHINE COAST,2003,7,0,0,0,2003-07-01T00:00:00
SUNSHINE COAST,2003,8,0,0,0,2003-08-01T00:00:00
SUNSHINE COAST,2003,9,0,0,0,2003-09-01T00:00:00
SUNSHINE COAST,2003,10,0,0,0,2003-10-01T00:00:00
SUNSHINE COAST,2003,11,0,0,0,2003-11-01T00:00:00
SUNSHINE COAST,2003,12,0,0,0,2003-12-01T00:00:00
SUNSHINE COAST,2004,1,0,0,0,2004-01-01T00:00:00
SUNSHINE COAST,2004,2,0,0,0,2004-02-01T00:00:00
SUNSHINE COAST,2004,3,0,0,0,2004-03-01T00:00:00
SUNSHINE COAST,2004,4,0,0,0,2004-04-01T00:00:00
SUNSHINE COAST,2004,5,0,0,0,2004-05-01T00:00:00
SUNSHINE COAST,2004,6,0,0,0,2004-06-01T00:00:00
SUNSHINE COAST,2004,7,0,0,0,2004-07-01T00:00:00
SUNSHINE COAST,2004,8,0,0,0,2004-08-01T00:00:00
SUNSHINE COAST,2004,9,0,0,0,2004-09-01T00:00:00
SUNSHINE COAST,2004,10,0,0,0,2004-10-01T00:00:00
SUNSHINE COAST,2004,11,0,0,0,2004-11-01T00:00:00
SUNSHINE COAST,2004,12,0,0,0,2004-12-01T00:00:00
SUNSHINE COAST,2005,1,0,0,0,2005-01-01T00:00:00
SUNSHINE COAST,2005,2,0,0,0,2005-02-01T00:00:00
SUNSHINE COAST,2005,3,0,0,0,2005-03-01T00:00:00
SUNSHINE COAST,2005,4,0,0,0,2005-04-01T00:00:00
SUNSHINE COAST,2005,5,0,0,0,2005-05-01T00:00:00
SUNSHINE COAST,2005,6,0,0,0,2005-06-01T00:00:00
SUNSHINE COAST,2005,7,0,0,0,2005-07-01T00:00:00
SUNSHINE COAST,2005,8,0,0,0,2005-08-01T00:00:00
SUNSHINE COAST,2005,9,0,0,0,2005-09-01T00:00:00
SUNSHINE COAST,2005,10,0,0,0,2005-10-01T00:00:00
SUNSHINE COAST,2005,11,0,0,0,2005-11-01T00:00:00
SUNSHINE COAST,2005,12,0,0,0,2005-12-01T00:00:00
SUNSHINE COAST,2006,1,0,0,0,2006-01-01T00:00:00
SUNSHINE COAST,2006,2,0,0,0,2006-02-01T00:00:00
SUNSHINE COAST,2006,3,0,0,0,2006-03-01T00:00:00
SUNSHINE COAST,2006,4,0,0,0,2006-04-01T00:00:00
SUNSHINE COAST,2006,5,0,0,0,2006-05-01T00:00:00
SUNSHINE COAST,2006,6,0,0,0,2006-06-01T00:00:00
SUNSHINE COAST,2006,7,0,0,0,2006-07-01T00:00:00
SUNSHINE COAST,2006,8,0,0,0,2006-08-01T00:00:00
SUNSHINE COAST,2006,9,0,0,0,2006-09-01T00:00:00
SUNSHINE COAST,2006,10,0,0,0,2006-10-01T00:00:00
SUNSHINE COAST,2006,11,0,0,0,2006-11-01T00:00:00
SUNSHINE COAST,2006,12,0,0,0,2006-12-01T00:00:00
SUNSHINE COAST,2007,1,0,0,0,2007-01-01T00:00:00
SUNSHINE COAST,2007,2,0,0,0,2007-02-01T00:00:00
SUNSHINE COAST,2007,3,0,0,0,2007-03-01T00:00:00
SUNSHINE COAST,2007,4,0,0,0,2007-04-01T00:00:00
SUNSHINE COAST,2007,5,0,0,0,2007-05-01T00:00:00
SUNSHINE COAST,2007,6,0,0,0,2007-06-01T00:00:00
SUNSHINE COAST,2007,7,0,0,0,2007-07-01T00:00:00
SUNSHINE COAST,2007,8,0,0,0,2007-08-01T00:00:00
SUNSHINE COAST,2007,9,0,0,0,2007-09-01T00:00:00
SUNSHINE COAST,2007,10,0,0,0,2007-10-01T00:00:00
SUNSHINE COAST,2007,11,0,0,0,2007-11-01T00:00:00
SUNSHINE COAST,2007,12,0,0,0,2007-12-01T00:00:00
SUNSHINE COAST,2008,1,0,0,0,2008-01-01T00:00:00
SUNSHINE COAST,2008,2,0,0,0,2008-02-01T00:00:00
SUNSHINE COAST,2008,3,0,0,0,2008-03-01T00:00:00
SUNSHINE COAST,2008,4,0,0,0,2008-04-01T00:00:00
SUNSHINE COAST,2008,5,0,0,0,2008-05-01T00:00:00
SUNSHINE COAST,2008,6,0,0,0,2008-06-01T00:00:00
SUNSHINE COAST,2008,7,0,0,0,2008-07-01T00:00:00
SUNSHINE COAST,2008,8,0,0,0,2008-08-01T00:00:00
SUNSHINE COAST,2008,9,0,0,0,2008-09-01T00:00:00
SUNSHINE COAST,2008,10,0,0,0,2008-10-01T00:00:00
SUNSHINE COAST,2008,11,0,0,0,2008-11-01T00:00:00
SUNSHINE COAST,2008,12,0,0,0,2008-12-01T00:00:00
SUNSHINE COAST,2009,1,0,0,0,2009-01-01T00:00:00
SUNSHINE COAST,2009,2,0,0,0,2009-02-01T00:00:00
SUNSHINE COAST,2009,3,0,0,0,2009-03-01T00:00:00
SUNSHINE COAST,2009,4,0,0,0,2009-04-01T00:00:00
SUNSHINE COAST,2009,5,0,0,0,2009-05-01T00:00:00
SUNSHINE COAST,2009,6,0,0,0,2009-06-01T00:00:00
SUNSHINE COAST,2009,7,0,0,0,2009-07-01T00:00:00
SUNSHINE COAST,2009,8,0,0,0,2009-08-01T00:00:00
SUNSHINE COAST,2009,9,0,0,0,2009-09-01T00:00:00
SUNSHINE COAST,2009,10,0,0,0,2009-10-01T00:00:00
SUNSHINE COAST,2009,11,0,0,0,2009-11-01T00:00:00
SUNSHINE COAST,2009,12,0,0,0,2009-12-01T00:00:00
SUNSHINE COAST,2010,1,0,0,0,2010-01-01T00:00:00
SUNSHINE COAST,2010,2,0,0,0,2010-02-01T00:00:00
SUNSHINE COAST,2010,3,0,0,0,2010-03-01T00:00:00
SUNSHINE COAST,2010,4,0,0,0,2010-04-01T00:00:00
SUNSHINE COAST,2010,5,0,0,0,2010-05-01T00:00:00
SUNSHINE COAST,2010,6,0,0,0,2010-06-01T00:00:00
SUNSHINE COAST,2010,7,0,0,0,2010-07-01T00:00:00
SUNSHINE COAST,2010,8,0,0,0,2010-08-01T00:00:00
SUNSHINE COAST,2010,9,0,0,0,2010-09-01T00:00:00
SUNSHINE COAST,2010,10,0,0,0,2010-10-01T00:00:00
SUNSHINE COAST,2010,11,0,0,0,2010-11-01T00:00:00
SUNSHINE COAST,2010,12,0,0,0,2010-12-01T00:00:00
SUNSHINE COAST,2011,1,0,0,0,2011-01-01T00:00:00
SUNSHINE COAST,2011,2,0,0,0,2011-02-01T00:00:00
SUNSHINE COAST,2011,3,0,0,0,2011-03-01T00:00:00
SUNSHINE COAST,2011,4,0,0,0,2011-04-01T00:00:00
SUNSHINE COAST,2011,5,0,0,0,2011-05-01T00:00:00
SUNSHINE COAST,2011,6,0,0,0,2011-06-01T00:00:00
SUNSHINE COAST,2011,7,0,0,0,2011-07-01T00:00:00
SUNSHINE COAST,2011,8,0,0,0,2011-08-01T00:00:00
SUNSHINE COAST,2011,9,0,0,0,2011-09-01T00:00:00
SUNSHINE COAST,2011,10,0,0,0,2011-10-01T00:00:00
SUNSHINE COAST,2011,11,0,0,0,2011-11-01T00:00:00
SUNSHINE COAST,2011,12,0,0,0,2011-12-01T00:00:00
SUNSHINE COAST,2012,1,0,0,0,2012-01-01T00:00:00
SUNSHINE COAST,2012,2,0,0,0,2012-02-01T00:00:00
SUNSHINE COAST,2012,3,0,0,0,2012-03-01T00:00:00
SUNSHINE COAST,2012,4,0,0,0,2012-04-01T00:00:00
SUNSHINE COAST,2012,5,0,0,0,2012-05-01T00:00:00
SUNSHINE COAST,2012,6,0,0,0,2012-06-01T00:00:00
SUNSHINE COAST,2012,7,1229,1055,2284,2012-07-01T00:00:00
SUNSHINE COAST,2012,8,1029,1003,2032,2012-08-01T00:00:00
SUNSHINE COAST,2012,9,606,791,1397,2012-09-01T00:00:00
SUNSHINE COAST,2012,10,0,0,0,2012-10-01T00:00:00
SUNSHINE COAST,2012,11,0,0,0,2012-11-01T00:00:00
SUNSHINE COAST,2012,12,0,0,0,2012-12-01T00:00:00
SUNSHINE COAST,2013,1,0,0,0,2013-01-01T00:00:00
SUNSHINE COAST,2013,2,0,0,0,2013-02-01T00:00:00
SUNSHINE COAST,2013,3,0,0,0,2013-03-01T00:00:00
SUNSHINE COAST,2013,4,0,0,0,2013-04-01T00:00:00
SUNSHINE COAST,2013,5,0,0,0,2013-05-01T00:00:00
SUNSHINE COAST,2013,6,511,329,840,2013-06-01T00:00:00
SUNSHINE COAST,2013,7,1162,1071,2233,2013-07-01T00:00:00
SUNSHINE COAST,2013,8,1044,982,2026,2013-08-01T00:00:00
SUNSHINE COAST,2013,9,1128,1136,2264,2013-09-01T00:00:00
SUNSHINE COAST,2013,10,553,489,1042,2013-10-01T00:00:00
SUNSHINE COAST,2013,11,0,0,0,2013-11-01T00:00:00
SUNSHINE COAST,2013,12,0,0,0,2013-12-01T00:00:00
SUNSHINE COAST,2014,1,0,0,0,2014-01-01T00:00:00
SUNSHINE COAST,2014,2,0,0,0,2014-02-01T00:00:00
SUNSHINE COAST,2014,3,0,0,0,2014-03-01T00:00:00
SUNSHINE COAST,2014,4,0,0,0,2014-04-01T00:00:00
SUNSHINE COAST,2014,5,0,0,0,2014-05-01T00:00:00
SUNSHINE COAST,2014,6,278,183,461,2014-06-01T00:00:00
SUNSHINE COAST,2014,7,1508,1203,2711,2014-07-01T00:00:00
SUNSHINE COAST,2014,8,1373,1191,2564,2014-08-01T00:00:00
SUNSHINE COAST,2014,9,1234,1210,2444,2014-09-01T00:00:00
SUNSHINE COAST,2014,10,1022,1046,2068,2014-10-01T00:00:00
SUNSHINE COAST,2014,11,0,0,0,2014-11-01T00:00:00
SUNSHINE COAST,2014,12,0,0,0,2014-12-01T00:00:00
SUNSHINE COAST,2015,1,0,0,0,2015-01-01T00:00:00
SUNSHINE COAST,2015,2,0,0,0,2015-02-01T00:00:00
SUNSHINE COAST,2015,3,0,0,0,2015-03-01T00:00:00
SUNSHINE COAST,2015,4,0,0,0,2015-04-01T00:00:00
SUNSHINE COAST,2015,5,0,0,0,2015-05-01T00:00:00
SUNSHINE COAST,2015,6,277,164,441,2015-06-01T00:00:00
SUNSHINE COAST,2015,7,1771,1381,3152,2015-07-01T00:00:00
SUNSHINE COAST,2015,8,1625,1570,3195,2015-08-01T00:00:00
SUNSHINE COAST,2015,9,1643,1593,3236,2015-09-01T00:00:00
SUNSHINE COAST,2015,10,1104,1133,2237,2015-10-01T00:00:00
SUNSHINE COAST,2015,11,0,0,0,2015-11-01T00:00:00
SUNSHINE COAST,2015,12,636,701,1337,2015-12-01T00:00:00
SUNSHINE COAST,2016,1,1157,1031,2188,2016-01-01T00:00:00
SUNSHINE COAST,2016,2,799,791,1590,2016-02-01T00:00:00
SUNSHINE COAST,2016,3,0,0,0,2016-03-01T00:00:00
SUNSHINE COAST,2016,4,0,0,0,2016-04-01T00:00:00
SUNSHINE COAST,2016,5,0,0,0,2016-05-01T00:00:00
SUNSHINE COAST,2016,6,0,0,0,2016-06-01T00:00:00
SUNSHINE COAST,2016,7,2074,1472,3546,2016-07-01T00:00:00
SUNSHINE COAST,2016,8,1740,1512,3252,2016-08-01T00:00:00
SUNSHINE COAST,2016,9,1894,1746,3640,2016-09-01T00:00:00
SUNSHINE COAST,2016,10,1663,1627,3290,2016-10-01T00:00:00
SUNSHINE COAST,2016,11,0,0,0,2016-11-01T00:00:00
SUNSHINE COAST,2016,12,0,0,0,2016-12-01T00:00:00
SUNSHINE COAST,2017,1,0,0,0,2017-01-01T00:00:00
SUNSHINE COAST,2017,2,0,0,0,2017-02-01T00:00:00
SUNSHINE COAST,2017,3,0,0,0,2017-03-01T00:00:00
SUNSHINE COAST,2017,4,0,0,0,2017-04-01T00:00:00
SUNSHINE COAST,2017,5,0,0,0,2017-05-01T00:00:00
SUNSHINE COAST,2017,6,0,0,0,2017-06-01T00:00:00
SUNSHINE COAST,2017,7,1948,1355,3303,2017-07-01T00:00:00
SUNSHINE COAST,2017,8,1776,1463,3239,2017-08-01T00:00:00
SUNSHINE COAST,2017,9,1839,1731,3570,2017-09-01T00:00:00
SUNSHINE COAST,2017,10,1882,1725,3607,2017-10-01T00:00:00
SUNSHINE COAST,2017,11,0,0,0,2017-11-01T00:00:00
SUNSHINE COAST,2017,12,0,0,0,2017-12-01T00:00:00
SUNSHINE COAST,2018,1,0,0,0,2018-01-01T00:00:00
SUNSHINE COAST,2018,2,0,0,0,2018-02-01T00:00:00
SUNSHINE COAST,2018,3,0,0,0,2018-03-01T00:00:00
SUNSHINE COAST,2018,4,0,0,0,2018-04-01T00:00:00
SUNSHINE COAST,2018,5,0,0,0,2018-05-01T00:00:00
SUNSHINE COAST,2018,6,0,0,0,2018-06-01T00:00:00
SUNSHINE COAST,2018,7,1943,1380,3323,2018-07-01T00:00:00
SUNSHINE COAST,2018,8,2175,1991,4166,2018-08-01T00:00:00
SUNSHINE COAST,2018,9,1918,1727,3645,2018-09-01T00:00:00
SUNSHINE COAST,2018,10,1583,1586,3169,2018-10-01T00:00:00
SUNSHINE COAST,2018,11,0,0,0,2018-11-01T00:00:00
SUNSHINE COAST,2018,12,0,0,0,2018-12-01T00:00:00
SUNSHINE COAST,2019,1,0,0,0,2019-01-01T00:00:00
SUNSHINE COAST,2019,2,0,0,0,2019-02-01T00:00:00
SUNSHINE COAST,2019,3,0,0,0,2019-03-01T00:00:00
SUNSHINE COAST,2019,4,0,0,0,2019-04-01T00:00:00
SUNSHINE COAST,2019,5,0,0,0,2019-05-01T00:00:00
SUNSHINE COAST,2019,6,0,0,0,2019-06-01T00:00:00
SUNSHINE COAST,2019,7,1830,1209,3039,2019-07-01T00:00:00
SUNSHINE COAST,2019,8,1994,1631,3625,2019-08-01T00:00:00
SUNSHINE COAST,2019,9,2012,1844,3856,2019-09-01T00:00:00
SUNSHINE COAST,2019,10,1252,1312,2564,2019-10-01T00:00:00
SUNSHINE COAST,2019,11,0,0,0,2019-11-01T00:00:00
SUNSHINE COAST,2019,12,0,0,0,2019-12-01T00:00:00
SUNSHINE COAST,2020,1,0,0,0,2020-01-01T00:00:00
SUNSHINE COAST,2020,2,0,0,0,2020-02-01T00:00:00
SUNSHINE COAST,2020,3,0,0,0,2020-03-01T00:00:00
SUNSHINE COAST,2020,4,0,0,0,2020-04-01T00:00:00
SUNSHINE COAST,2020,5,0,0,0,2020-05-01T00:00:00
SUNSHINE COAST,2020,6,0,0,0,2020-06-01T00:00:00
SUNSHINE COAST,2020,7,0,0,0,2020-07-01T00:00:00
SUNSHINE COAST,2020,8,0,0,0,2020-08-01T00:00:00
SUNSHINE COAST,2020,9,0,0,0,2020-09-01T00:00:00
SUNSHINE COAST,2020,10,0,0,0,2020-10-01T00:00:00
SUNSHINE COAST,2020,11,0,0,0,2020-11-01T00:00:00
SUNSHINE COAST,2020,12,0,0,0,2020-12-01T00:00:00
SUNSHINE COAST,2021,1,0,0,0,2021-01-01T00:00:00
SUNSHINE COAST,2021,2,0,0,0,2021-02-01T00:00:00
SUNSHINE COAST,2021,3,0,0,0,2021-03-01T00:00:00
SUNSHINE COAST,2021,4,0,0,0,2021-04-01T00:00:00
SUNSHINE COAST,2021,5,0,0,0,2021-05-01T00:00:00
SUNSHINE COAST,2021,6,0,0,0,2021-06-01T00:00:00
SUNSHINE COAST,2021,7,202,310,512,2021-07-01T00:00:00
SUNSHINE COAST,2021,8,0,0,0,2021-08-01T00:00:00
SUNSHINE COAST,2021,9,0,0,0,2021-09-01T00:00:00
SUNSHINE COAST,2021,10,0,0,0,2021-10-01T00:00:00
SUNSHINE COAST,2021,11,0,0,0,2021-11-01T00:00:00
SUNSHINE COAST,2021,12,0,0,0,2021-12-01T00:00:00
SUNSHINE COAST,2022,1,0,0,0,2022-01-01T00:00:00
SUNSHINE COAST,2022,2,0,0,0,2022-02-01T00:00:00
SUNSHINE COAST,2022,3,0,0,0,2022-03-01T00:00:00
SUNSHINE COAST,2022,4,0,0,0,2022-04-01T00:00:00
SUNSHINE COAST,2022,5,0,0,0,2022-05-01T00:00:00
SUNSHINE COAST,2022,6,0,0,0,2022-06-01T00:00:00
SUNSHINE COAST,2022,7,898,718,1616,2022-07-01T00:00:00
SUNSHINE COAST,2022,8,1211,1162,2373,2022-08-01T00:00:00
SUNSHINE COAST,2022,9,1147,1224,2371,2022-09-01T00:00:00
SUNSHINE COAST,2022,10,769,773,1542,2022-10-01T00:00:00
SUNSHINE COAST,2022,11,0,0,0,2022-11-01T00:00:00
SUNSHINE COAST,2022,12,0,0,0,2022-12-01T00:00:00
SUNSHINE COAST,2023,1,0,0,0,2023-01-01T00:00:00
SUNSHINE COAST,2023,2,0,0,0,2023-02-01T00:00:00
SUNSHINE COAST,2023,3,0,0,0,2023-03-01T00:00:00
SUNSHINE COAST,2023,4,0,0,0,2023-04-01T00:00:00
SUNSHINE COAST,2023,5,0,0,0,2023-05-01T00:00:00
SUNSHINE COAST,2023,6,433,287,720,2023-06-01T00:00:00
SUNSHINE COAST,2023,7,1753,1577,3330,2023-07-01T00:00:00
SUNSHINE COAST,2023,8,1585,1609,3194,2023-08-01T00:00:00
SUNSHINE COAST,2023,9,1809,1791,3600,2023-09-01T00:00:00
SUNSHINE COAST,2023,10,866,1073,1939,2023-10-01T00:00:00
SUNSHINE COAST,2023,11,0,0,0,2023-11-01T00:00:00
SUNSHINE COAST,2023,12,0,0,0,2023-12-01T00:00:00
SUNSHINE COAST,2024,1,0,0,0,2024-01-01T00:00:00
SUNSHINE COAST,2024,2,0,0,0,2024-02-01T00:00:00
SUNSHINE COAST,2024,3,0,0,0,2024-03-01T00:00:00
SUNSHINE COAST,2024,4,0,0,0,2024-04-01T00:00:00
SUNSHINE COAST,2024,5,0,0,0,2024-05-01T00:00:00
SUNSHINE COAST,2024,6,360,171,531,2024-06-01T00:00:00
SUNSHINE COAST,2024,7,1895,1588,3483,2024-07-01T00:00:00
SUNSHINE COAST,2024,8,1658,1574,3232,2024-08-01T00:00:00
SUNSHINE COAST,2024,9,1757,1840,3597,2024-09-01T00:00:00
SUNSHINE COAST,2024,10,1243,1327,2570,2024-10-01T00:00:00
SUNSHINE COAST,2024,11,0,0,0,2024-11-01T00:00:00
SUNSHINE COAST,2024,12,1135,1389,2524,2024-12-01T00:00:00
SUNSHINE COAST,2025,1,2151,1829,3980,2025-01-01T00:00:00
SUNSHINE COAST,2025,2,1236,1460,2696,2025-02-01T00:00:00
SUNSHINE COAST,2025,3,1173,1045,2218,2025-03-01T00:00:00
SUNSHINE COAST,2025,4,2093,1920,4013,2025-04-01T00:00:00
SUNSHINE COAST,2025,5,1576,1507,3083,2025-05-01T00:00:00
SUNSHINE COAST,2025,6,2151,1938,4089,2025-06-01T00:00:00
SYDNEY,1985,1,140832,111007,251839,1985-01-01T00:00:00
SYDNEY,1985,2,108155,99301,207456,1985-02-01T00:00:00
SYDNEY,1985,3,115643,126489,242132,1985-03-01T00:00:00
SYDNEY,1985,4,100570,117461,218031,1985-04-01T00:00:00
SYDNEY,1985,5,109520,120321,229841,1985-05-01T00:00:00
SYDNEY,1985,6,98770,105640,204410,1985-06-01T00:00:00
SYDNEY,1985,7,102757,96434,199191,1985-07-01T00:00:00
SYDNEY,1985,8,114148,124626,238774,1985-08-01T00:00:00
SYDNEY,1985,9,123879,103618,227497,1985-09-01T00:00:00
SYDNEY,1985,10,130501,99867,230368,1985-10-01T00:00:00
SYDNEY,1985,11,127508,119780,247288,1985-11-01T00:00:00
SYDNEY,1985,12,129870,145423,275293,1985-12-01T00:00:00
SYDNEY,1986,1,154218,126337,280555,1986-01-01T00:00:00
SYDNEY,1986,2,120361,104724,225085,1986-02-01T00:00:00
SYDNEY,1986,3,126596,137002,263598,1986-03-01T00:00:00
SYDNEY,1986,4,113767,136596,250363,1986-04-01T00:00:00
SYDNEY,1986,5,117047,127045,244092,1986-05-01T00:00:00
SYDNEY,1986,6,105416,108905,214321,1986-06-01T00:00:00
SYDNEY,1986,7,121470,116714,238184,1986-07-01T00:00:00
SYDNEY,1986,8,131658,138438,270096,1986-08-01T00:00:00
SYDNEY,1986,9,133514,111710,245224,1986-09-01T00:00:00
SYDNEY,1986,10,144443,114690,259133,1986-10-01T00:00:00
SYDNEY,1986,11,149128,139447,288575,1986-11-01T00:00:00
SYDNEY,1986,12,147786,159325,307111,1986-12-01T00:00:00
SYDNEY,1987,1,175469,149846,325315,1987-01-01T00:00:00
SYDNEY,1987,2,141879,129287,271166,1987-02-01T00:00:00
SYDNEY,1987,3,130483,147256,277739,1987-03-01T00:00:00
SYDNEY,1987,4,128578,137756,266334,1987-04-01T00:00:00
SYDNEY,1987,5,124873,143228,268101,1987-05-01T00:00:00
SYDNEY,1987,6,117317,126248,243565,1987-06-01T00:00:00
SYDNEY,1987,7,154634,144951,299585,1987-07-01T00:00:00
SYDNEY,1987,8,151067,158917,309984,1987-08-01T00:00:00
SYDNEY,1987,9,150640,149306,299946,1987-09-01T00:00:00
SYDNEY,1987,10,188052,147314,335366,1987-10-01T00:00:00
SYDNEY,1987,11,166794,158165,324959,1987-11-01T00:00:00
SYDNEY,1987,12,174806,172643,347449,1987-12-01T00:00:00
SYDNEY,1988,1,199123,177681,376804,1988-01-01T00:00:00
SYDNEY,1988,2,161102,150846,311948,1988-02-01T00:00:00
SYDNEY,1988,3,160036,171894,331930,1988-03-01T00:00:00
SYDNEY,1988,4,152750,163005,315755,1988-04-01T00:00:00
SYDNEY,1988,5,137288,165597,302885,1988-05-01T00:00:00
SYDNEY,1988,6,143964,153417,297381,1988-06-01T00:00:00
SYDNEY,1988,7,185209,172550,357759,1988-07-01T00:00:00
SYDNEY,1988,8,173149,181963,355112,1988-08-01T00:00:00
SYDNEY,1988,9,169802,185144,354946,1988-09-01T00:00:00
SYDNEY,1988,10,203114,169150,372264,1988-10-01T00:00:00
SYDNEY,1988,11,180475,169130,349605,1988-11-01T00:00:00
SYDNEY,1988,12,182584,197487,380071,1988-12-01T00:00:00
SYDNEY,1989,1,210566,188636,399202,1989-01-01T00:00:00
SYDNEY,1989,2,169183,152259,321442,1989-02-01T00:00:00
SYDNEY,1989,3,162283,183199,345482,1989-03-01T00:00:00
SYDNEY,1989,4,151865,162838,314703,1989-04-01T00:00:00
SYDNEY,1989,5,128596,156839,285435,1989-05-01T00:00:00
SYDNEY,1989,6,139952,159046,298998,1989-06-01T00:00:00
SYDNEY,1989,7,181674,157139,338813,1989-07-01T00:00:00
SYDNEY,1989,8,156757,169752,326509,1989-08-01T00:00:00
SYDNEY,1989,9,161771,169795,331566,1989-09-01T00:00:00
SYDNEY,1989,10,191845,148058,339903,1989-10-01T00:00:00
SYDNEY,1989,11,169482,159500,328982,1989-11-01T00:00:00
SYDNEY,1989,12,183193,212068,395261,1989-12-01T00:00:00
SYDNEY,1990,1,220212,192281,412493,1990-01-01T00:00:00
SYDNEY,1990,2,172470,156774,329244,1990-02-01T00:00:00
SYDNEY,1990,3,158688,181521,340209,1990-03-01T00:00:00
SYDNEY,1990,4,165043,187010,352053,1990-04-01T00:00:00
SYDNEY,1990,5,145880,166640,312520,1990-05-01T00:00:00
SYDNEY,1990,6,149478,178272,327750,1990-06-01T00:00:00
SYDNEY,1990,7,194169,172893,367062,1990-07-01T00:00:00
SYDNEY,1990,8,177258,185409,362667,1990-08-01T00:00:00
SYDNEY,1990,9,175612,186414,362026,1990-09-01T00:00:00
SYDNEY,1990,10,199228,162770,361998,1990-10-01T00:00:00
SYDNEY,1990,11,169733,169206,338939,1990-11-01T00:00:00
SYDNEY,1990,12,181594,215536,397130,1990-12-01T00:00:00
SYDNEY,1991,1,218519,186954,405473,1991-01-01T00:00:00
SYDNEY,1991,2,155028,149898,304926,1991-02-01T00:00:00
SYDNEY,1991,3,153643,177084,330727,1991-03-01T00:00:00
SYDNEY,1991,4,145438,153521,298959,1991-04-01T00:00:00
SYDNEY,1991,5,139321,158530,297851,1991-05-01T00:00:00
SYDNEY,1991,6,146938,171573,318511,1991-06-01T00:00:00
SYDNEY,1991,7,200198,171827,372025,1991-07-01T00:00:00
SYDNEY,1991,8,181031,188995,370026,1991-08-01T00:00:00
SYDNEY,1991,9,181438,191422,372860,1991-09-01T00:00:00
SYDNEY,1991,10,207024,176269,383293,1991-10-01T00:00:00
SYDNEY,1991,11,180996,185032,366028,1991-11-01T00:00:00
SYDNEY,1991,12,183277,216316,399593,1991-12-01T00:00:00
SYDNEY,1992,1,226755,195191,421946,1992-01-01T00:00:00
SYDNEY,1992,2,183467,173275,356742,1992-02-01T00:00:00
SYDNEY,1992,3,166948,187040,353988,1992-03-01T00:00:00
SYDNEY,1992,4,175499,197131,372630,1992-04-01T00:00:00
SYDNEY,1992,5,153996,182277,336273,1992-05-01T00:00:00
SYDNEY,1992,6,144627,174162,318789,1992-06-01T00:00:00
SYDNEY,1992,7,210784,195478,406262,1992-07-01T00:00:00
SYDNEY,1992,8,175976,184677,360653,1992-08-01T00:00:00
SYDNEY,1992,9,173801,193629,367430,1992-09-01T00:00:00
SYDNEY,1992,10,210980,176992,387972,1992-10-01T00:00:00
SYDNEY,1992,11,189670,197490,387160,1992-11-01T00:00:00
SYDNEY,1992,12,196582,239229,435811,1992-12-01T00:00:00
SYDNEY,1993,1,241909,215819,457728,1993-01-01T00:00:00
SYDNEY,1993,2,192992,181723,374715,1993-02-01T00:00:00
SYDNEY,1993,3,179994,202895,382889,1993-03-01T00:00:00
SYDNEY,1993,4,179230,204225,383455,1993-04-01T00:00:00
SYDNEY,1993,5,160582,197085,357667,1993-05-01T00:00:00
SYDNEY,1993,6,156213,189560,345773,1993-06-01T00:00:00
SYDNEY,1993,7,217789,184445,402234,1993-07-01T00:00:00
SYDNEY,1993,8,188740,204524,393264,1993-08-01T00:00:00
SYDNEY,1993,9,191102,203185,394287,1993-09-01T00:00:00
SYDNEY,1993,10,230282,193617,423899,1993-10-01T00:00:00
SYDNEY,1993,11,196654,209255,405909,1993-11-01T00:00:00
SYDNEY,1993,12,214047,242148,456195,1993-12-01T00:00:00
SYDNEY,1994,1,247854,229823,477677,1994-01-01T00:00:00
SYDNEY,1994,2,216374,209543,425917,1994-02-01T00:00:00
SYDNEY,1994,3,214118,239121,453239,1994-03-01T00:00:00
SYDNEY,1994,4,197992,219827,417819,1994-04-01T00:00:00
SYDNEY,1994,5,167227,206570,373797,1994-05-01T00:00:00
SYDNEY,1994,6,180671,214096,394767,1994-06-01T00:00:00
SYDNEY,1994,7,252596,216791,469387,1994-07-01T00:00:00
SYDNEY,1994,8,215225,231484,446709,1994-08-01T00:00:00
SYDNEY,1994,9,216559,233087,449646,1994-09-01T00:00:00
SYDNEY,1994,10,255703,224132,479835,1994-10-01T00:00:00
SYDNEY,1994,11,219107,236298,455405,1994-11-01T00:00:00
SYDNEY,1994,12,237509,276787,514296,1994-12-01T00:00:00
SYDNEY,1995,1,283194,262220,545414,1995-01-01T00:00:00
SYDNEY,1995,2,234727,226615,461342,1995-02-01T00:00:00
SYDNEY,1995,3,218138,248382,466520,1995-03-01T00:00:00
SYDNEY,1995,4,219521,248362,467883,1995-04-01T00:00:00
SYDNEY,1995,5,187422,227984,415406,1995-05-01T00:00:00
SYDNEY,1995,6,199692,223313,423005,1995-06-01T00:00:00
SYDNEY,1995,7,278585,247937,526522,1995-07-01T00:00:00
SYDNEY,1995,8,231847,258294,490141,1995-08-01T00:00:00
SYDNEY,1995,9,234139,248031,482170,1995-09-01T00:00:00
SYDNEY,1995,10,273878,231775,505653,1995-10-01T00:00:00
SYDNEY,1995,11,236645,251581,488226,1995-11-01T00:00:00
SYDNEY,1995,12,262781,303388,566169,1995-12-01T00:00:00
SYDNEY,1996,1,307460,285637,593097,1996-01-01T00:00:00
SYDNEY,1996,2,268120,255137,523257,1996-02-01T00:00:00
SYDNEY,1996,3,253767,295933,549700,1996-03-01T00:00:00
SYDNEY,1996,4,253255,272400,525655,1996-04-01T00:00:00
SYDNEY,1996,5,202924,243565,446489,1996-05-01T00:00:00
SYDNEY,1996,6,230043,266519,496562,1996-06-01T00:00:00
SYDNEY,1996,7,282152,262393,544545,1996-07-01T00:00:00
SYDNEY,1996,8,251048,282102,533150,1996-08-01T00:00:00
SYDNEY,1996,9,248957,271738,520695,1996-09-01T00:00:00
SYDNEY,1996,10,303599,259326,562925,1996-10-01T00:00:00
SYDNEY,1996,11,273754,282651,556405,1996-11-01T00:00:00
SYDNEY,1996,12,289507,335757,625264,1996-12-01T00:00:00
SYDNEY,1997,1,332661,316742,649403,1997-01-01T00:00:00
SYDNEY,1997,2,285878,270558,556436,1997-02-01T00:00:00
SYDNEY,1997,3,275294,319162,594456,1997-03-01T00:00:00
SYDNEY,1997,4,249148,281288,530436,1997-04-01T00:00:00
SYDNEY,1997,5,227584,273006,500590,1997-05-01T00:00:00
SYDNEY,1997,6,240325,282531,522856,1997-06-01T00:00:00
SYDNEY,1997,7,317284,290459,607743,1997-07-01T00:00:00
SYDNEY,1997,8,258606,300659,559265,1997-08-01T00:00:00
SYDNEY,1997,9,258736,278416,537152,1997-09-01T00:00:00
SYDNEY,1997,10,313920,277084,591004,1997-10-01T00:00:00
SYDNEY,1997,11,278196,297606,575802,1997-11-01T00:00:00
SYDNEY,1997,12,284415,331138,615553,1997-12-01T00:00:00
SYDNEY,1998,1,333694,314093,647787,1998-01-01T00:00:00
SYDNEY,1998,2,273642,266739,540381,1998-02-01T00:00:00
SYDNEY,1998,3,251781,292178,543959,1998-03-01T00:00:00
SYDNEY,1998,4,274438,310537,584975,1998-04-01T00:00:00
SYDNEY,1998,5,237662,285122,522784,1998-05-01T00:00:00
SYDNEY,1998,6,239365,274032,513397,1998-06-01T00:00:00
SYDNEY,1998,7,313591,289897,603488,1998-07-01T00:00:00
SYDNEY,1998,8,271953,307922,579875,1998-08-01T00:00:00
SYDNEY,1998,9,276052,288125,564177,1998-09-01T00:00:00
SYDNEY,1998,10,328457,283591,612048,1998-10-01T00:00:00
SYDNEY,1998,11,278190,298439,576629,1998-11-01T00:00:00
SYDNEY,1998,12,302826,341225,644051,1998-12-01T00:00:00
SYDNEY,1999,1,357204,337569,694773,1999-01-01T00:00:00
SYDNEY,1999,2,301054,277241,578295,1999-02-01T00:00:00
SYDNEY,1999,3,289522,321396,610918,1999-03-01T00:00:00
SYDNEY,1999,4,285944,307828,593772,1999-04-01T00:00:00
SYDNEY,1999,5,248069,285323,533392,1999-05-01T00:00:00
SYDNEY,1999,6,256388,283587,539975,1999-06-01T00:00:00
SYDNEY,1999,7,335859,310224,646083,1999-07-01T00:00:00
SYDNEY,1999,8,286415,337051,623466,1999-08-01T00:00:00
SYDNEY,1999,9,298505,322278,620783,1999-09-01T00:00:00
SYDNEY,1999,10,353335,303862,657197,1999-10-01T00:00:00
SYDNEY,1999,11,307195,318419,625614,1999-11-01T00:00:00
SYDNEY,1999,12,321849,342036,663885,1999-12-01T00:00:00
SYDNEY,2000,1,357512,362109,719621,2000-01-01T00:00:00
SYDNEY,2000,2,328992,311707,640699,2000-02-01T00:00:00
SYDNEY,2000,3,303770,337919,641689,2000-03-01T00:00:00
SYDNEY,2000,4,327665,360247,687912,2000-04-01T00:00:00
SYDNEY,2000,5,273093,319168,592261,2000-05-01T00:00:00
SYDNEY,2000,6,280055,303432,583487,2000-06-01T00:00:00
SYDNEY,2000,7,370847,338758,709605,2000-07-01T00:00:00
SYDNEY,2000,8,305438,344118,649556,2000-08-01T00:00:00
SYDNEY,2000,9,367096,351997,719093,2000-09-01T00:00:00
SYDNEY,2000,10,382128,370847,752975,2000-10-01T00:00:00
SYDNEY,2000,11,351774,370505,722279,2000-11-01T00:00:00
SYDNEY,2000,12,385093,432953,818046,2000-12-01T00:00:00
SYDNEY,2001,1,429519,413148,842667,2001-01-01T00:00:00
SYDNEY,2001,2,347071,326321,673392,2001-02-01T00:00:00
SYDNEY,2001,3,332452,368819,701271,2001-03-01T00:00:00
SYDNEY,2001,4,336349,368688,705037,2001-04-01T00:00:00
SYDNEY,2001,5,281788,327279,609067,2001-05-01T00:00:00
SYDNEY,2001,6,305000,329844,634844,2001-06-01T00:00:00
SYDNEY,2001,7,396511,376642,773153,2001-07-01T00:00:00
SYDNEY,2001,8,325629,371671,697300,2001-08-01T00:00:00
SYDNEY,2001,9,315765,329483,645248,2001-09-01T00:00:00
SYDNEY,2001,10,339550,289458,629008,2001-10-01T00:00:00
SYDNEY,2001,11,288534,300354,588888,2001-11-01T00:00:00
SYDNEY,2001,12,351844,377254,729098,2001-12-01T00:00:00
SYDNEY,2002,1,381444,371770,753214,2002-01-01T00:00:00
SYDNEY,2002,2,328497,317977,646474,2002-02-01T00:00:00
SYDNEY,2002,3,336029,359582,695611,2002-03-01T00:00:00
SYDNEY,2002,4,300847,333360,634207,2002-04-01T00:00:00
SYDNEY,2002,5,272660,311046,583706,2002-05-01T00:00:00
SYDNEY,2002,6,281121,311137,592258,2002-06-01T00:00:00
SYDNEY,2002,7,369163,338385,707548,2002-07-01T00:00:00
SYDNEY,2002,8,308310,346303,654613,2002-08-01T00:00:00
SYDNEY,2002,9,305796,318780,624576,2002-09-01T00:00:00
SYDNEY,2002,10,382244,320522,702766,2002-10-01T00:00:00
SYDNEY,2002,11,320663,340448,661111,2002-11-01T00:00:00
SYDNEY,2002,12,355308,395383,750691,2002-12-01T00:00:00
SYDNEY,2003,1,407482,389333,796815,2003-01-01T00:00:00
SYDNEY,2003,2,334481,309670,644151,2003-02-01T00:00:00
SYDNEY,2003,3,307115,323868,630983,2003-03-01T00:00:00
SYDNEY,2003,4,268547,284854,553401,2003-04-01T00:00:00
SYDNEY,2003,5,231588,257885,489473,2003-05-01T00:00:00
SYDNEY,2003,6,253355,283505,536860,2003-06-01T00:00:00
SYDNEY,2003,7,364483,333194,697677,2003-07-01T00:00:00
SYDNEY,2003,8,310030,349066,659096,2003-08-01T00:00:00
SYDNEY,2003,9,331797,338971,670768,2003-09-01T00:00:00
SYDNEY,2003,10,382214,324708,706922,2003-10-01T00:00:00
SYDNEY,2003,11,350664,373757,724421,2003-11-01T00:00:00
SYDNEY,2003,12,380581,438693,819274,2003-12-01T00:00:00
SYDNEY,2004,1,435635,417236,852871,2004-01-01T00:00:00
SYDNEY,2004,2,368353,339747,708100,2004-02-01T00:00:00
SYDNEY,2004,3,338145,372811,710956,2004-03-01T00:00:00
SYDNEY,2004,4,347767,375887,723654,2004-04-01T00:00:00
SYDNEY,2004,5,302528,345225,647753,2004-05-01T00:00:00
SYDNEY,2004,6,316365,356497,672862,2004-06-01T00:00:00
SYDNEY,2004,7,424147,375074,799221,2004-07-01T00:00:00
SYDNEY,2004,8,341799,370071,711870,2004-08-01T00:00:00
SYDNEY,2004,9,348401,368103,716504,2004-09-01T00:00:00
SYDNEY,2004,10,419236,351899,771135,2004-10-01T00:00:00
SYDNEY,2004,11,368157,387595,755752,2004-11-01T00:00:00
SYDNEY,2004,12,415329,465818,881147,2004-12-01T00:00:00
SYDNEY,2005,1,496729,456965,953694,2005-01-01T00:00:00
SYDNEY,2005,2,393734,364324,758058,2005-02-01T00:00:00
SYDNEY,2005,3,385399,405235,790634,2005-03-01T00:00:00
SYDNEY,2005,4,362986,392668,755654,2005-04-01T00:00:00
SYDNEY,2005,5,307917,359894,667811,2005-05-01T00:00:00
SYDNEY,2005,6,335529,377683,713212,2005-06-01T00:00:00
SYDNEY,2005,7,455890,400072,855962,2005-07-01T00:00:00
SYDNEY,2005,8,366335,400842,767177,2005-08-01T00:00:00
SYDNEY,2005,9,386191,388594,774785,2005-09-01T00:00:00
SYDNEY,2005,10,440647,360488,801135,2005-10-01T00:00:00
SYDNEY,2005,11,376786,395538,772324,2005-11-01T00:00:00
SYDNEY,2005,12,426049,479488,905537,2005-12-01T00:00:00
SYDNEY,2006,1,511247,457754,969001,2006-01-01T00:00:00
SYDNEY,2006,2,411471,371274,782745,2006-02-01T00:00:00
SYDNEY,2006,3,378684,401512,780196,2006-03-01T00:00:00
SYDNEY,2006,4,390293,425042,815335,2006-04-01T00:00:00
SYDNEY,2006,5,330210,364815,695025,2006-05-01T00:00:00
SYDNEY,2006,6,349258,399074,748332,2006-06-01T00:00:00
SYDNEY,2006,7,469131,393768,862899,2006-07-01T00:00:00
SYDNEY,2006,8,371197,400795,771992,2006-08-01T00:00:00
SYDNEY,2006,9,400559,395302,795861,2006-09-01T00:00:00
SYDNEY,2006,10,467976,397497,865473,2006-10-01T00:00:00
SYDNEY,2006,11,407704,412837,820541,2006-11-01T00:00:00
SYDNEY,2006,12,453427,505143,958570,2006-12-01T00:00:00
SYDNEY,2007,1,523596,479313,1002909,2007-01-01T00:00:00
SYDNEY,2007,2,431862,386756,818618,2007-02-01T00:00:00
SYDNEY,2007,3,428333,444210,872543,2007-03-01T00:00:00
SYDNEY,2007,4,410858,435630,846488,2007-04-01T00:00:00
SYDNEY,2007,5,343849,379611,723460,2007-05-01T00:00:00
SYDNEY,2007,6,372426,412629,785055,2007-06-01T00:00:00
SYDNEY,2007,7,484746,411228,895974,2007-07-01T00:00:00
SYDNEY,2007,8,408691,424699,833390,2007-08-01T00:00:00
SYDNEY,2007,9,418230,428780,847010,2007-09-01T00:00:00
SYDNEY,2007,10,493139,408634,901773,2007-10-01T00:00:00
SYDNEY,2007,11,431052,437608,868660,2007-11-01T00:00:00
SYDNEY,2007,12,460496,521864,982360,2007-12-01T00:00:00
SYDNEY,2008,1,548467,478227,1026694,2008-01-01T00:00:00
SYDNEY,2008,2,475823,411452,887275,2008-02-01T00:00:00
SYDNEY,2008,3,443531,457485,901016,2008-03-01T00:00:00
SYDNEY,2008,4,408788,429247,838035,2008-04-01T00:00:00
SYDNEY,2008,5,375114,408669,783783,2008-05-01T00:00:00
SYDNEY,2008,6,379389,415481,794870,2008-06-01T00:00:00
SYDNEY,2008,7,523633,457958,981591,2008-07-01T00:00:00
SYDNEY,2008,8,414252,435894,850146,2008-08-01T00:00:00
SYDNEY,2008,9,399830,406094,805924,2008-09-01T00:00:00
SYDNEY,2008,10,484575,397692,882267,2008-10-01T00:00:00
SYDNEY,2008,11,418604,418200,836804,2008-11-01T00:00:00
SYDNEY,2008,12,453228,511267,964495,2008-12-01T00:00:00
SYDNEY,2009,1,539079,457378,996457,2009-01-01T00:00:00
SYDNEY,2009,2,428010,373914,801924,2009-02-01T00:00:00
SYDNEY,2009,3,410673,411020,821693,2009-03-01T00:00:00
SYDNEY,2009,4,429137,441485,870622,2009-04-01T00:00:00
SYDNEY,2009,5,364220,395190,759410,2009-05-01T00:00:00
SYDNEY,2009,6,363355,404533,767888,2009-06-01T00:00:00
SYDNEY,2009,7,494278,447070,941348,2009-07-01T00:00:00
SYDNEY,2009,8,433893,430252,864145,2009-08-01T00:00:00
SYDNEY,2009,9,443209,436480,879689,2009-09-01T00:00:00
SYDNEY,2009,10,523927,451566,975493,2009-10-01T00:00:00
SYDNEY,2009,11,440305,453940,894245,2009-11-01T00:00:00
SYDNEY,2009,12,498977,563379,1062356,2009-12-01T00:00:00
SYDNEY,2010,1,589167,521511,1110678,2010-01-01T00:00:00
SYDNEY,2010,2,474091,424962,899053,2010-02-01T00:00:00
SYDNEY,2010,3,451545,474798,926343,2010-03-01T00:00:00
SYDNEY,2010,4,441331,445549,886880,2010-04-01T00:00:00
SYDNEY,2010,5,380176,422964,803140,2010-05-01T00:00:00
SYDNEY,2010,6,402125,465000,867125,2010-06-01T00:00:00
SYDNEY,2010,7,546386,469414,1015800,2010-07-01T00:00:00
SYDNEY,2010,8,457069,471363,928432,2010-08-01T00:00:00
SYDNEY,2010,9,473067,489387,962454,2010-09-01T00:00:00
SYDNEY,2010,10,549162,459725,1008887,2010-10-01T00:00:00
SYDNEY,2010,11,465698,478625,944323,2010-11-01T00:00:00
SYDNEY,2010,12,514182,588240,1102422,2010-12-01T00:00:00
SYDNEY,2011,1,617807,541526,1159333,2011-01-01T00:00:00
SYDNEY,2011,2,487786,428500,916286,2011-02-01T00:00:00
SYDNEY,2011,3,446942,456003,902945,2011-03-01T00:00:00
SYDNEY,2011,4,466420,499769,966189,2011-04-01T00:00:00
SYDNEY,2011,5,409295,443458,852753,2011-05-01T00:00:00
SYDNEY,2011,6,404433,480056,884489,2011-06-01T00:00:00
SYDNEY,2011,7,563461,476698,1040159,2011-07-01T00:00:00
SYDNEY,2011,8,462526,475601,938127,2011-08-01T00:00:00
SYDNEY,2011,9,482585,511900,994485,2011-09-01T00:00:00
SYDNEY,2011,10,566982,463447,1030429,2011-10-01T00:00:00
SYDNEY,2011,11,471165,480997,952162,2011-11-01T00:00:00
SYDNEY,2011,12,516227,594998,1111225,2011-12-01T00:00:00
SYDNEY,2012,1,636764,544134,1180898,2012-01-01T00:00:00
SYDNEY,2012,2,502187,438793,940980,2012-02-01T00:00:00
SYDNEY,2012,3,473869,498448,972317,2012-03-01T00:00:00
SYDNEY,2012,4,493981,507349,1001330,2012-04-01T00:00:00
SYDNEY,2012,5,415903,460344,876247,2012-05-01T00:00:00
SYDNEY,2012,6,447918,531028,978946,2012-06-01T00:00:00
SYDNEY,2012,7,585208,491435,1076643,2012-07-01T00:00:00
SYDNEY,2012,8,490990,513955,1004945,2012-08-01T00:00:00
SYDNEY,2012,9,512937,543135,1056072,2012-09-01T00:00:00
SYDNEY,2012,10,582555,480934,1063489,2012-10-01T00:00:00
SYDNEY,2012,11,503626,522024,1025650,2012-11-01T00:00:00
SYDNEY,2012,12,556732,634944,1191676,2012-12-01T00:00:00
SYDNEY,2013,1,651121,559445,1210566,2013-01-01T00:00:00
SYDNEY,2013,2,513791,460487,974278,2013-02-01T00:00:00
SYDNEY,2013,3,507531,532984,1040515,2013-03-01T00:00:00
SYDNEY,2013,4,507852,520156,1028008,2013-04-01T00:00:00
SYDNEY,2013,5,447696,488558,936254,2013-05-01T00:00:00
SYDNEY,2013,6,466995,542461,1009456,2013-06-01T00:00:00
SYDNEY,2013,7,609690,529985,1139675,2013-07-01T00:00:00
SYDNEY,2013,8,523344,542194,1065538,2013-08-01T00:00:00
SYDNEY,2013,9,536112,561318,1097430,2013-09-01T00:00:00
SYDNEY,2013,10,610674,497724,1108398,2013-10-01T00:00:00
SYDNEY,2013,11,530129,542880,1073009,2013-11-01T00:00:00
SYDNEY,2013,12,578786,671972,1250758,2013-12-01T00:00:00
SYDNEY,2014,1,698668,608317,1306985,2014-01-01T00:00:00
SYDNEY,2014,2,541240,495993,1037233,2014-02-01T00:00:00
SYDNEY,2014,3,513803,530525,1044328,2014-03-01T00:00:00
SYDNEY,2014,4,526287,566949,1093236,2014-04-01T00:00:00
SYDNEY,2014,5,483268,509089,992357,2014-05-01T00:00:00
SYDNEY,2014,6,463814,565678,1029492,2014-06-01T00:00:00
SYDNEY,2014,7,613345,528745,1142090,2014-07-01T00:00:00
SYDNEY,2014,8,524448,551983,1076431,2014-08-01T00:00:00
SYDNEY,2014,9,535529,554031,1089560,2014-09-01T00:00:00
SYDNEY,2014,10,616131,519670,1135801,2014-10-01T00:00:00
SYDNEY,2014,11,542097,546503,1088600,2014-11-01T00:00:00
SYDNEY,2014,12,593553,686169,1279722,2014-12-01T00:00:00
SYDNEY,2015,1,711721,614666,1326387,2015-01-01T00:00:00
SYDNEY,2015,2,563101,503262,1066363,2015-02-01T00:00:00
SYDNEY,2015,3,557245,579473,1136718,2015-03-01T00:00:00
SYDNEY,2015,4,547174,551891,1099065,2015-04-01T00:00:00
SYDNEY,2015,5,488608,519255,1007863,2015-05-01T00:00:00
SYDNEY,2015,6,487652,572404,1060056,2015-06-01T00:00:00
SYDNEY,2015,7,643544,567433,1210977,2015-07-01T00:00:00
SYDNEY,2015,8,553594,567291,1120885,2015-08-01T00:00:00
SYDNEY,2015,9,572834,579569,1152403,2015-09-01T00:00:00
SYDNEY,2015,10,639213,552224,1191437,2015-10-01T00:00:00
SYDNEY,2015,11,570432,579909,1150341,2015-11-01T00:00:00
SYDNEY,2015,12,643342,745391,1388733,2015-12-01T00:00:00
SYDNEY,2016,1,781878,675908,1457786,2016-01-01T00:00:00
SYDNEY,2016,2,636639,567917,1204556,2016-02-01T00:00:00
SYDNEY,2016,3,601343,625198,1226541,2016-03-01T00:00:00
SYDNEY,2016,4,602761,612185,1214946,2016-04-01T00:00:00
SYDNEY,2016,5,526968,555830,1082798,2016-05-01T00:00:00
SYDNEY,2016,6,524116,616675,1140791,2016-06-01T00:00:00
SYDNEY,2016,7,719961,627148,1347109,2016-07-01T00:00:00
SYDNEY,2016,8,601925,608827,1210752,2016-08-01T00:00:00
SYDNEY,2016,9,617389,630118,1247507,2016-09-01T00:00:00
SYDNEY,2016,10,693223,588318,1281541,2016-10-01T00:00:00
SYDNEY,2016,11,605826,622927,1228753,2016-11-01T00:00:00
SYDNEY,2016,12,681661,787236,1468897,2016-12-01T00:00:00
SYDNEY,2017,1,835438,724531,1559969,2017-01-01T00:00:00
SYDNEY,2017,2,655651,570218,1225869,2017-02-01T00:00:00
SYDNEY,2017,3,614723,629062,1243785,2017-03-01T00:00:00
SYDNEY,2017,4,664691,681401,1346092,2017-04-01T00:00:00
SYDNEY,2017,5,562979,593638,1156617,2017-05-01T00:00:00
SYDNEY,2017,6,569557,673314,1242871,2017-06-01T00:00:00
SYDNEY,2017,7,760491,662542,1423033,2017-07-01T00:00:00
SYDNEY,2017,8,644683,655860,1300543,2017-08-01T00:00:00
SYDNEY,2017,9,657428,669922,1327350,2017-09-01T00:00:00
SYDNEY,2017,10,727017,618485,1345502,2017-10-01T00:00:00
SYDNEY,2017,11,644589,666967,1311556,2017-11-01T00:00:00
SYDNEY,2017,12,720485,834514,1554999,2017-12-01T00:00:00
SYDNEY,2018,1,852699,733634,1586333,2018-01-01T00:00:00
SYDNEY,2018,2,696311,617701,1314012,2018-02-01T00:00:00
SYDNEY,2018,3,676261,692921,1369182,2018-03-01T00:00:00
SYDNEY,2018,4,672810,700606,1373416,2018-04-01T00:00:00
SYDNEY,2018,5,605693,624178,1229871,2018-05-01T00:00:00
SYDNEY,2018,6,592992,702206,1295198,2018-06-01T00:00:00
SYDNEY,2018,7,793662,696321,1489983,2018-07-01T00:00:00
SYDNEY,2018,8,675440,686667,1362107,2018-08-01T00:00:00
SYDNEY,2018,9,672762,684833,1357595,2018-09-01T00:00:00
SYDNEY,2018,10,779641,656652,1436293,2018-10-01T00:00:00
SYDNEY,2018,11,663086,684189,1347275,2018-11-01T00:00:00
SYDNEY,2018,12,734848,866372,1601220,2018-12-01T00:00:00
SYDNEY,2019,1,887489,768912,1656401,2019-01-01T00:00:00
SYDNEY,2019,2,707952,612960,1320912,2019-02-01T00:00:00
SYDNEY,2019,3,656438,672111,1328549,2019-03-01T00:00:00
SYDNEY,2019,4,681293,719809,1401102,2019-04-01T00:00:00
SYDNEY,2019,5,641103,658543,1299646,2019-05-01T00:00:00
SYDNEY,2019,6,609046,697055,1306101,2019-06-01T00:00:00
SYDNEY,2019,7,758328,692756,1451084,2019-07-01T00:00:00
SYDNEY,2019,8,688054,695834,1383888,2019-08-01T00:00:00
SYDNEY,2019,9,668842,689778,1358620,2019-09-01T00:00:00
SYDNEY,2019,10,759129,665258,1424387,2019-10-01T00:00:00
SYDNEY,2019,11,677641,682256,1359897,2019-11-01T00:00:00
SYDNEY,2019,12,728207,871647,1599854,2019-12-01T00:00:00
SYDNEY,2020,1,877231,775800,1653031,2020-01-01T00:00:00
SYDNEY,2020,2,595097,506896,1101993,2020-02-01T00:00:00
SYDNEY,2020,3,341102,344459,685561,2020-03-01T00:00:00
SYDNEY,2020,4,7751,33619,41370,2020-04-01T00:00:00
SYDNEY,2020,5,10119,20218,30337,2020-05-01T00:00:00
SYDNEY,2020,6,12537,21934,34471,2020-06-01T00:00:00
SYDNEY,2020,7,12877,29798,42675,2020-07-01T00:00:00
SYDNEY,2020,8,9825,28770,38595,2020-08-01T00:00:00
SYDNEY,2020,9,10035,24897,34932,2020-09-01T00:00:00
SYDNEY,2020,10,13108,23983,37091,2020-10-01T00:00:00
SYDNEY,2020,11,15900,24368,40268,2020-11-01T00:00:00
SYDNEY,2020,12,16152,26436,42588,2020-12-01T00:00:00
SYDNEY,2021,1,11032,20684,31716,2021-01-01T00:00:00
SYDNEY,2021,2,9983,14635,24618,2021-02-01T00:00:00
SYDNEY,2021,3,13957,15381,29338,2021-03-01T00:00:00
SYDNEY,2021,4,21742,27003,48745,2021-04-01T00:00:00
SYDNEY,2021,5,41234,42708,83942,2021-05-01T00:00:00
SYDNEY,2021,6,39699,40536,80235,2021-06-01T00:00:00
SYDNEY,2021,7,12380,19811,32191,2021-07-01T00:00:00
SYDNEY,2021,8,7955,18448,26403,2021-08-01T00:00:00
SYDNEY,2021,9,4410,14062,18472,2021-09-01T00:00:00
SYDNEY,2021,10,3662,15753,19415,2021-10-01T00:00:00
SYDNEY,2021,11,42178,49870,92048,2021-11-01T00:00:00
SYDNEY,2021,12,112764,129642,242406,2021-12-01T00:00:00
SYDNEY,2022,1,153721,103167,256888,2022-01-01T00:00:00
SYDNEY,2022,2,134032,88762,222794,2022-02-01T00:00:00
SYDNEY,2022,3,177024,160206,337230,2022-03-01T00:00:00
SYDNEY,2022,4,259434,279098,538532,2022-04-01T00:00:00
SYDNEY,2022,5,287411,289660,577071,2022-05-01T00:00:00
SYDNEY,2022,6,319268,376620,695888,2022-06-01T00:00:00
SYDNEY,2022,7,449878,404429,854307,2022-07-01T00:00:00
SYDNEY,2022,8,420285,385639,805924,2022-08-01T00:00:00
SYDNEY,2022,9,433437,429297,862734,2022-09-01T00:00:00
SYDNEY,2022,10,491670,415469,907139,2022-10-01T00:00:00
SYDNEY,2022,11,484849,489552,974401,2022-11-01T00:00:00
SYDNEY,2022,12,529261,621131,1150392,2022-12-01T00:00:00
SYDNEY,2023,1,671268,574067,1245335,2023-01-01T00:00:00
SYDNEY,2023,2,566934,453954,1020888,2023-02-01T00:00:00
SYDNEY,2023,3,551400,551878,1103278,2023-03-01T00:00:00
SYDNEY,2023,4,560311,570535,1130846,2023-04-01T00:00:00
SYDNEY,2023,5,534733,553471,1088204,2023-05-01T00:00:00
SYDNEY,2023,6,543365,626860,1170225,2023-06-01T00:00:00
SYDNEY,2023,7,705713,602013,1307726,2023-07-01T00:00:00
SYDNEY,2023,8,624566,612723,1237289,2023-08-01T00:00:00
SYDNEY,2023,9,638554,640991,1279545,2023-09-01T00:00:00
SYDNEY,2023,10,695855,594999,1290854,2023-10-01T00:00:00
SYDNEY,2023,11,624043,641640,1265683,2023-11-01T00:00:00
SYDNEY,2023,12,680443,818725,1499168,2023-12-01T00:00:00
SYDNEY,2024,1,853678,701745,1555423,2024-01-01T00:00:00
SYDNEY,2024,2,708756,597237,1305993,2024-02-01T00:00:00
SYDNEY,2024,3,633865,672069,1305934,2024-03-01T00:00:00
SYDNEY,2024,4,646591,663606,1310197,2024-04-01T00:00:00
SYDNEY,2024,5,599358,617617,1216975,2024-05-01T00:00:00
SYDNEY,2024,6,589647,683744,1273391,2024-06-01T00:00:00
SYDNEY,2024,7,746729,648790,1395519,2024-07-01T00:00:00
SYDNEY,2024,8,641894,658433,1300327,2024-08-01T00:00:00
SYDNEY,2024,9,668361,694792,1363153,2024-09-01T00:00:00
SYDNEY,2024,10,753747,655141,1408888,2024-10-01T00:00:00
SYDNEY,2024,11,668969,699082,1368051,2024-11-01T00:00:00
SYDNEY,2024,12,720211,879579,1599790,2024-12-01T00:00:00
SYDNEY,2025,1,912257,789368,1701625,2025-01-01T00:00:00
SYDNEY,2025,2,730795,590082,1320877,2025-02-01T00:00:00
SYDNEY,2025,3,655331,659931,1315262,2025-03-01T00:00:00
SYDNEY,2025,4,670335,720564,1390899,2025-04-01T00:00:00
SYDNEY,2025,5,640137,648323,1288460,2025-05-01T00:00:00
SYDNEY,2025,6,610293,688177,1298470,2025-06-01T00:00:00
TOWNSVILLE,1985,1,1358,990,2348,1985-01-01T00:00:00
TOWNSVILLE,1985,2,849,825,1674,1985-02-01T00:00:00
TOWNSVILLE,1985,3,808,748,1556,1985-03-01T00:00:00
TOWNSVILLE,1985,4,869,952,1821,1985-04-01T00:00:00
TOWNSVILLE,1985,5,1146,892,2038,1985-05-01T00:00:00
TOWNSVILLE,1985,6,1299,1208,2507,1985-06-01T00:00:00
TOWNSVILLE,1985,7,1957,1353,3310,1985-07-01T00:00:00
TOWNSVILLE,1985,8,1031,1142,2173,1985-08-01T00:00:00
TOWNSVILLE,1985,9,956,1041,1997,1985-09-01T00:00:00
TOWNSVILLE,1985,10,1123,1014,2137,1985-10-01T00:00:00
TOWNSVILLE,1985,11,712,930,1642,1985-11-01T00:00:00
TOWNSVILLE,1985,12,874,1461,2335,1985-12-01T00:00:00
TOWNSVILLE,1986,1,1613,1015,2628,1986-01-01T00:00:00
TOWNSVILLE,1986,2,735,707,1442,1986-02-01T00:00:00
TOWNSVILLE,1986,3,931,759,1690,1986-03-01T00:00:00
TOWNSVILLE,1986,4,855,921,1776,1986-04-01T00:00:00
TOWNSVILLE,1986,5,1060,1053,2113,1986-05-01T00:00:00
TOWNSVILLE,1986,6,1677,1241,2918,1986-06-01T00:00:00
TOWNSVILLE,1986,7,1683,1321,3004,1986-07-01T00:00:00
TOWNSVILLE,1986,8,1461,1683,3144,1986-08-01T00:00:00
TOWNSVILLE,1986,9,1254,1539,2793,1986-09-01T00:00:00
TOWNSVILLE,1986,10,1344,1273,2617,1986-10-01T00:00:00
TOWNSVILLE,1986,11,1366,1431,2797,1986-11-01T00:00:00
TOWNSVILLE,1986,12,1192,1531,2723,1986-12-01T00:00:00
TOWNSVILLE,1987,1,1476,1326,2802,1987-01-01T00:00:00
TOWNSVILLE,1987,2,823,838,1661,1987-02-01T00:00:00
TOWNSVILLE,1987,3,926,970,1896,1987-03-01T00:00:00
TOWNSVILLE,1987,4,942,744,1686,1987-04-01T00:00:00
TOWNSVILLE,1987,5,1066,1160,2226,1987-05-01T00:00:00
TOWNSVILLE,1987,6,982,768,1750,1987-06-01T00:00:00
TOWNSVILLE,1987,7,1147,967,2114,1987-07-01T00:00:00
TOWNSVILLE,1987,8,1088,1175,2263,1987-08-01T00:00:00
TOWNSVILLE,1987,9,923,1205,2128,1987-09-01T00:00:00
TOWNSVILLE,1987,10,1290,1069,2359,1987-10-01T00:00:00
TOWNSVILLE,1987,11,842,899,1741,1987-11-01T00:00:00
TOWNSVILLE,1987,12,778,825,1603,1987-12-01T00:00:00
TOWNSVILLE,1988,1,1097,958,2055,1988-01-01T00:00:00
TOWNSVILLE,1988,2,670,706,1376,1988-02-01T00:00:00
TOWNSVILLE,1988,3,824,663,1487,1988-03-01T00:00:00
TOWNSVILLE,1988,4,863,753,1616,1988-04-01T00:00:00
TOWNSVILLE,1988,5,893,734,1627,1988-05-01T00:00:00
TOWNSVILLE,1988,6,1083,730,1813,1988-06-01T00:00:00
TOWNSVILLE,1988,7,1292,895,2187,1988-07-01T00:00:00
TOWNSVILLE,1988,8,1124,1026,2150,1988-08-01T00:00:00
TOWNSVILLE,1988,9,1107,1181,2288,1988-09-01T00:00:00
TOWNSVILLE,1988,10,966,1046,2012,1988-10-01T00:00:00
TOWNSVILLE,1988,11,630,806,1436,1988-11-01T00:00:00
TOWNSVILLE,1988,12,874,1053,1927,1988-12-01T00:00:00
TOWNSVILLE,1989,1,932,830,1762,1989-01-01T00:00:00
TOWNSVILLE,1989,2,700,692,1392,1989-02-01T00:00:00
TOWNSVILLE,1989,3,661,748,1409,1989-03-01T00:00:00
TOWNSVILLE,1989,4,782,734,1516,1989-04-01T00:00:00
TOWNSVILLE,1989,5,595,723,1318,1989-05-01T00:00:00
TOWNSVILLE,1989,6,897,859,1756,1989-06-01T00:00:00
TOWNSVILLE,1989,7,1115,960,2075,1989-07-01T00:00:00
TOWNSVILLE,1989,8,849,835,1684,1989-08-01T00:00:00
TOWNSVILLE,1989,9,981,1145,2126,1989-09-01T00:00:00
TOWNSVILLE,1989,10,779,807,1586,1989-10-01T00:00:00
TOWNSVILLE,1989,11,682,658,1340,1989-11-01T00:00:00
TOWNSVILLE,1989,12,766,1062,1828,1989-12-01T00:00:00
TOWNSVILLE,1990,1,899,775,1674,1990-01-01T00:00:00
TOWNSVILLE,1990,2,701,611,1312,1990-02-01T00:00:00
TOWNSVILLE,1990,3,901,895,1796,1990-03-01T00:00:00
TOWNSVILLE,1990,4,769,815,1584,1990-04-01T00:00:00
TOWNSVILLE,1990,5,789,705,1494,1990-05-01T00:00:00
TOWNSVILLE,1990,6,890,924,1814,1990-06-01T00:00:00
TOWNSVILLE,1990,7,897,817,1714,1990-07-01T00:00:00
TOWNSVILLE,1990,8,741,850,1591,1990-08-01T00:00:00
TOWNSVILLE,1990,9,831,993,1824,1990-09-01T00:00:00
TOWNSVILLE,1990,10,623,694,1317,1990-10-01T00:00:00
TOWNSVILLE,1990,11,428,386,814,1990-11-01T00:00:00
TOWNSVILLE,1990,12,491,680,1171,1990-12-01T00:00:00
TOWNSVILLE,1991,1,669,416,1085,1991-01-01T00:00:00
TOWNSVILLE,1991,2,491,396,887,1991-02-01T00:00:00
TOWNSVILLE,1991,3,461,447,908,1991-03-01T00:00:00
TOWNSVILLE,1991,4,0,0,0,1991-04-01T00:00:00
TOWNSVILLE,1991,5,0,0,0,1991-05-01T00:00:00
TOWNSVILLE,1991,6,0,0,0,1991-06-01T00:00:00
TOWNSVILLE,1991,7,0,0,0,1991-07-01T00:00:00
TOWNSVILLE,1991,8,0,0,0,1991-08-01T00:00:00
TOWNSVILLE,1991,9,0,0,0,1991-09-01T00:00:00
TOWNSVILLE,1991,10,0,0,0,1991-10-01T00:00:00
TOWNSVILLE,1991,11,0,0,0,1991-11-01T00:00:00
TOWNSVILLE,1991,12,0,0,0,1991-12-01T00:00:00
TOWNSVILLE,1992,1,0,0,0,1992-01-01T00:00:00
TOWNSVILLE,1992,2,0,0,0,1992-02-01T00:00:00
TOWNSVILLE,1992,3,0,0,0,1992-03-01T00:00:00
TOWNSVILLE,1992,4,0,0,0,1992-04-01T00:00:00
TOWNSVILLE,1992,5,0,0,0,1992-05-01T00:00:00
TOWNSVILLE,1992,6,0,0,0,1992-06-01T00:00:00
TOWNSVILLE,1992,7,0,0,0,1992-07-01T00:00:00
TOWNSVILLE,1992,8,0,0,0,1992-08-01T00:00:00
TOWNSVILLE,1992,9,0,0,0,1992-09-01T00:00:00
TOWNSVILLE,1992,10,0,0,0,1992-10-01T00:00:00
TOWNSVILLE,1992,11,136,175,311,1992-11-01T00:00:00
TOWNSVILLE,1992,12,226,368,594,1992-12-01T00:00:00
TOWNSVILLE,1993,1,250,149,399,1993-01-01T00:00:00
TOWNSVILLE,1993,2,220,204,424,1993-02-01T00:00:00
TOWNSVILLE,1993,3,187,157,344,1993-03-01T00:00:00
TOWNSVILLE,1993,4,101,111,212,1993-04-01T00:00:00
TOWNSVILLE,1993,5,90,149,239,1993-05-01T00:00:00
TOWNSVILLE,1993,6,144,207,351,1993-06-01T00:00:00
TOWNSVILLE,1993,7,279,246,525,1993-07-01T00:00:00
TOWNSVILLE,1993,8,198,225,423,1993-08-01T00:00:00
TOWNSVILLE,1993,9,199,296,495,1993-09-01T00:00:00
TOWNSVILLE,1993,10,262,179,441,1993-10-01T00:00:00
TOWNSVILLE,1993,11,208,244,452,1993-11-01T00:00:00
TOWNSVILLE,1993,12,297,504,801,1993-12-01T00:00:00
TOWNSVILLE,1994,1,362,271,633,1994-01-01T00:00:00
TOWNSVILLE,1994,2,214,244,458,1994-02-01T00:00:00
TOWNSVILLE,1994,3,141,205,346,1994-03-01T00:00:00
TOWNSVILLE,1994,4,111,252,363,1994-04-01T00:00:00
TOWNSVILLE,1994,5,80,109,189,1994-05-01T00:00:00
TOWNSVILLE,1994,6,143,288,431,1994-06-01T00:00:00
TOWNSVILLE,1994,7,215,309,524,1994-07-01T00:00:00
TOWNSVILLE,1994,8,95,186,281,1994-08-01T00:00:00
TOWNSVILLE,1994,9,144,207,351,1994-09-01T00:00:00
TOWNSVILLE,1994,10,232,223,455,1994-10-01T00:00:00
TOWNSVILLE,1994,11,0,0,0,1994-11-01T00:00:00
TOWNSVILLE,1994,12,0,0,0,1994-12-01T00:00:00
TOWNSVILLE,1995,1,0,0,0,1995-01-01T00:00:00
TOWNSVILLE,1995,2,0,0,0,1995-02-01T00:00:00
TOWNSVILLE,1995,3,0,0,0,1995-03-01T00:00:00
TOWNSVILLE,1995,4,0,0,0,1995-04-01T00:00:00
TOWNSVILLE,1995,5,0,0,0,1995-05-01T00:00:00
TOWNSVILLE,1995,6,0,0,0,1995-06-01T00:00:00
TOWNSVILLE,1995,7,0,0,0,1995-07-01T00:00:00
TOWNSVILLE,1995,8,0,0,0,1995-08-01T00:00:00
TOWNSVILLE,1995,9,0,0,0,1995-09-01T00:00:00
TOWNSVILLE,1995,10,0,0,0,1995-10-01T00:00:00
TOWNSVILLE,1995,11,0,0,0,1995-11-01T00:00:00
TOWNSVILLE,1995,12,0,0,0,1995-12-01T00:00:00
TOWNSVILLE,1996,1,0,0,0,1996-01-01T00:00:00
TOWNSVILLE,1996,2,0,0,0,1996-02-01T00:00:00
TOWNSVILLE,1996,3,0,0,0,1996-03-01T00:00:00
TOWNSVILLE,1996,4,0,0,0,1996-04-01T00:00:00
TOWNSVILLE,1996,5,0,0,0,1996-05-01T00:00:00
TOWNSVILLE,1996,6,0,0,0,1996-06-01T00:00:00
TOWNSVILLE,1996,7,0,0,0,1996-07-01T00:00:00
TOWNSVILLE,1996,8,0,0,0,1996-08-01T00:00:00
TOWNSVILLE,1996,9,0,0,0,1996-09-01T00:00:00
TOWNSVILLE,1996,10,0,0,0,1996-10-01T00:00:00
TOWNSVILLE,1996,11,0,0,0,1996-11-01T00:00:00
TOWNSVILLE,1996,12,0,0,0,1996-12-01T00:00:00
TOWNSVILLE,1997,1,0,0,0,1997-01-01T00:00:00
TOWNSVILLE,1997,2,0,0,0,1997-02-01T00:00:00
TOWNSVILLE,1997,3,0,0,0,1997-03-01T00:00:00
TOWNSVILLE,1997,4,0,0,0,1997-04-01T00:00:00
TOWNSVILLE,1997,5,18,0,18,1997-05-01T00:00:00
TOWNSVILLE,1997,6,36,40,76,1997-06-01T00:00:00
TOWNSVILLE,1997,7,24,37,61,1997-07-01T00:00:00
TOWNSVILLE,1997,8,25,28,53,1997-08-01T00:00:00
TOWNSVILLE,1997,9,3,26,29,1997-09-01T00:00:00
TOWNSVILLE,1997,10,0,3,3,1997-10-01T00:00:00
TOWNSVILLE,1997,11,0,0,0,1997-11-01T00:00:00
TOWNSVILLE,1997,12,0,0,0,1997-12-01T00:00:00
TOWNSVILLE,1998,1,0,0,0,1998-01-01T00:00:00
TOWNSVILLE,1998,2,0,0,0,1998-02-01T00:00:00
TOWNSVILLE,1998,3,0,0,0,1998-03-01T00:00:00
TOWNSVILLE,1998,4,0,0,0,1998-04-01T00:00:00
TOWNSVILLE,1998,5,0,0,0,1998-05-01T00:00:00
TOWNSVILLE,1998,6,0,0,0,1998-06-01T00:00:00
TOWNSVILLE,1998,7,0,0,0,1998-07-01T00:00:00
TOWNSVILLE,1998,8,0,0,0,1998-08-01T00:00:00
TOWNSVILLE,1998,9,0,0,0,1998-09-01T00:00:00
TOWNSVILLE,1998,10,23,42,65,1998-10-01T00:00:00
TOWNSVILLE,1998,11,53,58,111,1998-11-01T00:00:00
TOWNSVILLE,1998,12,171,69,240,1998-12-01T00:00:00
TOWNSVILLE,1999,1,88,54,142,1999-01-01T00:00:00
TOWNSVILLE,1999,2,37,63,100,1999-02-01T00:00:00
TOWNSVILLE,1999,3,0,0,0,1999-03-01T00:00:00
TOWNSVILLE,1999,4,0,0,0,1999-04-01T00:00:00
TOWNSVILLE,1999,5,0,0,0,1999-05-01T00:00:00
TOWNSVILLE,1999,6,0,0,0,1999-06-01T00:00:00
TOWNSVILLE,1999,7,0,0,0,1999-07-01T00:00:00
TOWNSVILLE,1999,8,0,0,0,1999-08-01T00:00:00
TOWNSVILLE,1999,9,0,0,0,1999-09-01T00:00:00
TOWNSVILLE,1999,10,0,0,0,1999-10-01T00:00:00
TOWNSVILLE,1999,11,0,0,0,1999-11-01T00:00:00
TOWNSVILLE,1999,12,0,0,0,1999-12-01T00:00:00
TOWNSVILLE,2000,1,0,0,0,2000-01-01T00:00:00
TOWNSVILLE,2000,2,0,0,0,2000-02-01T00:00:00
TOWNSVILLE,2000,3,0,0,0,2000-03-01T00:00:00
TOWNSVILLE,2000,4,0,0,0,2000-04-01T00:00:00
TOWNSVILLE,2000,5,0,0,0,2000-05-01T00:00:00
TOWNSVILLE,2000,6,0,0,0,2000-06-01T00:00:00
TOWNSVILLE,2000,7,0,0,0,2000-07-01T00:00:00
TOWNSVILLE,2000,8,0,0,0,2000-08-01T00:00:00
TOWNSVILLE,2000,9,0,0,0,2000-09-01T00:00:00
TOWNSVILLE,2000,10,0,0,0,2000-10-01T00:00:00
TOWNSVILLE,2000,11,0,0,0,2000-11-01T00:00:00
TOWNSVILLE,2000,12,0,0,0,2000-12-01T00:00:00
TOWNSVILLE,2001,1,0,0,0,2001-01-01T00:00:00
TOWNSVILLE,2001,2,0,0,0,2001-02-01T00:00:00
TOWNSVILLE,2001,3,0,0,0,2001-03-01T00:00:00
TOWNSVILLE,2001,4,0,0,0,2001-04-01T00:00:00
TOWNSVILLE,2001,5,0,0,0,2001-05-01T00:00:00
TOWNSVILLE,2001,6,0,0,0,2001-06-01T00:00:00
TOWNSVILLE,2001,7,0,0,0,2001-07-01T00:00:00
TOWNSVILLE,2001,8,0,0,0,2001-08-01T00:00:00
TOWNSVILLE,2001,9,0,0,0,2001-09-01T00:00:00
TOWNSVILLE,2001,10,1,8,9,2001-10-01T00:00:00
TOWNSVILLE,2001,11,44,44,88,2001-11-01T00:00:00
TOWNSVILLE,2001,12,23,27,50,2001-12-01T00:00:00
TOWNSVILLE,2002,1,0,0,0,2002-01-01T00:00:00
TOWNSVILLE,2002,2,0,0,0,2002-02-01T00:00:00
TOWNSVILLE,2002,3,0,0,0,2002-03-01T00:00:00
TOWNSVILLE,2002,4,0,0,0,2002-04-01T00:00:00
TOWNSVILLE,2002,5,0,0,0,2002-05-01T00:00:00
TOWNSVILLE,2002,6,0,0,0,2002-06-01T00:00:00
TOWNSVILLE,2002,7,0,0,0,2002-07-01T00:00:00
TOWNSVILLE,2002,8,0,0,0,2002-08-01T00:00:00
TOWNSVILLE,2002,9,0,0,0,2002-09-01T00:00:00
TOWNSVILLE,2002,10,0,0,0,2002-10-01T00:00:00
TOWNSVILLE,2002,11,0,0,0,2002-11-01T00:00:00
TOWNSVILLE,2002,12,0,0,0,2002-12-01T00:00:00
TOWNSVILLE,2003,1,0,0,0,2003-01-01T00:00:00
TOWNSVILLE,2003,2,0,0,0,2003-02-01T00:00:00
TOWNSVILLE,2003,3,0,0,0,2003-03-01T00:00:00
TOWNSVILLE,2003,4,0,0,0,2003-04-01T00:00:00
TOWNSVILLE,2003,5,0,0,0,2003-05-01T00:00:00
TOWNSVILLE,2003,6,0,0,0,2003-06-01T00:00:00
TOWNSVILLE,2003,7,0,0,0,2003-07-01T00:00:00
TOWNSVILLE,2003,8,0,0,0,2003-08-01T00:00:00
TOWNSVILLE,2003,9,0,0,0,2003-09-01T00:00:00
TOWNSVILLE,2003,10,0,0,0,2003-10-01T00:00:00
TOWNSVILLE,2003,11,0,0,0,2003-11-01T00:00:00
TOWNSVILLE,2003,12,0,0,0,2003-12-01T00:00:00
TOWNSVILLE,2004,1,0,0,0,2004-01-01T00:00:00
TOWNSVILLE,2004,2,0,0,0,2004-02-01T00:00:00
TOWNSVILLE,2004,3,0,0,0,2004-03-01T00:00:00
TOWNSVILLE,2004,4,0,0,0,2004-04-01T00:00:00
TOWNSVILLE,2004,5,0,0,0,2004-05-01T00:00:00
TOWNSVILLE,2004,6,0,0,0,2004-06-01T00:00:00
TOWNSVILLE,2004,7,0,0,0,2004-07-01T00:00:00
TOWNSVILLE,2004,8,0,0,0,2004-08-01T00:00:00
TOWNSVILLE,2004,9,0,0,0,2004-09-01T00:00:00
TOWNSVILLE,2004,10,0,0,0,2004-10-01T00:00:00
TOWNSVILLE,2004,11,0,0,0,2004-11-01T00:00:00
TOWNSVILLE,2004,12,0,0,0,2004-12-01T00:00:00
TOWNSVILLE,2005,1,0,0,0,2005-01-01T00:00:00
TOWNSVILLE,2005,2,0,0,0,2005-02-01T00:00:00
TOWNSVILLE,2005,3,0,0,0,2005-03-01T00:00:00
TOWNSVILLE,2005,4,0,0,0,2005-04-01T00:00:00
TOWNSVILLE,2005,5,0,0,0,2005-05-01T00:00:00
TOWNSVILLE,2005,6,0,0,0,2005-06-01T00:00:00
TOWNSVILLE,2005,7,0,0,0,2005-07-01T00:00:00
TOWNSVILLE,2005,8,0,0,0,2005-08-01T00:00:00
TOWNSVILLE,2005,9,0,0,0,2005-09-01T00:00:00
TOWNSVILLE,2005,10,0,0,0,2005-10-01T00:00:00
TOWNSVILLE,2005,11,0,0,0,2005-11-01T00:00:00
TOWNSVILLE,2005,12,0,0,0,2005-12-01T00:00:00
TOWNSVILLE,2006,1,0,0,0,2006-01-01T00:00:00
TOWNSVILLE,2006,2,0,0,0,2006-02-01T00:00:00
TOWNSVILLE,2006,3,0,0,0,2006-03-01T00:00:00
TOWNSVILLE,2006,4,0,0,0,2006-04-01T00:00:00
TOWNSVILLE,2006,5,0,0,0,2006-05-01T00:00:00
TOWNSVILLE,2006,6,0,0,0,2006-06-01T00:00:00
TOWNSVILLE,2006,7,0,0,0,2006-07-01T00:00:00
TOWNSVILLE,2006,8,0,0,0,2006-08-01T00:00:00
TOWNSVILLE,2006,9,0,0,0,2006-09-01T00:00:00
TOWNSVILLE,2006,10,0,0,0,2006-10-01T00:00:00
TOWNSVILLE,2006,11,0,0,0,2006-11-01T00:00:00
TOWNSVILLE,2006,12,0,0,0,2006-12-01T00:00:00
TOWNSVILLE,2007,1,0,0,0,2007-01-01T00:00:00
TOWNSVILLE,2007,2,0,0,0,2007-02-01T00:00:00
TOWNSVILLE,2007,3,0,0,0,2007-03-01T00:00:00
TOWNSVILLE,2007,4,0,0,0,2007-04-01T00:00:00
TOWNSVILLE,2007,5,0,0,0,2007-05-01T00:00:00
TOWNSVILLE,2007,6,0,0,0,2007-06-01T00:00:00
TOWNSVILLE,2007,7,0,0,0,2007-07-01T00:00:00
TOWNSVILLE,2007,8,0,0,0,2007-08-01T00:00:00
TOWNSVILLE,2007,9,0,0,0,2007-09-01T00:00:00
TOWNSVILLE,2007,10,0,0,0,2007-10-01T00:00:00
TOWNSVILLE,2007,11,0,0,0,2007-11-01T00:00:00
TOWNSVILLE,2007,12,0,0,0,2007-12-01T00:00:00
TOWNSVILLE,2008,1,0,0,0,2008-01-01T00:00:00
TOWNSVILLE,2008,2,0,0,0,2008-02-01T00:00:00
TOWNSVILLE,2008,3,0,0,0,2008-03-01T00:00:00
TOWNSVILLE,2008,4,0,0,0,2008-04-01T00:00:00
TOWNSVILLE,2008,5,0,0,0,2008-05-01T00:00:00
TOWNSVILLE,2008,6,0,0,0,2008-06-01T00:00:00
TOWNSVILLE,2008,7,0,0,0,2008-07-01T00:00:00
TOWNSVILLE,2008,8,0,0,0,2008-08-01T00:00:00
TOWNSVILLE,2008,9,0,0,0,2008-09-01T00:00:00
TOWNSVILLE,2008,10,0,0,0,2008-10-01T00:00:00
TOWNSVILLE,2008,11,0,0,0,2008-11-01T00:00:00
TOWNSVILLE,2008,12,0,0,0,2008-12-01T00:00:00
TOWNSVILLE,2009,1,0,0,0,2009-01-01T00:00:00
TOWNSVILLE,2009,2,0,0,0,2009-02-01T00:00:00
TOWNSVILLE,2009,3,0,0,0,2009-03-01T00:00:00
TOWNSVILLE,2009,4,0,0,0,2009-04-01T00:00:00
TOWNSVILLE,2009,5,0,0,0,2009-05-01T00:00:00
TOWNSVILLE,2009,6,0,0,0,2009-06-01T00:00:00
TOWNSVILLE,2009,7,0,0,0,2009-07-01T00:00:00
TOWNSVILLE,2009,8,0,0,0,2009-08-01T00:00:00
TOWNSVILLE,2009,9,0,0,0,2009-09-01T00:00:00
TOWNSVILLE,2009,10,0,0,0,2009-10-01T00:00:00
TOWNSVILLE,2009,11,0,0,0,2009-11-01T00:00:00
TOWNSVILLE,2009,12,0,0,0,2009-12-01T00:00:00
TOWNSVILLE,2010,1,0,0,0,2010-01-01T00:00:00
TOWNSVILLE,2010,2,0,0,0,2010-02-01T00:00:00
TOWNSVILLE,2010,3,0,0,0,2010-03-01T00:00:00
TOWNSVILLE,2010,4,0,0,0,2010-04-01T00:00:00
TOWNSVILLE,2010,5,0,0,0,2010-05-01T00:00:00
TOWNSVILLE,2010,6,0,0,0,2010-06-01T00:00:00
TOWNSVILLE,2010,7,0,0,0,2010-07-01T00:00:00
TOWNSVILLE,2010,8,0,0,0,2010-08-01T00:00:00
TOWNSVILLE,2010,9,0,0,0,2010-09-01T00:00:00
TOWNSVILLE,2010,10,0,0,0,2010-10-01T00:00:00
TOWNSVILLE,2010,11,0,0,0,2010-11-01T00:00:00
TOWNSVILLE,2010,12,432,882,1314,2010-12-01T00:00:00
TOWNSVILLE,2011,1,1124,818,1942,2011-01-01T00:00:00
TOWNSVILLE,2011,2,567,593,1160,2011-02-01T00:00:00
TOWNSVILLE,2011,3,537,617,1154,2011-03-01T00:00:00
TOWNSVILLE,2011,4,437,567,1004,2011-04-01T00:00:00
TOWNSVILLE,2011,5,524,321,845,2011-05-01T00:00:00
TOWNSVILLE,2011,6,355,399,754,2011-06-01T00:00:00
TOWNSVILLE,2011,7,611,514,1125,2011-07-01T00:00:00
TOWNSVILLE,2011,8,400,340,740,2011-08-01T00:00:00
TOWNSVILLE,2011,9,476,290,766,2011-09-01T00:00:00
TOWNSVILLE,2011,10,15,87,102,2011-10-01T00:00:00
TOWNSVILLE,2011,11,0,0,0,2011-11-01T00:00:00
TOWNSVILLE,2011,12,0,0,0,2011-12-01T00:00:00
TOWNSVILLE,2012,1,0,0,0,2012-01-01T00:00:00
TOWNSVILLE,2012,2,0,0,0,2012-02-01T00:00:00
TOWNSVILLE,2012,3,0,0,0,2012-03-01T00:00:00
TOWNSVILLE,2012,4,0,0,0,2012-04-01T00:00:00
TOWNSVILLE,2012,5,0,0,0,2012-05-01T00:00:00
TOWNSVILLE,2012,6,0,0,0,2012-06-01T00:00:00
TOWNSVILLE,2012,7,0,0,0,2012-07-01T00:00:00
TOWNSVILLE,2012,8,0,0,0,2012-08-01T00:00:00
TOWNSVILLE,2012,9,0,0,0,2012-09-01T00:00:00
TOWNSVILLE,2012,10,0,0,0,2012-10-01T00:00:00
TOWNSVILLE,2012,11,0,0,0,2012-11-01T00:00:00
TOWNSVILLE,2012,12,0,0,0,2012-12-01T00:00:00
TOWNSVILLE,2013,1,0,0,0,2013-01-01T00:00:00
TOWNSVILLE,2013,2,0,0,0,2013-02-01T00:00:00
TOWNSVILLE,2013,3,0,0,0,2013-03-01T00:00:00
TOWNSVILLE,2013,4,0,0,0,2013-04-01T00:00:00
TOWNSVILLE,2013,5,0,0,0,2013-05-01T00:00:00
TOWNSVILLE,2013,6,0,0,0,2013-06-01T00:00:00
TOWNSVILLE,2013,7,0,0,0,2013-07-01T00:00:00
TOWNSVILLE,2013,8,0,0,0,2013-08-01T00:00:00
TOWNSVILLE,2013,9,0,0,0,2013-09-01T00:00:00
TOWNSVILLE,2013,10,0,0,0,2013-10-01T00:00:00
TOWNSVILLE,2013,11,0,0,0,2013-11-01T00:00:00
TOWNSVILLE,2013,12,0,0,0,2013-12-01T00:00:00
TOWNSVILLE,2014,1,0,0,0,2014-01-01T00:00:00
TOWNSVILLE,2014,2,0,0,0,2014-02-01T00:00:00
TOWNSVILLE,2014,3,0,0,0,2014-03-01T00:00:00
TOWNSVILLE,2014,4,0,0,0,2014-04-01T00:00:00
TOWNSVILLE,2014,5,0,0,0,2014-05-01T00:00:00
TOWNSVILLE,2014,6,0,0,0,2014-06-01T00:00:00
TOWNSVILLE,2014,7,0,0,0,2014-07-01T00:00:00
TOWNSVILLE,2014,8,0,0,0,2014-08-01T00:00:00
TOWNSVILLE,2014,9,0,0,0,2014-09-01T00:00:00
TOWNSVILLE,2014,10,0,0,0,2014-10-01T00:00:00
TOWNSVILLE,2014,11,0,0,0,2014-11-01T00:00:00
TOWNSVILLE,2014,12,0,0,0,2014-12-01T00:00:00
TOWNSVILLE,2015,1,0,0,0,2015-01-01T00:00:00
TOWNSVILLE,2015,2,0,0,0,2015-02-01T00:00:00
TOWNSVILLE,2015,3,0,0,0,2015-03-01T00:00:00
TOWNSVILLE,2015,4,0,0,0,2015-04-01T00:00:00
TOWNSVILLE,2015,5,0,0,0,2015-05-01T00:00:00
TOWNSVILLE,2015,6,0,0,0,2015-06-01T00:00:00
TOWNSVILLE,2015,7,0,0,0,2015-07-01T00:00:00
TOWNSVILLE,2015,8,0,0,0,2015-08-01T00:00:00
TOWNSVILLE,2015,9,1111,1698,2809,2015-09-01T00:00:00
TOWNSVILLE,2015,10,1815,1720,3535,2015-10-01T00:00:00
TOWNSVILLE,2015,11,348,881,1229,2015-11-01T00:00:00
TOWNSVILLE,2015,12,1571,1979,3550,2015-12-01T00:00:00
TOWNSVILLE,2016,1,1864,1370,0,2016-01-01T00:00:00
TOWNSVILLE,2016,2,1352,1370,0,2016-02-01T00:00:00
TOWNSVILLE,2016,3,1555,1604,0,2016-03-01T00:00:00
TOWNSVILLE,2016,4,1417,1604,0,2016-04-01T00:00:00
TOWNSVILLE,2016,5,1685,1933,0,2016-05-01T00:00:00
TOWNSVILLE,2016,6,1663,2044,0,2016-06-01T00:00:00
TOWNSVILLE,2016,7,1973,1919,0,2016-07-01T00:00:00
TOWNSVILLE,2016,8,1609,1800,0,2016-08-01T00:00:00
TOWNSVILLE,2016,9,1969,1734,0,2016-09-01T00:00:00
TOWNSVILLE,2016,10,2053,1842,0,2016-10-01T00:00:00
TOWNSVILLE,2016,11,1523,1763,0,2016-11-01T00:00:00
TOWNSVILLE,2016,12,1746,2087,0,2016-12-01T00:00:00
TOWNSVILLE,2017,1,2224,1623,0,2017-01-01T00:00:00
TOWNSVILLE,2017,2,1677,1594,0,2017-02-01T00:00:00
TOWNSVILLE,2017,3,1603,1632,0,2017-03-01T00:00:00
TOWNSVILLE,2017,4,2025,2257,0,2017-04-01T00:00:00
TOWNSVILLE,2017,5,1954,2370,0,2017-05-01T00:00:00
TOWNSVILLE,2017,6,2106,2123,0,2017-06-01T00:00:00
TOWNSVILLE,2017,7,2452,2457,0,2017-07-01T00:00:00
TOWNSVILLE,2017,8,2373,2231,0,2017-08-01T00:00:00
TOWNSVILLE,2017,9,2197,2368,0,2017-09-01T00:00:00
TOWNSVILLE,2017,10,2278,2100,0,2017-10-01T00:00:00
TOWNSVILLE,2017,11,1622,1747,0,2017-11-01T00:00:00
TOWNSVILLE,2017,12,1467,2055,0,2017-12-01T00:00:00
TOWNSVILLE,2018,1,2279,2327,0,2018-01-01T00:00:00
TOWNSVILLE,2018,2,2180,2140,0,2018-02-01T00:00:00
TOWNSVILLE,2018,3,1744,1355,0,2018-03-01T00:00:00
TOWNSVILLE,2018,4,415,443,0,2018-04-01T00:00:00
TOWNSVILLE,2018,5,263,284,0,2018-05-01T00:00:00
TOWNSVILLE,2018,6,375,318,0,2018-06-01T00:00:00
TOWNSVILLE,2018,7,425,383,0,2018-07-01T00:00:00
TOWNSVILLE,2018,8,354,318,0,2018-08-01T00:00:00
TOWNSVILLE,2018,9,252,332,0,2018-09-01T00:00:00
TOWNSVILLE,2018,10,0,0,0,2018-10-01T00:00:00
TOWNSVILLE,2018,11,0,0,0,2018-11-01T00:00:00
TOWNSVILLE,2018,12,0,0,0,2018-12-01T00:00:00
TOWNSVILLE,2019,1,0,0,0,2019-01-01T00:00:00
TOWNSVILLE,2019,2,0,0,0,2019-02-01T00:00:00
TOWNSVILLE,2019,3,0,0,0,2019-03-01T00:00:00
TOWNSVILLE,2019,4,0,0,0,2019-04-01T00:00:00
TOWNSVILLE,2019,5,0,0,0,2019-05-01T00:00:00
TOWNSVILLE,2019,6,0,0,0,2019-06-01T00:00:00
TOWNSVILLE,2019,7,0,0,0,2019-07-01T00:00:00
TOWNSVILLE,2019,8,0,0,0,2019-08-01T00:00:00
TOWNSVILLE,2019,9,0,0,0,2019-09-01T00:00:00
TOWNSVILLE,2019,10,0,0,0,2019-10-01T00:00:00
TOWNSVILLE,2019,11,0,0,0,2019-11-01T00:00:00
TOWNSVILLE,2019,12,0,0,0,2019-12-01T00:00:00
TOWNSVILLE,2020,1,0,0,0,2020-01-01T00:00:00
TOWNSVILLE,2020,2,0,0,0,2020-02-01T00:00:00
TOWNSVILLE,2020,3,0,0,0,2020-03-01T00:00:00
TOWNSVILLE,2020,4,0,0,0,2020-04-01T00:00:00
TOWNSVILLE,2020,5,0,0,0,2020-05-01T00:00:00
TOWNSVILLE,2020,6,0,0,0,2020-06-01T00:00:00
TOWNSVILLE,2020,7,0,0,0,2020-07-01T00:00:00
TOWNSVILLE,2020,8,0,0,0,2020-08-01T00:00:00
TOWNSVILLE,2020,9,0,0,0,2020-09-01T00:00:00
TOWNSVILLE,2020,10,0,0,0,2020-10-01T00:00:00
TOWNSVILLE,2020,11,0,0,0,2020-11-01T00:00:00
TOWNSVILLE,2020,12,0,0,0,2020-12-01T00:00:00
TOWNSVILLE,2021,1,0,0,0,2021-01-01T00:00:00
TOWNSVILLE,2021,2,0,0,0,2021-02-01T00:00:00
TOWNSVILLE,2021,3,0,0,0,2021-03-01T00:00:00
TOWNSVILLE,2021,4,0,0,0,2021-04-01T00:00:00
TOWNSVILLE,2021,5,0,0,0,2021-05-01T00:00:00
TOWNSVILLE,2021,6,0,0,0,2021-06-01T00:00:00
TOWNSVILLE,2021,7,0,0,0,2021-07-01T00:00:00
TOWNSVILLE,2021,8,0,0,0,2021-08-01T00:00:00
TOWNSVILLE,2021,9,0,0,0,2021-09-01T00:00:00
TOWNSVILLE,2021,10,0,0,0,2021-10-01T00:00:00
TOWNSVILLE,2021,11,0,0,0,2021-11-01T00:00:00
TOWNSVILLE,2021,12,0,0,0,2021-12-01T00:00:00
TOWNSVILLE,2022,1,0,0,0,2022-01-01T00:00:00
TOWNSVILLE,2022,2,0,0,0,2022-02-01T00:00:00
TOWNSVILLE,2022,3,0,0,0,2022-03-01T00:00:00
TOWNSVILLE,2022,4,0,0,0,2022-04-01T00:00:00
TOWNSVILLE,2022,5,0,0,0,2022-05-01T00:00:00
TOWNSVILLE,2022,6,0,0,0,2022-06-01T00:00:00
TOWNSVILLE,2022,7,0,0,0,2022-07-01T00:00:00
TOWNSVILLE,2022,8,0,0,0,2022-08-01T00:00:00
TOWNSVILLE,2022,9,0,0,0,2022-09-01T00:00:00
TOWNSVILLE,2022,10,0,0,0,2022-10-01T00:00:00
TOWNSVILLE,2022,11,0,0,0,2022-11-01T00:00:00
TOWNSVILLE,2022,12,0,0,0,2022-12-01T00:00:00
TOWNSVILLE,2023,1,0,0,0,2023-01-01T00:00:00
TOWNSVILLE,2023,2,0,0,0,2023-02-01T00:00:00
TOWNSVILLE,2023,3,0,0,0,2023-03-01T00:00:00
TOWNSVILLE,2023,4,0,0,0,2023-04-01T00:00:00
TOWNSVILLE,2023,5,0,0,0,2023-05-01T00:00:00
TOWNSVILLE,2023,6,0,0,0,2023-06-01T00:00:00
TOWNSVILLE,2023,7,0,0,0,2023-07-01T00:00:00
TOWNSVILLE,2023,8,0,0,0,2023-08-01T00:00:00
TOWNSVILLE,2023,9,0,0,0,2023-09-01T00:00:00
TOWNSVILLE,2023,10,0,0,0,2023-10-01T00:00:00
TOWNSVILLE,2023,11,0,0,0,2023-11-01T00:00:00
TOWNSVILLE,2023,12,0,0,0,2023-12-01T00:00:00
TOWNSVILLE,2024,1,0,0,0,2024-01-01T00:00:00
TOWNSVILLE,2024,2,0,0,0,2024-02-01T00:00:00
TOWNSVILLE,2024,3,0,0,0,2024-03-01T00:00:00
TOWNSVILLE,2024,4,0,0,0,2024-04-01T00:00:00
TOWNSVILLE,2024,5,0,0,0,2024-05-01T00:00:00
TOWNSVILLE,2024,6,0,0,0,2024-06-01T00:00:00
TOWNSVILLE,2024,7,0,0,0,2024-07-01T00:00:00
TOWNSVILLE,2024,8,0,0,0,2024-08-01T00:00:00
TOWNSVILLE,2024,9,0,0,0,2024-09-01T00:00:00
TOWNSVILLE,2024,10,0,0,0,2024-10-01T00:00:00
TOWNSVILLE,2024,11,0,0,0,2024-11-01T00:00:00
TOWNSVILLE,2024,12,0,0,0,2024-12-01T00:00:00
TOWNSVILLE,2025,1,0,0,0,2025-01-01T00:00:00
TOWNSVILLE,2025,2,0,0,0,2025-02-01T00:00:00
TOWNSVILLE,2025,3,0,0,0,2025-03-01T00:00:00
TOWNSVILLE,2025,4,0,0,0,2025-04-01T00:00:00
TOWNSVILLE,2025,5,0,0,0,2025-05-01T00:00:00
TOWNSVILLE,2025,6,0,0,0,2025-06-01T00:00:00
All Australian Airports,1985,1,263795,208770,472565,1985-01-01T00:00:00
All Australian Airports,1985,2,204953,179222,384175,1985-02-01T00:00:00
All Australian Airports,1985,3,209513,231582,441095,1985-03-01T00:00:00
All Australian Airports,1985,4,182673,214403,397076,1985-04-01T00:00:00
All Australian Airports,1985,5,198902,224350,423252,1985-05-01T00:00:00
All Australian Airports,1985,6,193943,209080,403023,1985-06-01T00:00:00
All Australian Airports,1985,7,206179,196596,402775,1985-07-01T00:00:00
All Australian Airports,1985,8,216594,229109,445703,1985-08-01T00:00:00
All Australian Airports,1985,9,243608,197542,441150,1985-09-01T00:00:00
All Australian Airports,1985,10,249262,178319,427581,1985-10-01T00:00:00
All Australian Airports,1985,11,233980,211234,445214,1985-11-01T00:00:00
All Australian Airports,1985,12,243329,273435,516764,1985-12-01T00:00:00
All Australian Airports,1986,1,292576,237224,529800,1986-01-01T00:00:00
All Australian Airports,1986,2,223688,188004,411692,1986-02-01T00:00:00
All Australian Airports,1986,3,225416,241557,466973,1986-03-01T00:00:00
All Australian Airports,1986,4,208330,243972,452302,1986-04-01T00:00:00
All Australian Airports,1986,5,214800,239637,454437,1986-05-01T00:00:00
All Australian Airports,1986,6,209651,220335,429986,1986-06-01T00:00:00
All Australian Airports,1986,7,239617,228905,468522,1986-07-01T00:00:00
All Australian Airports,1986,8,255503,261532,517035,1986-08-01T00:00:00
All Australian Airports,1986,9,266920,221479,488399,1986-09-01T00:00:00
All Australian Airports,1986,10,282320,213632,495952,1986-10-01T00:00:00
All Australian Airports,1986,11,274844,250773,525617,1986-11-01T00:00:00
All Australian Airports,1986,12,280169,297553,577722,1986-12-01T00:00:00
All Australian Airports,1987,1,336241,278842,615083,1987-01-01T00:00:00
All Australian Airports,1987,2,263562,233605,497167,1987-02-01T00:00:00
All Australian Airports,1987,3,246336,274131,520467,1987-03-01T00:00:00
All Australian Airports,1987,4,245843,258248,504091,1987-04-01T00:00:00
All Australian Airports,1987,5,234032,269714,503746,1987-05-01T00:00:00
All Australian Airports,1987,6,229533,251647,481180,1987-06-01T00:00:00
All Australian Airports,1987,7,304662,273355,578017,1987-07-01T00:00:00
All Australian Airports,1987,8,290267,292715,582982,1987-08-01T00:00:00
All Australian Airports,1987,9,293051,284202,577253,1987-09-01T00:00:00
All Australian Airports,1987,10,358523,261408,619931,1987-10-01T00:00:00
All Australian Airports,1987,11,311171,278325,589496,1987-11-01T00:00:00
All Australian Airports,1987,12,323057,321962,645019,1987-12-01T00:00:00
All Australian Airports,1988,1,371659,322979,694638,1988-01-01T00:00:00
All Australian Airports,1988,2,302167,265724,567891,1988-02-01T00:00:00
All Australian Airports,1988,3,298283,310622,608905,1988-03-01T00:00:00
All Australian Airports,1988,4,288218,297783,586001,1988-04-01T00:00:00
All Australian Airports,1988,5,264494,307690,572184,1988-05-01T00:00:00
All Australian Airports,1988,6,287424,302002,589426,1988-06-01T00:00:00
All Australian Airports,1988,7,366504,320304,686808,1988-07-01T00:00:00
All Australian Airports,1988,8,340569,339043,679612,1988-08-01T00:00:00
All Australian Airports,1988,9,348421,346881,695302,1988-09-01T00:00:00
All Australian Airports,1988,10,392404,312920,705324,1988-10-01T00:00:00
All Australian Airports,1988,11,341635,312110,653745,1988-11-01T00:00:00
All Australian Airports,1988,12,353341,373605,726946,1988-12-01T00:00:00
All Australian Airports,1989,1,406078,353027,759105,1989-01-01T00:00:00
All Australian Airports,1989,2,325524,279992,605516,1989-02-01T00:00:00
All Australian Airports,1989,3,310085,342512,652597,1989-03-01T00:00:00
All Australian Airports,1989,4,299136,315425,614561,1989-04-01T00:00:00
All Australian Airports,1989,5,254512,299689,554201,1989-05-01T00:00:00
All Australian Airports,1989,6,284425,312446,596871,1989-06-01T00:00:00
All Australian Airports,1989,7,370111,317490,687601,1989-07-01T00:00:00
All Australian Airports,1989,8,324349,338415,662764,1989-08-01T00:00:00
All Australian Airports,1989,9,341728,341420,683148,1989-09-01T00:00:00
All Australian Airports,1989,10,391321,292732,684053,1989-10-01T00:00:00
All Australian Airports,1989,11,343052,311100,654152,1989-11-01T00:00:00
All Australian Airports,1989,12,365371,411163,776534,1989-12-01T00:00:00
All Australian Airports,1990,1,434987,370070,805057,1990-01-01T00:00:00
All Australian Airports,1990,2,348203,294226,642429,1990-02-01T00:00:00
All Australian Airports,1990,3,323246,351298,674544,1990-03-01T00:00:00
All Australian Airports,1990,4,335754,370333,706087,1990-04-01T00:00:00
All Australian Airports,1990,5,290503,331581,622084,1990-05-01T00:00:00
All Australian Airports,1990,6,306690,347626,654316,1990-06-01T00:00:00
All Australian Airports,1990,7,396377,351530,747907,1990-07-01T00:00:00
All Australian Airports,1990,8,362706,365264,727970,1990-08-01T00:00:00
All Australian Airports,1990,9,365425,370343,735768,1990-09-01T00:00:00
All Australian Airports,1990,10,415331,311123,726454,1990-10-01T00:00:00
All Australian Airports,1990,11,350086,333334,683420,1990-11-01T00:00:00
All Australian Airports,1990,12,373740,422449,796189,1990-12-01T00:00:00
All Australian Airports,1991,1,436936,366581,803517,1991-01-01T00:00:00
All Australian Airports,1991,2,323487,294390,617877,1991-02-01T00:00:00
All Australian Airports,1991,3,319028,348723,667751,1991-03-01T00:00:00
All Australian Airports,1991,4,300563,320391,620954,1991-04-01T00:00:00
All Australian Airports,1991,5,289444,326351,615795,1991-05-01T00:00:00
All Australian Airports,1991,6,324042,356867,680909,1991-06-01T00:00:00
All Australian Airports,1991,7,409725,364182,773907,1991-07-01T00:00:00
All Australian Airports,1991,8,371301,375371,746672,1991-08-01T00:00:00
All Australian Airports,1991,9,378629,382911,761540,1991-09-01T00:00:00
All Australian Airports,1991,10,435723,353070,788793,1991-10-01T00:00:00
All Australian Airports,1991,11,381203,378711,759914,1991-11-01T00:00:00
All Australian Airports,1991,12,383963,430985,814948,1991-12-01T00:00:00
All Australian Airports,1992,1,452237,384720,836957,1992-01-01T00:00:00
All Australian Airports,1992,2,380351,342690,723041,1992-02-01T00:00:00
All Australian Airports,1992,3,343875,376487,720362,1992-03-01T00:00:00
All Australian Airports,1992,4,358914,390167,749081,1992-04-01T00:00:00
All Australian Airports,1992,5,320192,363908,684100,1992-05-01T00:00:00
All Australian Airports,1992,6,322929,360645,683574,1992-06-01T00:00:00
All Australian Airports,1992,7,435768,393798,829566,1992-07-01T00:00:00
All Australian Airports,1992,8,376059,380893,756952,1992-08-01T00:00:00
All Australian Airports,1992,9,386283,400593,786876,1992-09-01T00:00:00
All Australian Airports,1992,10,457934,355498,813432,1992-10-01T00:00:00
All Australian Airports,1992,11,405635,397517,803152,1992-11-01T00:00:00
All Australian Airports,1992,12,430288,490547,920835,1992-12-01T00:00:00
All Australian Airports,1993,1,516585,438365,954950,1993-01-01T00:00:00
All Australian Airports,1993,2,405308,356814,762122,1993-02-01T00:00:00
All Australian Airports,1993,3,389293,413113,802406,1993-03-01T00:00:00
All Australian Airports,1993,4,385172,416542,801714,1993-04-01T00:00:00
All Australian Airports,1993,5,356028,408986,765014,1993-05-01T00:00:00
All Australian Airports,1993,6,358340,403706,762046,1993-06-01T00:00:00
All Australian Airports,1993,7,472768,403100,875868,1993-07-01T00:00:00
All Australian Airports,1993,8,413429,426981,840410,1993-08-01T00:00:00
All Australian Airports,1993,9,421487,429754,851241,1993-09-01T00:00:00
All Australian Airports,1993,10,506269,405797,912066,1993-10-01T00:00:00
All Australian Airports,1993,11,432614,438218,870832,1993-11-01T00:00:00
All Australian Airports,1993,12,470552,509064,979616,1993-12-01T00:00:00
All Australian Airports,1994,1,527407,469469,996876,1994-01-01T00:00:00
All Australian Airports,1994,2,460291,417938,878229,1994-02-01T00:00:00
All Australian Airports,1994,3,457106,479516,936622,1994-03-01T00:00:00
All Australian Airports,1994,4,420003,448911,868914,1994-04-01T00:00:00
All Australian Airports,1994,5,359926,418249,778175,1994-05-01T00:00:00
All Australian Airports,1994,6,398165,434962,833127,1994-06-01T00:00:00
All Australian Airports,1994,7,522764,453194,975958,1994-07-01T00:00:00
All Australian Airports,1994,8,451024,470159,921183,1994-08-01T00:00:00
All Australian Airports,1994,9,466412,464745,931157,1994-09-01T00:00:00
All Australian Airports,1994,10,543192,444819,988011,1994-10-01T00:00:00
All Australian Airports,1994,11,468686,465186,933872,1994-11-01T00:00:00
All Australian Airports,1994,12,516874,554602,1071476,1994-12-01T00:00:00
All Australian Airports,1995,1,589329,519315,1108644,1995-01-01T00:00:00
All Australian Airports,1995,2,490333,439366,929699,1995-02-01T00:00:00
All Australian Airports,1995,3,466598,502616,969214,1995-03-01T00:00:00
All Australian Airports,1995,4,469570,498096,967666,1995-04-01T00:00:00
All Australian Airports,1995,5,407934,461791,869725,1995-05-01T00:00:00
All Australian Airports,1995,6,437595,461553,899148,1995-06-01T00:00:00
All Australian Airports,1995,7,576773,503218,1079991,1995-07-01T00:00:00
All Australian Airports,1995,8,498982,518535,1017517,1995-08-01T00:00:00
All Australian Airports,1995,9,494221,500676,994897,1995-09-01T00:00:00
All Australian Airports,1995,10,574700,466206,1040906,1995-10-01T00:00:00
All Australian Airports,1995,11,510998,506151,1017149,1995-11-01T00:00:00
All Australian Airports,1995,12,564233,604419,1168652,1995-12-01T00:00:00
All Australian Airports,1996,1,625708,558520,1184228,1996-01-01T00:00:00
All Australian Airports,1996,2,565345,496045,1061390,1996-02-01T00:00:00
All Australian Airports,1996,3,528958,570914,1099872,1996-03-01T00:00:00
All Australian Airports,1996,4,523996,537998,1061994,1996-04-01T00:00:00
All Australian Airports,1996,5,430732,485036,915768,1996-05-01T00:00:00
All Australian Airports,1996,6,497238,539849,1037087,1996-06-01T00:00:00
All Australian Airports,1996,7,600167,531934,1132101,1996-07-01T00:00:00
All Australian Airports,1996,8,539877,566540,1106417,1996-08-01T00:00:00
All Australian Airports,1996,9,543871,549898,1093769,1996-09-01T00:00:00
All Australian Airports,1996,10,638351,516377,1154728,1996-10-01T00:00:00
All Australian Airports,1996,11,573063,559022,1132085,1996-11-01T00:00:00
All Australian Airports,1996,12,623712,664036,1287748,1996-12-01T00:00:00
All Australian Airports,1997,1,675571,614026,1289597,1997-01-01T00:00:00
All Australian Airports,1997,2,593466,525705,1119171,1997-02-01T00:00:00
All Australian Airports,1997,3,582353,615104,1197457,1997-03-01T00:00:00
All Australian Airports,1997,4,528376,564554,1092930,1997-04-01T00:00:00
All Australian Airports,1997,5,477793,541424,1019217,1997-05-01T00:00:00
All Australian Airports,1997,6,519046,574214,1093260,1997-06-01T00:00:00
All Australian Airports,1997,7,684123,590935,1275058,1997-07-01T00:00:00
All Australian Airports,1997,8,561304,600551,1161855,1997-08-01T00:00:00
All Australian Airports,1997,9,575532,572064,1147596,1997-09-01T00:00:00
All Australian Airports,1997,10,672911,554111,1227022,1997-10-01T00:00:00
All Australian Airports,1997,11,594835,594323,1189158,1997-11-01T00:00:00
All Australian Airports,1997,12,608928,653606,1262534,1997-12-01T00:00:00
All Australian Airports,1998,1,680064,614301,1294365,1998-01-01T00:00:00
All Australian Airports,1998,2,568733,515811,1084544,1998-02-01T00:00:00
All Australian Airports,1998,3,535256,573299,1108555,1998-03-01T00:00:00
All Australian Airports,1998,4,564847,602595,1167442,1998-04-01T00:00:00
All Australian Airports,1998,5,500921,563877,1064798,1998-05-01T00:00:00
All Australian Airports,1998,6,530216,566970,1097186,1998-06-01T00:00:00
All Australian Airports,1998,7,664791,582535,1247326,1998-07-01T00:00:00
All Australian Airports,1998,8,581496,621787,1203283,1998-08-01T00:00:00
All Australian Airports,1998,9,601615,591979,1193594,1998-09-01T00:00:00
All Australian Airports,1998,10,692703,586039,1278742,1998-10-01T00:00:00
All Australian Airports,1998,11,595261,597381,1192642,1998-11-01T00:00:00
All Australian Airports,1998,12,637411,667417,1304828,1998-12-01T00:00:00
All Australian Airports,1999,1,711690,663273,1374963,1999-01-01T00:00:00
All Australian Airports,1999,2,608912,533862,1142774,1999-02-01T00:00:00
All Australian Airports,1999,3,602150,626197,1228347,1999-03-01T00:00:00
All Australian Airports,1999,4,575080,609590,1184670,1999-04-01T00:00:00
All Australian Airports,1999,5,517783,562137,1079920,1999-05-01T00:00:00
All Australian Airports,1999,6,542817,590155,1132972,1999-06-01T00:00:00
All Australian Airports,1999,7,706613,611044,1317657,1999-07-01T00:00:00
All Australian Airports,1999,8,611009,672827,1283836,1999-08-01T00:00:00
All Australian Airports,1999,9,645896,643786,1289682,1999-09-01T00:00:00
All Australian Airports,1999,10,734824,611518,1346342,1999-10-01T00:00:00
All Australian Airports,1999,11,643641,637963,1281604,1999-11-01T00:00:00
All Australian Airports,1999,12,641908,681888,1323796,1999-12-01T00:00:00
All Australian Airports,2000,1,719427,685967,1405394,2000-01-01T00:00:00
All Australian Airports,2000,2,666259,590819,1257078,2000-02-01T00:00:00
All Australian Airports,2000,3,626792,664433,1291225,2000-03-01T00:00:00
All Australian Airports,2000,4,670585,705170,1375755,2000-04-01T00:00:00
All Australian Airports,2000,5,559444,629995,1189439,2000-05-01T00:00:00
All Australian Airports,2000,6,590606,631280,1221886,2000-06-01T00:00:00
All Australian Airports,2000,7,765264,667776,1433040,2000-07-01T00:00:00
All Australian Airports,2000,8,653600,692941,1346541,2000-08-01T00:00:00
All Australian Airports,2000,9,709223,683155,1392378,2000-09-01T00:00:00
All Australian Airports,2000,10,784022,701143,1485165,2000-10-01T00:00:00
All Australian Airports,2000,11,729698,730454,1460152,2000-11-01T00:00:00
All Australian Airports,2000,12,789820,839801,1629621,2000-12-01T00:00:00
All Australian Airports,2001,1,855773,798087,1653860,2001-01-01T00:00:00
All Australian Airports,2001,2,703576,615353,1318929,2001-02-01T00:00:00
All Australian Airports,2001,3,688265,723252,1411517,2001-03-01T00:00:00
All Australian Airports,2001,4,695693,729635,1425328,2001-04-01T00:00:00
All Australian Airports,2001,5,582571,656184,1238755,2001-05-01T00:00:00
All Australian Airports,2001,6,647013,684205,1331218,2001-06-01T00:00:00
All Australian Airports,2001,7,819763,727134,1546897,2001-07-01T00:00:00
All Australian Airports,2001,8,688655,739708,1428363,2001-08-01T00:00:00
All Australian Airports,2001,9,691070,687638,1378708,2001-09-01T00:00:00
All Australian Airports,2001,10,728889,607169,1336058,2001-10-01T00:00:00
All Australian Airports,2001,11,617609,620179,1237788,2001-11-01T00:00:00
All Australian Airports,2001,12,730275,762019,1492294,2001-12-01T00:00:00
All Australian Airports,2002,1,782505,745134,1527639,2002-01-01T00:00:00
All Australian Airports,2002,2,691276,625125,1316401,2002-02-01T00:00:00
All Australian Airports,2002,3,718368,729751,1448119,2002-03-01T00:00:00
All Australian Airports,2002,4,624593,673756,1298349,2002-04-01T00:00:00
All Australian Airports,2002,5,574897,636866,1211763,2002-05-01T00:00:00
All Australian Airports,2002,6,605461,658503,1263964,2002-06-01T00:00:00
All Australian Airports,2002,7,778916,685532,1464448,2002-07-01T00:00:00
All Australian Airports,2002,8,672938,713414,1386352,2002-08-01T00:00:00
All Australian Airports,2002,9,675669,682676,1358345,2002-09-01T00:00:00
All Australian Airports,2002,10,803668,654313,1457981,2002-10-01T00:00:00
All Australian Airports,2002,11,693245,696741,1389986,2002-11-01T00:00:00
All Australian Airports,2002,12,750231,808795,1559026,2002-12-01T00:00:00
All Australian Airports,2003,1,829075,769151,1598226,2003-01-01T00:00:00
All Australian Airports,2003,2,701588,612085,1313673,2003-02-01T00:00:00
All Australian Airports,2003,3,649712,663428,1313140,2003-03-01T00:00:00
All Australian Airports,2003,4,560217,582709,1142926,2003-04-01T00:00:00
All Australian Airports,2003,5,479079,524420,1003499,2003-05-01T00:00:00
All Australian Airports,2003,6,533464,587351,1120815,2003-06-01T00:00:00
All Australian Airports,2003,7,754724,666609,1421333,2003-07-01T00:00:00
All Australian Airports,2003,8,658166,714121,1372287,2003-08-01T00:00:00
All Australian Airports,2003,9,713500,714859,1428359,2003-09-01T00:00:00
All Australian Airports,2003,10,816054,678996,1495050,2003-10-01T00:00:00
All Australian Airports,2003,11,750684,773851,1524535,2003-11-01T00:00:00
All Australian Airports,2003,12,816867,900021,1716888,2003-12-01T00:00:00
All Australian Airports,2004,1,920113,858477,1778590,2004-01-01T00:00:00
All Australian Airports,2004,2,790773,686908,1477681,2004-02-01T00:00:00
All Australian Airports,2004,3,736297,778057,1514354,2004-03-01T00:00:00
All Australian Airports,2004,4,753982,794895,1548877,2004-04-01T00:00:00
All Australian Airports,2004,5,651521,728844,1380365,2004-05-01T00:00:00
All Australian Airports,2004,6,696054,776913,1472967,2004-06-01T00:00:00
All Australian Airports,2004,7,936438,793611,1730049,2004-07-01T00:00:00
All Australian Airports,2004,8,764352,817993,1582345,2004-08-01T00:00:00
All Australian Airports,2004,9,797626,805829,1603455,2004-09-01T00:00:00
All Australian Airports,2004,10,927928,773544,1701472,2004-10-01T00:00:00
All Australian Airports,2004,11,823002,845498,1668500,2004-11-01T00:00:00
All Australian Airports,2004,12,909487,1002908,1912395,2004-12-01T00:00:00
All Australian Airports,2005,1,1060578,945553,2006131,2005-01-01T00:00:00
All Australian Airports,2005,2,864702,763893,1628595,2005-02-01T00:00:00
All Australian Airports,2005,3,861116,879480,1740596,2005-03-01T00:00:00
All Australian Airports,2005,4,798150,838242,1636392,2005-04-01T00:00:00
All Australian Airports,2005,5,691481,793283,1484764,2005-05-01T00:00:00
All Australian Airports,2005,6,762552,852487,1615039,2005-06-01T00:00:00
All Australian Airports,2005,7,1020181,858978,1879159,2005-07-01T00:00:00
All Australian Airports,2005,8,830999,891251,1722250,2005-08-01T00:00:00
All Australian Airports,2005,9,881772,860179,1741951,2005-09-01T00:00:00
All Australian Airports,2005,10,973132,804152,1777284,2005-10-01T00:00:00
All Australian Airports,2005,11,827355,863017,1690372,2005-11-01T00:00:00
All Australian Airports,2005,12,931155,1024711,1955866,2005-12-01T00:00:00
All Australian Airports,2006,1,1089012,952277,2041289,2006-01-01T00:00:00
All Australian Airports,2006,2,886500,775376,1661876,2006-02-01T00:00:00
All Australian Airports,2006,3,839841,858257,1698098,2006-03-01T00:00:00
All Australian Airports,2006,4,841414,905572,1746986,2006-04-01T00:00:00
All Australian Airports,2006,5,718313,794689,1513002,2006-05-01T00:00:00
All Australian Airports,2006,6,783796,885022,1668818,2006-06-01T00:00:00
All Australian Airports,2006,7,1027914,854156,1882070,2006-07-01T00:00:00
All Australian Airports,2006,8,837360,887264,1724624,2006-08-01T00:00:00
All Australian Airports,2006,9,908725,889284,1798009,2006-09-01T00:00:00
All Australian Airports,2006,10,1025314,862386,1887700,2006-10-01T00:00:00
All Australian Airports,2006,11,890377,892661,1783038,2006-11-01T00:00:00
All Australian Airports,2006,12,994238,1087336,2081574,2006-12-01T00:00:00
All Australian Airports,2007,1,1126388,1008044,2134432,2007-01-01T00:00:00
All Australian Airports,2007,2,936238,815606,1751844,2007-02-01T00:00:00
All Australian Airports,2007,3,939244,949218,1888462,2007-03-01T00:00:00
All Australian Airports,2007,4,895544,940058,1835602,2007-04-01T00:00:00
All Australian Airports,2007,5,768333,842185,1610518,2007-05-01T00:00:00
All Australian Airports,2007,6,838202,921692,1759894,2007-06-01T00:00:00
All Australian Airports,2007,7,1064144,917921,1982065,2007-07-01T00:00:00
All Australian Airports,2007,8,919038,946558,1865596,2007-08-01T00:00:00
All Australian Airports,2007,9,943556,964058,1907614,2007-09-01T00:00:00
All Australian Airports,2007,10,1085834,895869,1981703,2007-10-01T00:00:00
All Australian Airports,2007,11,950742,952034,1902776,2007-11-01T00:00:00
All Australian Airports,2007,12,1009543,1145630,2155173,2007-12-01T00:00:00
All Australian Airports,2008,1,1187381,1019944,2207325,2008-01-01T00:00:00
All Australian Airports,2008,2,1018866,864662,1883528,2008-02-01T00:00:00
All Australian Airports,2008,3,977974,990109,1968083,2008-03-01T00:00:00
All Australian Airports,2008,4,909650,937104,1846754,2008-04-01T00:00:00
All Australian Airports,2008,5,837552,908433,1745985,2008-05-01T00:00:00
All Australian Airports,2008,6,869243,948728,1817971,2008-06-01T00:00:00
All Australian Airports,2008,7,1147127,980606,2127733,2008-07-01T00:00:00
All Australian Airports,2008,8,944922,980102,1925024,2008-08-01T00:00:00
All Australian Airports,2008,9,933138,938860,1871998,2008-09-01T00:00:00
All Australian Airports,2008,10,1104613,904177,2008790,2008-10-01T00:00:00
All Australian Airports,2008,11,942575,947361,1889936,2008-11-01T00:00:00
All Australian Airports,2008,12,1013369,1165534,2178903,2008-12-01T00:00:00
All Australian Airports,2009,1,1223646,1025778,2249424,2009-01-01T00:00:00
All Australian Airports,2009,2,969607,823540,1793147,2009-02-01T00:00:00
All Australian Airports,2009,3,937697,933843,1871540,2009-03-01T00:00:00
All Australian Airports,2009,4,971404,1004204,1975608,2009-04-01T00:00:00
All Australian Airports,2009,5,842073,922435,1764508,2009-05-01T00:00:00
All Australian Airports,2009,6,853975,975920,1829895,2009-06-01T00:00:00
All Australian Airports,2009,7,1140351,999000,2139351,2009-07-01T00:00:00
All Australian Airports,2009,8,994466,1005333,1999799,2009-08-01T00:00:00
All Australian Airports,2009,9,1041573,1045194,2086767,2009-09-01T00:00:00
All Australian Airports,2009,10,1195265,1022497,2217762,2009-10-01T00:00:00
All Australian Airports,2009,11,1021470,1054438,2075908,2009-11-01T00:00:00
All Australian Airports,2009,12,1115592,1287599,2403191,2009-12-01T00:00:00
All Australian Airports,2010,1,1331612,1151057,2482669,2010-01-01T00:00:00
All Australian Airports,2010,2,1078500,951627,2030127,2010-02-01T00:00:00
All Australian Airports,2010,3,1052707,1092822,2145529,2010-03-01T00:00:00
All Australian Airports,2010,4,1026383,1036390,2062773,2010-04-01T00:00:00
All Australian Airports,2010,5,893089,993010,1886099,2010-05-01T00:00:00
All Australian Airports,2010,6,963769,1131910,2095679,2010-06-01T00:00:00
All Australian Airports,2010,7,1299592,1101544,2401136,2010-07-01T00:00:00
All Australian Airports,2010,8,1083502,1130243,2213745,2010-08-01T00:00:00
All Australian Airports,2010,9,1142673,1173690,2316363,2010-09-01T00:00:00
All Australian Airports,2010,10,1288712,1084487,2373199,2010-10-01T00:00:00
All Australian Airports,2010,11,1084692,1120950,2205642,2010-11-01T00:00:00
All Australian Airports,2010,12,1184169,1393185,2577354,2010-12-01T00:00:00
All Australian Airports,2011,1,1460356,1248767,2709123,2011-01-01T00:00:00
All Australian Airports,2011,2,1139969,980257,2120226,2011-02-01T00:00:00
All Australian Airports,2011,3,1055726,1055897,2111623,2011-03-01T00:00:00
All Australian Airports,2011,4,1097300,1188149,2285449,2011-04-01T00:00:00
All Australian Airports,2011,5,1010388,1069097,2079485,2011-05-01T00:00:00
All Australian Airports,2011,6,991794,1164150,2155944,2011-06-01T00:00:00
All Australian Airports,2011,7,1366044,1165850,2531894,2011-07-01T00:00:00
All Australian Airports,2011,8,1144506,1164418,2308924,2011-08-01T00:00:00
All Australian Airports,2011,9,1167424,1234511,2401935,2011-09-01T00:00:00
All Australian Airports,2011,10,1356836,1119499,2476335,2011-10-01T00:00:00
All Australian Airports,2011,11,1141680,1161292,2302972,2011-11-01T00:00:00
All Australian Airports,2011,12,1219820,1451279,2671099,2011-12-01T00:00:00
All Australian Airports,2012,1,1522951,1280575,2803526,2012-01-01T00:00:00
All Australian Airports,2012,2,1202079,1018688,2220767,2012-02-01T00:00:00
All Australian Airports,2012,3,1140970,1184391,2325361,2012-03-01T00:00:00
All Australian Airports,2012,4,1176642,1202602,2379244,2012-04-01T00:00:00
All Australian Airports,2012,5,1001277,1097826,2099103,2012-05-01T00:00:00
All Australian Airports,2012,6,1093857,1267331,2361188,2012-06-01T00:00:00
All Australian Airports,2012,7,1411426,1183757,2595183,2012-07-01T00:00:00
All Australian Airports,2012,8,1191135,1227542,2418677,2012-08-01T00:00:00
All Australian Airports,2012,9,1241037,1291879,2532916,2012-09-01T00:00:00
All Australian Airports,2012,10,1410564,1162152,2572716,2012-10-01T00:00:00
All Australian Airports,2012,11,1206638,1244036,2450674,2012-11-01T00:00:00
All Australian Airports,2012,12,1314757,1534880,2849637,2012-12-01T00:00:00
All Australian Airports,2013,1,1571356,1316140,2887496,2013-01-01T00:00:00
All Australian Airports,2013,2,1235881,1077428,2313309,2013-02-01T00:00:00
All Australian Airports,2013,3,1225650,1271601,2497251,2013-03-01T00:00:00
All Australian Airports,2013,4,1215952,1233982,2449934,2013-04-01T00:00:00
All Australian Airports,2013,5,1090305,1183884,2274189,2013-05-01T00:00:00
All Australian Airports,2013,6,1148699,1319217,2467916,2013-06-01T00:00:00
All Australian Airports,2013,7,1502141,1293265,2795406,2013-07-01T00:00:00
All Australian Airports,2013,8,1305475,1338815,2644290,2013-08-01T00:00:00
All Australian Airports,2013,9,1317813,1363172,2680985,2013-09-01T00:00:00
All Australian Airports,2013,10,1496725,1212883,2709608,2013-10-01T00:00:00
All Australian Airports,2013,11,1268103,1285380,2553483,2013-11-01T00:00:00
All Australian Airports,2013,12,1403760,1666889,3070649,2013-12-01T00:00:00
All Australian Airports,2014,1,1741156,1460453,3201609,2014-01-01T00:00:00
All Australian Airports,2014,2,1320109,1170234,2490343,2014-02-01T00:00:00
All Australian Airports,2014,3,1256750,1275028,2531778,2014-03-01T00:00:00
All Australian Airports,2014,4,1319185,1390747,2709932,2014-04-01T00:00:00
All Australian Airports,2014,5,1186430,1262179,2448609,2014-05-01T00:00:00
All Australian Airports,2014,6,1174912,1410529,2585441,2014-06-01T00:00:00
All Australian Airports,2014,7,1599897,1357325,2957222,2014-07-01T00:00:00
All Australian Airports,2014,8,1341299,1402976,2744275,2014-08-01T00:00:00
All Australian Airports,2014,9,1377010,1404018,2781028,2014-09-01T00:00:00
All Australian Airports,2014,10,1556897,1297662,2854559,2014-10-01T00:00:00
All Australian Airports,2014,11,1322483,1346054,2668537,2014-11-01T00:00:00
All Australian Airports,2014,12,1449684,1710071,3159755,2014-12-01T00:00:00
All Australian Airports,2015,1,1784287,1498628,3282915,2015-01-01T00:00:00
All Australian Airports,2015,2,1410790,1240775,2651565,2015-02-01T00:00:00
All Australian Airports,2015,3,1370140,1432073,2802213,2015-03-01T00:00:00
All Australian Airports,2015,4,1361635,1384880,2746515,2015-04-01T00:00:00
All Australian Airports,2015,5,1218186,1309275,2527461,2015-05-01T00:00:00
All Australian Airports,2015,6,1232005,1456587,2688592,2015-06-01T00:00:00
All Australian Airports,2015,7,1649910,1439511,3089421,2015-07-01T00:00:00
All Australian Airports,2015,8,1417242,1453713,2870955,2015-08-01T00:00:00
All Australian Airports,2015,9,1458846,1474613,2933459,2015-09-01T00:00:00
All Australian Airports,2015,10,1631063,1391059,3022122,2015-10-01T00:00:00
All Australian Airports,2015,11,1403347,1420285,2823632,2015-11-01T00:00:00
All Australian Airports,2015,12,1580055,1847744,3427799,2015-12-01T00:00:00
All Australian Airports,2016,1,1918216,1642055,3560271,2016-01-01T00:00:00
All Australian Airports,2016,2,1560626,1375056,2935682,2016-02-01T00:00:00
All Australian Airports,2016,3,1470828,1538489,3009317,2016-03-01T00:00:00
All Australian Airports,2016,4,1481132,1478130,2959262,2016-04-01T00:00:00
All Australian Airports,2016,5,1301845,1389018,2690863,2016-05-01T00:00:00
All Australian Airports,2016,6,1330046,1575902,2905948,2016-06-01T00:00:00
All Australian Airports,2016,7,1832875,1574975,3407850,2016-07-01T00:00:00
All Australian Airports,2016,8,1514269,1548743,3063012,2016-08-01T00:00:00
All Australian Airports,2016,9,1583513,1592100,3175613,2016-09-01T00:00:00
All Australian Airports,2016,10,1740278,1485480,3225758,2016-10-01T00:00:00
All Australian Airports,2016,11,1489028,1536531,3025559,2016-11-01T00:00:00
All Australian Airports,2016,12,1691033,1966585,3657618,2016-12-01T00:00:00
All Australian Airports,2017,1,2044464,1757649,3802113,2017-01-01T00:00:00
All Australian Airports,2017,2,1599434,1371201,2970635,2017-02-01T00:00:00
All Australian Airports,2017,3,1509048,1550291,3059339,2017-03-01T00:00:00
All Australian Airports,2017,4,1634650,1673176,3307826,2017-04-01T00:00:00
All Australian Airports,2017,5,1391507,1479723,2871230,2017-05-01T00:00:00
All Australian Airports,2017,6,1425247,1669146,3094393,2017-06-01T00:00:00
All Australian Airports,2017,7,1897855,1643059,3540914,2017-07-01T00:00:00
All Australian Airports,2017,8,1607947,1642140,3250087,2017-08-01T00:00:00
All Australian Airports,2017,9,1649934,1680464,3330398,2017-09-01T00:00:00
All Australian Airports,2017,10,1826871,1543057,3369928,2017-10-01T00:00:00
All Australian Airports,2017,11,1571174,1620735,3191909,2017-11-01T00:00:00
All Australian Airports,2017,12,1773170,2053765,3826935,2017-12-01T00:00:00
All Australian Airports,2018,1,2098405,1786996,3885401,2018-01-01T00:00:00
All Australian Airports,2018,2,1697805,1489815,3187620,2018-02-01T00:00:00
All Australian Airports,2018,3,1660037,1710242,3370279,2018-03-01T00:00:00
All Australian Airports,2018,4,1664141,1697992,3362133,2018-04-01T00:00:00
All Australian Airports,2018,5,1477266,1549386,3026652,2018-05-01T00:00:00
All Australian Airports,2018,6,1504833,1772073,3276906,2018-06-01T00:00:00
All Australian Airports,2018,7,1994170,1716945,3711115,2018-07-01T00:00:00
All Australian Airports,2018,8,1711828,1757645,3469473,2018-08-01T00:00:00
All Australian Airports,2018,9,1710672,1752050,3462722,2018-09-01T00:00:00
All Australian Airports,2018,10,1925383,1622374,3547757,2018-10-01T00:00:00
All Australian Airports,2018,11,1636769,1687907,3324676,2018-11-01T00:00:00
All Australian Airports,2018,12,1808282,2142297,3950579,2018-12-01T00:00:00
All Australian Airports,2019,1,2187442,1885630,4073072,2019-01-01T00:00:00
All Australian Airports,2019,2,1757525,1499283,3256808,2019-02-01T00:00:00
All Australian Airports,2019,3,1629562,1655711,3285273,2019-03-01T00:00:00
All Australian Airports,2019,4,1701680,1801316,3502996,2019-04-01T00:00:00
All Australian Airports,2019,5,1579940,1627989,3207929,2019-05-01T00:00:00
All Australian Airports,2019,6,1545754,1782850,3328604,2019-06-01T00:00:00
All Australian Airports,2019,7,1985113,1750509,3735622,2019-07-01T00:00:00
All Australian Airports,2019,8,1766857,1801853,3568710,2019-08-01T00:00:00
All Australian Airports,2019,9,1721451,1775323,3496774,2019-09-01T00:00:00
All Australian Airports,2019,10,1926829,1660334,3587163,2019-10-01T00:00:00
All Australian Airports,2019,11,1702426,1724008,3426434,2019-11-01T00:00:00
All Australian Airports,2019,12,1846338,2192732,4039070,2019-12-01T00:00:00
All Australian Airports,2020,1,2215508,1938543,4154051,2020-01-01T00:00:00
All Australian Airports,2020,2,1529809,1275620,2805429,2020-02-01T00:00:00
All Australian Airports,2020,3,887482,838247,1725729,2020-03-01T00:00:00
All Australian Airports,2020,4,17304,58002,75306,2020-04-01T00:00:00
All Australian Airports,2020,5,18749,34240,52989,2020-05-01T00:00:00
All Australian Airports,2020,6,25244,39591,64835,2020-06-01T00:00:00
All Australian Airports,2020,7,20016,53835,73851,2020-07-01T00:00:00
All Australian Airports,2020,8,15549,56449,71998,2020-08-01T00:00:00
All Australian Airports,2020,9,15413,46707,62120,2020-09-01T00:00:00
All Australian Airports,2020,10,23559,45618,69177,2020-10-01T00:00:00
All Australian Airports,2020,11,26167,41044,67211,2020-11-01T00:00:00
All Australian Airports,2020,12,32335,47173,79508,2020-12-01T00:00:00
All Australian Airports,2021,1,27823,39649,67472,2021-01-01T00:00:00
All Australian Airports,2021,2,22040,29573,51613,2021-02-01T00:00:00
All Australian Airports,2021,3,28204,30287,58491,2021-03-01T00:00:00
All Australian Airports,2021,4,50398,62540,112938,2021-04-01T00:00:00
All Australian Airports,2021,5,108911,105335,214246,2021-05-01T00:00:00
All Australian Airports,2021,6,97495,96795,194290,2021-06-01T00:00:00
All Australian Airports,2021,7,69698,84994,154692,2021-07-01T00:00:00
All Australian Airports,2021,8,21142,35215,56357,2021-08-01T00:00:00
All Australian Airports,2021,9,12520,29629,42149,2021-09-01T00:00:00
All Australian Airports,2021,10,11760,34385,46145,2021-10-01T00:00:00
All Australian Airports,2021,11,67906,88305,156211,2021-11-01T00:00:00
All Australian Airports,2021,12,184878,215879,400757,2021-12-01T00:00:00
All Australian Airports,2022,1,258368,183907,442275,2022-01-01T00:00:00
All Australian Airports,2022,2,264136,172254,436390,2022-02-01T00:00:00
All Australian Airports,2022,3,369092,329019,698111,2022-03-01T00:00:00
All Australian Airports,2022,4,567077,598702,1165779,2022-04-01T00:00:00
All Australian Airports,2022,5,640888,653826,1294714,2022-05-01T00:00:00
All Australian Airports,2022,6,738579,877319,1615898,2022-06-01T00:00:00
All Australian Airports,2022,7,1086071,971208,2057279,2022-07-01T00:00:00
All Australian Airports,2022,8,1025769,943786,1969555,2022-08-01T00:00:00
All Australian Airports,2022,9,1062946,1032545,2095491,2022-09-01T00:00:00
All Australian Airports,2022,10,1191908,1005302,2197210,2022-10-01T00:00:00
All Australian Airports,2022,11,1181061,1178912,2359973,2022-11-01T00:00:00
All Australian Airports,2022,12,1257845,1488238,2746083,2022-12-01T00:00:00
All Australian Airports,2023,1,1595713,1365286,2960999,2023-01-01T00:00:00
All Australian Airports,2023,2,1354076,1072359,2426435,2023-02-01T00:00:00
All Australian Airports,2023,3,1335992,1313600,2649592,2023-03-01T00:00:00
All Australian Airports,2023,4,1367840,1408119,2775959,2023-04-01T00:00:00
All Australian Airports,2023,5,1296777,1357817,2654594,2023-05-01T00:00:00
All Australian Airports,2023,6,1348155,1545993,2894148,2023-06-01T00:00:00
All Australian Airports,2023,7,1740726,1493114,3233840,2023-07-01T00:00:00
All Australian Airports,2023,8,1543744,1513983,3057727,2023-08-01T00:00:00
All Australian Airports,2023,9,1594956,1584122,3179078,2023-09-01T00:00:00
All Australian Airports,2023,10,1706736,1464593,3171329,2023-10-01T00:00:00
All Australian Airports,2023,11,1535785,1577388,3113173,2023-11-01T00:00:00
All Australian Airports,2023,12,1673868,1987298,3661166,2023-12-01T00:00:00
All Australian Airports,2024,1,2091817,1716775,3808592,2024-01-01T00:00:00
All Australian Airports,2024,2,1741437,1468805,3210242,2024-02-01T00:00:00
All Australian Airports,2024,3,1586833,1678797,3265630,2024-03-01T00:00:00
All Australian Airports,2024,4,1620367,1613381,3233748,2024-04-01T00:00:00
All Australian Airports,2024,5,1473426,1553935,3027361,2024-05-01T00:00:00
All Australian Airports,2024,6,1525730,1755435,3281165,2024-06-01T00:00:00
All Australian Airports,2024,7,1924013,1645739,3569752,2024-07-01T00:00:00
All Australian Airports,2024,8,1650487,1691111,3341598,2024-08-01T00:00:00
All Australian Airports,2024,9,1727807,1789000,3516807,2024-09-01T00:00:00
All Australian Airports,2024,10,1909888,1647507,3557395,2024-10-01T00:00:00
All Australian Airports,2024,11,1687572,1764936,3452508,2024-11-01T00:00:00
All Australian Airports,2024,12,1846530,2246497,4093027,2024-12-01T00:00:00
All Australian Airports,2025,1,2359518,2012459,4371977,2025-01-01T00:00:00
All Australian Airports,2025,2,1846939,1502037,3348976,2025-02-01T00:00:00
All Australian Airports,2025,3,1662586,1655770,3318356,2025-03-01T00:00:00
All Australian Airports,2025,4,1757485,1892381,3649866,2025-04-01T00:00:00
All Australian Airports,2025,5,1660553,1687505,3348058,2025-05-01T00:00:00
All Australian Airports,2025,6,1625030,1817248,3442278,2025-06-01T00:00:00