AIRPORT,Year,Month,Dom_Acm_Out,Int_Acm_Out,Acm_Out
Adelaide,1985,1,1902,34,1936
Adelaide,1985,2,1668,31,1699
Adelaide,1985,3,1878,40,1918
Adelaide,1985,4,1804,29,1833
Adelaide,1985,5,2033,30,2063
Adelaide,1985,6,1787,32,1819
Adelaide,1985,7,1911,29,1940
Adelaide,1985,8,2119,34,2153
Adelaide,1985,9,2000,29,2029
Adelaide,1985,10,2089,35,2124
Adelaide,1985,11,2228,55,2283
Adelaide,1985,12,2079,65,2144
Adelaide,1986,1,1997,71,2068
Adelaide,1986,2,1887,62,1949
Adelaide,1986,3,2161,71,2232
Adelaide,1986,4,2182,68,2250
Adelaide,1986,5,2432,70,2502
Adelaide,1986,6,2391,67,2458
Adelaide,1986,7,2528,70,2598
Adelaide,1986,8,2550,69,2619
Adelaide,1986,9,2557,69,2626
Adelaide,1986,10,1900,73,1973
Adelaide,1986,11,1770,70,1840
Adelaide,1986,12,1975,77,2052
Adelaide,1987,1,1771,71,1842
Adelaide,1987,2,1748,66,1814
Adelaide,1987,3,2052,75,2127
Adelaide,1987,4,1925,64,1989
Adelaide,1987,5,1891,64,1955
Adelaide,1987,6,1822,67,1889
Adelaide,1987,7,1952,68,2020
Adelaide,1987,8,1957,63,2020
Adelaide,1987,9,1808,69,1877
Adelaide,1987,10,1995,73,2068
Adelaide,1987,11,2027,67,2094
Adelaide,1987,12,1981,72,2053
Adelaide,1988,1,1828,74,1902
Adelaide,1988,2,1825,68,1893
Adelaide,1988,3,2013,70,2083
Adelaide,1988,4,1868,64,1932
Adelaide,1988,5,1907,67,1974
Adelaide,1988,6,1849,68,1917
Adelaide,1988,7,2123,65,2188
Adelaide,1988,8,2064,65,2129
Adelaide,1988,9,2118,66,2184
Adelaide,1988,10,2025,66,2091
Adelaide,1988,11,2108,69,2177
Adelaide,1988,12,1891,71,1962
Adelaide,1989,1,1880,72,1952
Adelaide,1989,2,1813,62,1875
Adelaide,1989,3,2046,69,2115
Adelaide,1989,4,1952,83,2035
Adelaide,1989,5,1981,83,2064
Adelaide,1989,6,1961,78,2039
Adelaide,1989,7,2176,88,2264
Adelaide,1989,8,1827,90,1917
Adelaide,1989,9,1309,85,1394
Adelaide,1989,10,1534,93,1627
Adelaide,1989,11,1714,88,1802
Adelaide,1989,12,1533,89,1622
Adelaide,1990,1,1500,93,1593
Adelaide,1990,2,1551,84,1635
Adelaide,1990,3,1672,93,1765
Adelaide,1990,4,1662,90,1752
Adelaide,1990,5,1756,94,1850
Adelaide,1990,6,1680,90,1770
Adelaide,1990,7,1826,92,1918
Adelaide,1990,8,1866,91,1957
Adelaide,1990,9,1908,92,2000
Adelaide,1990,10,2178,99,2277
Adelaide,1990,11,2063,88,2151
Adelaide,1990,12,1988,95,2083
Adelaide,1991,1,2014,100,2114
Adelaide,1991,2,1888,86,1974
Adelaide,1991,3,2117,92,2209
Adelaide,1991,4,2104,87,2191
Adelaide,1991,5,2044,88,2132
Adelaide,1991,6,2023,102,2125
Adelaide,1991,7,2229,104,2333
Adelaide,1991,8,2194,108,2302
Adelaide,1991,9,2140,97,2237
Adelaide,1991,10,2329,96,2425
Adelaide,1991,11,2352,99,2451
Adelaide,1991,12,2300,100,2400
Adelaide,1992,1,2082,99,2181
Adelaide,1992,2,2039,97,2136
Adelaide,1992,3,2307,102,2409
Adelaide,1992,4,2224,100,2324
Adelaide,1992,5,2278,97,2375
Adelaide,1992,6,2211,98,2309
Adelaide,1992,7,2356,102,2458
Adelaide,1992,8,2378,102,2480
Adelaide,1992,9,2417,99,2516
Adelaide,1992,10,2450,106,2556
Adelaide,1992,11,2457,91,2548
Adelaide,1992,12,2393,92,2485
Adelaide,1993,1,2182,93,2275
Adelaide,1993,2,2158,84,2242
Adelaide,1993,3,2439,90,2529
Adelaide,1993,4,2275,98,2373
Adelaide,1993,5,2301,94,2395
Adelaide,1993,6,2309,93,2402
Adelaide,1993,7,2390,101,2491
Adelaide,1993,8,2412,96,2508
Adelaide,1993,9,2424,95,2519
Adelaide,1993,10,2453,99,2552
Adelaide,1993,11,2440,92,2532
Adelaide,1993,12,2365,99,2464
Adelaide,1994,1,2265,99,2364
Adelaide,1994,2,2186,89,2275
Adelaide,1994,3,2552,98,2650
Adelaide,1994,4,2367,93,2460
Adelaide,1994,5,2485,96,2581
Adelaide,1994,6,2300,95,2395
Adelaide,1994,7,2523,97,2620
Adelaide,1994,8,2603,95,2698
Adelaide,1994,9,2517,95,2612
Adelaide,1994,10,2593,95,2688
Adelaide,1994,11,2599,96,2695
Adelaide,1994,12,2482,98,2580
Adelaide,1995,1,2405,96,2501
Adelaide,1995,2,2354,89,2443
Adelaide,1995,3,2650,96,2746
Adelaide,1995,4,2499,87,2586
Adelaide,1995,5,2694,86,2780
Adelaide,1995,6,2556,88,2644
Adelaide,1995,7,2750,88,2838
Adelaide,1995,8,2848,90,2938
Adelaide,1995,9,2722,84,2806
Adelaide,1995,10,2860,88,2948
Adelaide,1995,11,2724,88,2812
Adelaide,1995,12,2575,88,2663
Adelaide,1996,1,2590,92,2682
Adelaide,1996,2,2557,91,2648
Adelaide,1996,3,2727,90,2817
Adelaide,1996,4,2681,90,2771
Adelaide,1996,5,2740,90,2830
Adelaide,1996,6,2580,90,2670
Adelaide,1996,7,2863,92,2955
Adelaide,1996,8,2893,90,2983
Adelaide,1996,9,2775,91,2866
Adelaide,1996,10,2951,89,3040
Adelaide,1996,11,2857,84,2941
Adelaide,1996,12,2684,91,2775
Adelaide,1997,1,2599,89,2688
Adelaide,1997,2,2581,81,2662
Adelaide,1997,3,2815,91,2906
Adelaide,1997,4,2843,87,2930
Adelaide,1997,5,2827,90,2917
Adelaide,1997,6,2722,80,2802
Adelaide,1997,7,2942,84,3026
Adelaide,1997,8,2968,83,3051
Adelaide,1997,9,2978,80,3058
Adelaide,1997,10,3133,84,3217
Adelaide,1997,11,2994,83,3077
Adelaide,1997,12,2914,81,2995
Adelaide,1998,1,2753,81,2834
Adelaide,1998,2,2756,75,2831
Adelaide,1998,3,3063,85,3148
Adelaide,1998,4,2955,82,3037
Adelaide,1998,5,2963,86,3049
Adelaide,1998,6,2852,78,2930
Adelaide,1998,7,3074,86,3160
Adelaide,1998,8,3051,92,3143
Adelaide,1998,9,3061,89,3150
Adelaide,1998,10,3136,90,3226
Adelaide,1998,11,3020,90,3110
Adelaide,1998,12,2984,91,3075
Adelaide,1999,1,2796,89,2885
Adelaide,1999,2,2747,82,2829
Adelaide,1999,3,3104,87,3191
Adelaide,1999,4,2931,88,3019
Adelaide,1999,5,2875,90,2965
Adelaide,1999,6,2779,77,2856
Adelaide,1999,7,2952,72,3024
Adelaide,1999,8,2997,80,3077
Adelaide,1999,9,2909,76,2985
Adelaide,1999,10,3072,81,3153
Adelaide,1999,11,2970,71,3041
Adelaide,1999,12,2973,75,3048
Adelaide,2000,1,2707,75,2782
Adelaide,2000,2,2788,71,2859
Adelaide,2000,3,3034,77,3111
Adelaide,2000,4,2788,85,2873
Adelaide,2000,5,2971,81,3052
Adelaide,2000,6,2691,82,2773
Adelaide,2000,7,2801,86,2887
Adelaide,2000,8,2994,83,3077
Adelaide,2000,9,2848,82,2930
Adelaide,2000,10,3032,85,3117
Adelaide,2000,11,3059,83,3142
Adelaide,2000,12,2956,84,3040
Adelaide,2001,1,2929,83,3012
Adelaide,2001,2,2794,72,2866
Adelaide,2001,3,3239,78,3317
Adelaide,2001,4,3062,80,3142
Adelaide,2001,5,3144,76,3220
Adelaide,2001,6,3028,76,3104
Adelaide,2001,7,3202,79,3281
Adelaide,2001,8,3236,80,3316
Adelaide,2001,9,2583,76,2659
Adelaide,2001,10,2572,78,2650
Adelaide,2001,11,2631,76,2707
Adelaide,2001,12,2648,83,2731
Adelaide,2002,1,2685,79,2764
Adelaide,2002,2,2509,72,2581
Adelaide,2002,3,2694,81,2775
Adelaide,2002,4,2543,73,2616
Adelaide,2002,5,2583,74,2657
Adelaide,2002,6,2438,74,2512
Adelaide,2002,7,2714,75,2789
Adelaide,2002,8,2830,76,2906
Adelaide,2002,9,2852,75,2927
Adelaide,2002,10,2934,75,3009
Adelaide,2002,11,2741,65,2806
Adelaide,2002,12,2720,64,2784
Adelaide,2003,1,2640,63,2703
Adelaide,2003,2,2536,56,2592
Adelaide,2003,3,2789,63,2852
Adelaide,2003,4,2570,73,2643
Adelaide,2003,5,2536,77,2613
Adelaide,2003,6,2433,76,2509
Adelaide,2003,7,2583,83,2666
Adelaide,2003,8,2627,85,2712
Adelaide,2003,9,2712,81,2793
Adelaide,2003,10,2801,80,2881
Adelaide,2003,11,2729,74,2803
Adelaide,2003,12,2767,74,2841
Adelaide,2004,1,2695,75,2770
Adelaide,2004,2,2686,71,2757
Adelaide,2004,3,2947,83,3030
Adelaide,2004,4,2765,79,2844
Adelaide,2004,5,2548,84,2632
Adelaide,2004,6,2730,82,2812
Adelaide,2004,7,2855,85,2940
Adelaide,2004,8,2866,84,2950
Adelaide,2004,9,2848,84,2932
Adelaide,2004,10,2877,87,2964
Adelaide,2004,11,2925,84,3009
Adelaide,2004,12,2945,97,3042
Adelaide,2005,1,2697,97,2794
Adelaide,2005,2,2711,93,2804
Adelaide,2005,3,2974,100,3074
Adelaide,2005,4,2865,96,2961
Adelaide,2005,5,2916,102,3018
Adelaide,2005,6,2829,99,2928
Adelaide,2005,7,2914,103,3017
Adelaide,2005,8,3003,101,3104
Adelaide,2005,9,2907,90,2997
Adelaide,2005,10,2955,102,3057
Adelaide,2005,11,2739,95,2834
Adelaide,2005,12,2693,92,2785
Adelaide,2006,1,2591,93,2684
Adelaide,2006,2,2651,83,2734
Adelaide,2006,3,3044,97,3141
Adelaide,2006,4,2807,122,2929
Adelaide,2006,5,3010,122,3132
Adelaide,2006,6,2873,131,3004
Adelaide,2006,7,2817,136,2953
Adelaide,2006,8,2927,135,3062
Adelaide,2006,9,2843,124,2967
Adelaide,2006,10,2935,128,3063
Adelaide,2006,11,2910,123,3033
Adelaide,2006,12,2863,128,2991
Adelaide,2007,1,2750,125,2875
Adelaide,2007,2,2647,117,2764
Adelaide,2007,3,3086,128,3214
Adelaide,2007,4,2926,122,3048
Adelaide,2007,5,3081,128,3209
Adelaide,2007,6,2966,124,3090
Adelaide,2007,7,3138,126,3264
Adelaide,2007,8,3182,119,3301
Adelaide,2007,9,2984,118,3102
Adelaide,2007,10,3122,128,3250
Adelaide,2007,11,2933,137,3070
Adelaide,2007,12,2907,150,3057
Adelaide,2008,1,2916,146,3062
Adelaide,2008,2,2812,131,2943
Adelaide,2008,3,2934,142,3076
Adelaide,2008,4,2912,136,3048
Adelaide,2008,5,3042,138,3180
Adelaide,2008,6,2875,132,3007
Adelaide,2008,7,2993,139,3132
Adelaide,2008,8,2976,136,3112
Adelaide,2008,9,2994,134,3128
Adelaide,2008,10,3192,134,3326
Adelaide,2008,11,3026,143,3169
Adelaide,2008,12,3010,151,3161
Adelaide,2009,1,2805,152,2957
Adelaide,2009,2,2718,133,2851
Adelaide,2009,3,3135,147,3282
Adelaide,2009,4,3039,142,3181
Adelaide,2009,5,2937,143,3080
Adelaide,2009,6,2824,146,2970
Adelaide,2009,7,2952,147,3099
Adelaide,2009,8,2898,141,3039
Adelaide,2009,9,2877,148,3025
Adelaide,2009,10,2953,157,3110
Adelaide,2009,11,2798,151,2949
Adelaide,2009,12,2829,153,2982
Adelaide,2010,1,2813,155,2968
Adelaide,2010,2,2756,133,2889
Adelaide,2010,3,3208,144,3352
Adelaide,2010,4,3147,139,3286
Adelaide,2010,5,3208,134,3342
Adelaide,2010,6,3081,130,3211
Adelaide,2010,7,3226,135,3361
Adelaide,2010,8,3128,134,3262
Adelaide,2010,9,3093,132,3225
Adelaide,2010,10,3169,137,3306
Adelaide,2010,11,3046,132,3178
Adelaide,2010,12,3148,137,3285
Adelaide,2011,1,2944,137,3081
Adelaide,2011,2,2711,121,2832
Adelaide,2011,3,3129,137,3266
Adelaide,2011,4,2988,144,3132
Adelaide,2011,5,3063,147,3210
Adelaide,2011,6,2763,134,2897
Adelaide,2011,7,2994,146,3140
Adelaide,2011,8,3002,142,3144
Adelaide,2011,9,2873,144,3017
Adelaide,2011,10,2883,152,3035
Adelaide,2011,11,2825,150,2975
Adelaide,2011,12,2818,173,2991
Adelaide,2012,1,2702,175,2877
Adelaide,2012,2,2730,145,2875
Adelaide,2012,3,2994,155,3149
Adelaide,2012,4,2842,151,2993
Adelaide,2012,5,2868,155,3023
Adelaide,2012,6,2738,155,2893
Adelaide,2012,7,3016,174,3190
Adelaide,2012,8,3058,168,3226
Adelaide,2012,9,2917,171,3088
Adelaide,2012,10,3070,176,3246
Adelaide,2012,11,3048,194,3242
Adelaide,2012,12,2981,207,3188
Adelaide,2013,1,2869,207,3076
Adelaide,2013,2,2691,193,2884
Adelaide,2013,3,3011,211,3222
Adelaide,2013,4,3004,194,3198
Adelaide,2013,5,3023,179,3202
Adelaide,2013,6,2813,174,2987
Adelaide,2013,7,3070,195,3265
Adelaide,2013,8,3019,179,3198
Adelaide,2013,9,3009,191,3200
Adelaide,2013,10,3112,192,3304
Adelaide,2013,11,2952,201,3153
Adelaide,2013,12,2947,241,3188
Adelaide,2014,1,2860,251,3111
Adelaide,2014,2,2706,215,2921
Adelaide,2014,3,3092,233,3325
Adelaide,2014,4,3042,236,3278
Adelaide,2014,5,3084,232,3316
Adelaide,2014,6,2981,232,3213
Adelaide,2014,7,3162,239,3401
Adelaide,2014,8,3110,224,3334
Adelaide,2014,9,3111,195,3306
Adelaide,2014,10,3200,206,3406
Adelaide,2014,11,2988,193,3181
Adelaide,2014,12,3033,224,3257
Adelaide,2015,1,2837,224,3061
Adelaide,2015,2,2750,175,2925
Adelaide,2015,3,3138,181,3319
Adelaide,2015,4,3104,180,3284
Adelaide,2015,5,3166,182,3348
Adelaide,2015,6,3049,176,3225
Adelaide,2015,7,3242,173,3415
Adelaide,2015,8,3138,165,3303
Adelaide,2015,9,3161,171,3332
Adelaide,2015,10,3213,178,3391
Adelaide,2015,11,3126,146,3272
Adelaide,2015,12,3126,194,3320
Adelaide,2016,1,2964,202,3166
Adelaide,2016,2,3021,166,3187
Adelaide,2016,3,3190,171,3361
Adelaide,2016,4,3071,172,3243
Adelaide,2016,5,3049,198,3247
Adelaide,2016,6,2910,191,3101
Adelaide,2016,7,3151,217,3368
Adelaide,2016,8,3201,195,3396
Adelaide,2016,9,3151,194,3345
Adelaide,2016,10,3236,208,3444
Adelaide,2016,11,3167,193,3360
Adelaide,2016,12,3066,229,3295
Adelaide,2017,1,2852,221,3073
Adelaide,2017,2,2852,176,3028
Adelaide,2017,3,3246,193,3439
Adelaide,2017,4,2987,184,3171
Adelaide,2017,5,3054,183,3237
Adelaide,2017,6,2911,178,3089
Adelaide,2017,7,3081,212,3293
Adelaide,2017,8,3104,209,3313
Adelaide,2017,9,3081,204,3285
Adelaide,2017,10,3212,205,3417
Adelaide,2017,11,3148,182,3330
Adelaide,2017,12,3098,233,3331
Adelaide,2018,1,3005,259,3264
Adelaide,2018,2,2844,188,3032
Adelaide,2018,3,3150,198,3348
Adelaide,2018,4,2999,198,3197
Adelaide,2018,5,3017,186,3203
Adelaide,2018,6,2864,187,3051
Adelaide,2018,7,3146,208,3354
Adelaide,2018,8,3120,202,3322
Adelaide,2018,9,3046,201,3247
Adelaide,2018,10,3236,213,3449
Adelaide,2018,11,3114,215,3329
Adelaide,2018,12,3009,230,3239
Adelaide,2019,1,3000,237,3237
Adelaide,2019,2,2868,199,3067
Adelaide,2019,3,3187,206,3393
Adelaide,2019,4,3056,211,3267
Adelaide,2019,5,3141,205,3346
Adelaide,2019,6,2948,214,3162
Adelaide,2019,7,3210,249,3459
Adelaide,2019,8,3102,233,3335
Adelaide,2019,9,3067,238,3305
Adelaide,2019,10,3228,241,3469
Adelaide,2019,11,3053,222,3275
Adelaide,2019,12,2995,267,3262
Adelaide,2020,1,2851,281,3132
Adelaide,2020,2,2831,200,3031
Adelaide,2020,3,2527,137,2664
Adelaide,2020,4,414,0,414
Adelaide,2020,5,418,4,422
Adelaide,2020,6,471,13,484
Adelaide,2020,7,685,15,700
Adelaide,2020,8,762,21,783
Adelaide,2020,9,893,23,916
Adelaide,2020,10,1169,26,1195
Adelaide,2020,11,1158,32,1190
Adelaide,2020,12,1528,37,1565
Adelaide,2021,1,1499,38,1537
Adelaide,2021,2,1412,35,1447
Adelaide,2021,3,2045,39,2084
Adelaide,2021,4,2385,38,2423
Adelaide,2021,5,2470,48,2518
Adelaide,2021,6,2068,47,2115
Adelaide,2021,7,1479,47,1526
Adelaide,2021,8,1070,36,1106
Adelaide,2021,9,1364,35,1399
Adelaide,2021,10,1489,39,1528
Adelaide,2021,11,1755,36,1791
Adelaide,2021,12,2405,51,2456
Adelaide,2022,1,1912,71,1983
Adelaide,2022,2,1733,65,1798
Adelaide,2022,3,2468,72,2540
Adelaide,2022,4,2793,75,2868
Adelaide,2022,5,2845,95,2940
Adelaide,2022,6,2752,105,2857
Adelaide,2022,7,2757,150,2907
Adelaide,2022,8,2756,138,2894
Adelaide,2022,9,2662,128,2790
Adelaide,2022,10,2808,134,2942
Adelaide,2022,11,2746,147,2893
Adelaide,2022,12,2859,206,3065
Adelaide,2023,1,2861,239,3100
Adelaide,2023,2,2677,193,2870
Adelaide,2023,3,3050,221,3271
Adelaide,2023,4,2970,257,3227
Adelaide,2023,5,3078,216,3294
Adelaide,2023,6,2861,219,3080
Adelaide,2023,7,2954,275,3229
Adelaide,2023,8,2984,230,3214
Adelaide,2023,9,2928,212,3140
Adelaide,2023,10,3077,230,3307
Adelaide,2023,11,2958,194,3152
Adelaide,2023,12,2953,288,3241
Adelaide,2024,1,2937,312,3249
Adelaide,2024,2,2813,199,3012
Adelaide,2024,3,2964,206,3170
Adelaide,2024,4,3078,233,3311
Adelaide,2024,5,3035,199,3234
Adelaide,2024,6,2830,203,3033
Adelaide,2024,7,3077,227,3304
Adelaide,2024,8,2890,181,3071
Adelaide,2024,9,2880,181,3061
Adelaide,2024,10,2988,201,3189
Adelaide,2024,11,2811,220,3031
Adelaide,2024,12,2885,235,3120
Alice Springs,1985,1,261,0,261
Alice Springs,1985,2,237,0,237
Alice Springs,1985,3,281,0,281
Alice Springs,1985,4,258,0,258
Alice Springs,1985,5,294,0,294
Alice Springs,1985,6,284,0,284
Alice Springs,1985,7,299,0,299
Alice Springs,1985,8,325,0,325
Alice Springs,1985,9,312,0,312
Alice Springs,1985,10,310,0,310
Alice Springs,1985,11,317,0,317
Alice Springs,1985,12,294,0,294
Alice Springs,1986,1,301,0,301
Alice Springs,1986,2,272,0,272
Alice Springs,1986,3,356,0,356
Alice Springs,1986,4,367,0,367
Alice Springs,1986,5,329,0,329
Alice Springs,1986,6,304,0,304
Alice Springs,1986,7,323,0,323
Alice Springs,1986,8,355,0,355
Alice Springs,1986,9,336,0,336
Alice Springs,1986,10,389,0,389
Alice Springs,1986,11,387,0,387
Alice Springs,1986,12,378,0,378
Alice Springs,1987,1,445,0,445
Alice Springs,1987,2,386,0,386
Alice Springs,1987,3,393,0,393
Alice Springs,1987,4,372,0,372
Alice Springs,1987,5,390,0,390
Alice Springs,1987,6,406,0,406
Alice Springs,1987,7,448,0,448
Alice Springs,1987,8,431,0,431
Alice Springs,1987,9,443,0,443
Alice Springs,1987,10,488,0,488
Alice Springs,1987,11,452,0,452
Alice Springs,1987,12,409,0,409
Alice Springs,1988,1,410,0,410
Alice Springs,1988,2,356,0,356
Alice Springs,1988,3,399,0,399
Alice Springs,1988,4,398,0,398
Alice Springs,1988,5,381,0,381
Alice Springs,1988,6,372,0,372
Alice Springs,1988,7,429,0,429
Alice Springs,1988,8,421,0,421
Alice Springs,1988,9,404,0,404
Alice Springs,1988,10,437,0,437
Alice Springs,1988,11,419,0,419
Alice Springs,1988,12,393,0,393
Alice Springs,1989,1,397,0,397
Alice Springs,1989,2,348,0,348
Alice Springs,1989,3,397,0,397
Alice Springs,1989,4,398,0,398
Alice Springs,1989,5,387,0,387
Alice Springs,1989,6,368,0,368
Alice Springs,1989,7,431,0,431
Alice Springs,1989,8,276,0,276
Alice Springs,1989,9,13,0,13
Alice Springs,1989,10,50,0,50
Alice Springs,1989,11,111,0,111
Alice Springs,1989,12,180,0,180
Alice Springs,1990,1,227,0,227
Alice Springs,1990,2,251,0,251
Alice Springs,1990,3,354,0,354
Alice Springs,1990,4,368,0,368
Alice Springs,1990,5,388,0,388
Alice Springs,1990,6,371,0,371
Alice Springs,1990,7,410,0,410
Alice Springs,1990,8,395,0,395
Alice Springs,1990,9,378,0,378
Alice Springs,1990,10,464,0,464
Alice Springs,1990,11,483,0,483
Alice Springs,1990,12,455,0,455
Alice Springs,1991,1,437,0,437
Alice Springs,1991,2,397,0,397
Alice Springs,1991,3,413,0,413
Alice Springs,1991,4,364,0,364
Alice Springs,1991,5,381,0,381
Alice Springs,1991,6,381,0,381
Alice Springs,1991,7,429,0,429
Alice Springs,1991,8,451,0,451
Alice Springs,1991,9,441,0,441
Alice Springs,1991,10,461,0,461
Alice Springs,1991,11,462,0,462
Alice Springs,1991,12,439,0,439
Alice Springs,1992,1,442,0,442
Alice Springs,1992,2,391,0,391
Alice Springs,1992,3,434,0,434
Alice Springs,1992,4,422,0,422
Alice Springs,1992,5,430,0,430
Alice Springs,1992,6,407,0,407
Alice Springs,1992,7,456,0,456
Alice Springs,1992,8,459,0,459
Alice Springs,1992,9,437,0,437
Alice Springs,1992,10,489,0,489
Alice Springs,1992,11,478,0,478
Alice Springs,1992,12,480,0,480
Alice Springs,1993,1,464,0,464
Alice Springs,1993,2,446,0,446
Alice Springs,1993,3,500,0,500
Alice Springs,1993,4,474,0,474
Alice Springs,1993,5,483,0,483
Alice Springs,1993,6,494,0,494
Alice Springs,1993,7,530,0,530
Alice Springs,1993,8,528,0,528
Alice Springs,1993,9,503,0,503
Alice Springs,1993,10,548,0,548
Alice Springs,1993,11,525,0,525
Alice Springs,1993,12,538,0,538
Alice Springs,1994,1,546,0,546
Alice Springs,1994,2,468,0,468
Alice Springs,1994,3,525,0,525
Alice Springs,1994,4,515,0,515
Alice Springs,1994,5,527,0,527
Alice Springs,1994,6,549,0,549
Alice Springs,1994,7,602,0,602
Alice Springs,1994,8,581,0,581
Alice Springs,1994,9,567,0,567
Alice Springs,1994,10,609,0,609
Alice Springs,1994,11,590,0,590
Alice Springs,1994,12,609,0,609
Alice Springs,1995,1,597,0,597
Alice Springs,1995,2,534,0,534
Alice Springs,1995,3,590,0,590
Alice Springs,1995,4,568,0,568
Alice Springs,1995,5,565,0,565
Alice Springs,1995,6,550,0,550
Alice Springs,1995,7,594,0,594
Alice Springs,1995,8,584,0,584
Alice Springs,1995,9,574,0,574
Alice Springs,1995,10,593,0,593
Alice Springs,1995,11,518,0,518
Alice Springs,1995,12,546,0,546
Alice Springs,1996,1,529,0,529
Alice Springs,1996,2,502,0,502
Alice Springs,1996,3,538,0,538
Alice Springs,1996,4,519,0,519
Alice Springs,1996,5,535,0,535
Alice Springs,1996,6,528,0,528
Alice Springs,1996,7,547,0,547
Alice Springs,1996,8,544,0,544
Alice Springs,1996,9,528,0,528
Alice Springs,1996,10,612,0,612
Alice Springs,1996,11,552,0,552
Alice Springs,1996,12,570,0,570
Alice Springs,1997,1,566,0,566
Alice Springs,1997,2,509,0,509
Alice Springs,1997,3,553,0,553
Alice Springs,1997,4,532,0,532
Alice Springs,1997,5,555,0,555
Alice Springs,1997,6,536,0,536
Alice Springs,1997,7,558,0,558
Alice Springs,1997,8,567,0,567
Alice Springs,1997,9,541,0,541
Alice Springs,1997,10,570,0,570
Alice Springs,1997,11,569,0,569
Alice Springs,1997,12,572,0,572
Alice Springs,1998,1,568,0,568
Alice Springs,1998,2,500,0,500
Alice Springs,1998,3,560,0,560
Alice Springs,1998,4,532,0,532
Alice Springs,1998,5,552,0,552
Alice Springs,1998,6,535,0,535
Alice Springs,1998,7,553,0,553
Alice Springs,1998,8,558,0,558
Alice Springs,1998,9,537,0,537
Alice Springs,1998,10,557,0,557
Alice Springs,1998,11,536,0,536
Alice Springs,1998,12,517,0,517
Alice Springs,1999,1,499,0,499
Alice Springs,1999,2,485,0,485
Alice Springs,1999,3,535,0,535
Alice Springs,1999,4,524,0,524
Alice Springs,1999,5,536,0,536
Alice Springs,1999,6,512,0,512
Alice Springs,1999,7,542,0,542
Alice Springs,1999,8,540,0,540
Alice Springs,1999,9,521,0,521
Alice Springs,1999,10,539,0,539
Alice Springs,1999,11,539,0,539
Alice Springs,1999,12,524,0,524
Alice Springs,2000,1,517,0,517
Alice Springs,2000,2,509,0,509
Alice Springs,2000,3,536,0,536
Alice Springs,2000,4,544,0,544
Alice Springs,2000,5,537,0,537
Alice Springs,2000,6,521,0,521
Alice Springs,2000,7,475,0,475
Alice Springs,2000,8,447,0,447
Alice Springs,2000,9,434,0,434
Alice Springs,2000,10,495,0,495
Alice Springs,2000,11,469,0,469
Alice Springs,2000,12,479,0,479
Alice Springs,2001,1,462,0,462
Alice Springs,2001,2,435,0,435
Alice Springs,2001,3,492,0,492
Alice Springs,2001,4,482,0,482
Alice Springs,2001,5,488,0,488
Alice Springs,2001,6,479,0,479
Alice Springs,2001,7,505,0,505
Alice Springs,2001,8,492,0,492
Alice Springs,2001,9,331,0,331
Alice Springs,2001,10,283,0,283
Alice Springs,2001,11,287,0,287
Alice Springs,2001,12,299,0,299
Alice Springs,2002,1,283,0,283
Alice Springs,2002,2,258,0,258
Alice Springs,2002,3,292,0,292
Alice Springs,2002,4,288,0,288
Alice Springs,2002,5,294,0,294
Alice Springs,2002,6,316,0,316
Alice Springs,2002,7,340,0,340
Alice Springs,2002,8,340,0,340
Alice Springs,2002,9,338,0,338
Alice Springs,2002,10,341,0,341
Alice Springs,2002,11,296,0,296
Alice Springs,2002,12,296,0,296
Alice Springs,2003,1,292,0,292
Alice Springs,2003,2,269,0,269
Alice Springs,2003,3,311,0,311
Alice Springs,2003,4,315,0,315
Alice Springs,2003,5,333,0,333
Alice Springs,2003,6,352,0,352
Alice Springs,2003,7,358,0,358
Alice Springs,2003,8,368,0,368
Alice Springs,2003,9,355,0,355
Alice Springs,2003,10,360,0,360
Alice Springs,2003,11,308,0,308
Alice Springs,2003,12,321,0,321
Alice Springs,2004,1,318,0,318
Alice Springs,2004,2,299,0,299
Alice Springs,2004,3,316,0,316
Alice Springs,2004,4,309,0,309
Alice Springs,2004,5,324,0,324
Alice Springs,2004,6,313,0,313
Alice Springs,2004,7,327,0,327
Alice Springs,2004,8,327,0,327
Alice Springs,2004,9,310,0,310
Alice Springs,2004,10,319,0,319
Alice Springs,2004,11,303,0,303
Alice Springs,2004,12,304,0,304
Alice Springs,2005,1,317,0,317
Alice Springs,2005,2,280,0,280
Alice Springs,2005,3,305,0,305
Alice Springs,2005,4,302,0,302
Alice Springs,2005,5,309,0,309
Alice Springs,2005,6,309,0,309
Alice Springs,2005,7,317,0,317
Alice Springs,2005,8,315,0,315
Alice Springs,2005,9,290,0,290
Alice Springs,2005,10,297,0,297
Alice Springs,2005,11,291,0,291
Alice Springs,2005,12,295,0,295
Alice Springs,2006,1,303,0,303
Alice Springs,2006,2,266,0,266
Alice Springs,2006,3,291,0,291
Alice Springs,2006,4,289,0,289
Alice Springs,2006,5,297,0,297
Alice Springs,2006,6,285,0,285
Alice Springs,2006,7,298,0,298
Alice Springs,2006,8,297,0,297
Alice Springs,2006,9,269,0,269
Alice Springs,2006,10,263,0,263
Alice Springs,2006,11,250,0,250
Alice Springs,2006,12,255,0,255
Alice Springs,2007,1,257,0,257
Alice Springs,2007,2,235,0,235
Alice Springs,2007,3,264,0,264
Alice Springs,2007,4,250,0,250
Alice Springs,2007,5,255,0,255
Alice Springs,2007,6,253,0,253
Alice Springs,2007,7,263,0,263
Alice Springs,2007,8,256,0,256
Alice Springs,2007,9,253,0,253
Alice Springs,2007,10,260,0,260
Alice Springs,2007,11,263,0,263
Alice Springs,2007,12,268,0,268
Alice Springs,2008,1,258,0,258
Alice Springs,2008,2,243,0,243
Alice Springs,2008,3,273,0,273
Alice Springs,2008,4,275,0,275
Alice Springs,2008,5,285,0,285
Alice Springs,2008,6,281,0,281
Alice Springs,2008,7,301,0,301
Alice Springs,2008,8,292,0,292
Alice Springs,2008,9,281,0,281
Alice Springs,2008,10,285,0,285
Alice Springs,2008,11,265,0,265
Alice Springs,2008,12,272,0,272
Ballina,1985,1,0,0,0
Ballina,1985,2,0,0,0
Ballina,1985,3,0,0,0
Ballina,1985,4,0,0,0
Ballina,1985,5,0,0,0
Ballina,1985,6,0,0,0
Ballina,1985,7,0,0,0
Ballina,1985,8,0,0,0
Ballina,1985,9,0,0,0
Ballina,1985,10,0,0,0
Ballina,1985,11,0,0,0
Ballina,1985,12,0,0,0
Ballina,1986,1,0,0,0
Ballina,1986,2,0,0,0
Ballina,1986,3,0,0,0
Ballina,1986,4,0,0,0
Ballina,1986,5,0,0,0
Ballina,1986,6,0,0,0
Ballina,1986,7,0,0,0
Ballina,1986,8,0,0,0
Ballina,1986,9,0,0,0
Ballina,1986,10,0,0,0
Ballina,1986,11,0,0,0
Ballina,1986,12,12,0,12
Ballina,1987,1,31,0,31
Ballina,1987,2,29,0,29
Ballina,1987,3,32,0,32
Ballina,1987,4,35,0,35
Ballina,1987,5,28,0,28
Ballina,1987,6,32,0,32
Ballina,1987,7,113,0,113
Ballina,1987,8,137,0,137
Ballina,1987,9,134,0,134
Ballina,1987,10,144,0,144
Ballina,1987,11,145,0,145
Ballina,1987,12,172,0,172
Ballina,1988,1,167,0,167
Ballina,1988,2,152,0,152
Ballina,1988,3,170,0,170
Ballina,1988,4,165,0,165
Ballina,1988,5,140,0,140
Ballina,1988,6,142,0,142
Ballina,1988,7,176,0,176
Ballina,1988,8,165,0,165
Ballina,1988,9,195,0,195
Ballina,1988,10,198,0,198
Ballina,1988,11,164,0,164
Ballina,1988,12,186,0,186
Ballina,1989,1,203,0,203
Ballina,1989,2,206,0,206
Ballina,1989,3,215,0,215
Ballina,1989,4,217,0,217
Ballina,1989,5,218,0,218
Ballina,1989,6,231,0,231
Ballina,1989,7,258,0,258
Ballina,1989,8,235,0,235
Ballina,1989,9,236,0,236
Ballina,1989,10,212,0,212
Ballina,1989,11,206,0,206
Ballina,1989,12,228,0,228
Ballina,1990,1,235,0,235
Ballina,1990,2,207,0,207
Ballina,1990,3,239,0,239
Ballina,1990,4,258,0,258
Ballina,1990,5,253,0,253
Ballina,1990,6,261,0,261
Ballina,1990,7,160,0,160
Ballina,1990,8,166,0,166
Ballina,1990,9,194,0,194
Ballina,1990,10,196,0,196
Ballina,1990,11,185,0,185
Ballina,1990,12,184,0,184
Ballina,1991,1,294,0,294
Ballina,1991,2,243,0,243
Ballina,1991,3,292,0,292
Ballina,1991,4,296,0,296
Ballina,1991,5,332,0,332
Ballina,1991,6,342,0,342
Ballina,1991,7,362,0,362
Ballina,1991,8,331,0,331
Ballina,1991,9,330,0,330
Ballina,1991,10,354,0,354
Ballina,1991,11,345,0,345
Ballina,1991,12,106,0,106
Ballina,1992,1,106,0,106
Ballina,1992,2,102,0,102
Ballina,1992,3,83,0,83
Ballina,1992,4,109,0,109
Ballina,1992,5,177,0,177
Ballina,1992,6,175,0,175
Ballina,1992,7,180,0,180
Ballina,1992,8,177,0,177
Ballina,1992,9,178,0,178
Ballina,1992,10,179,0,179
Ballina,1992,11,176,0,176
Ballina,1992,12,193,0,193
Ballina,1993,1,77,0,77
Ballina,1993,2,65,0,65
Ballina,1993,3,72,0,72
Ballina,1993,4,67,0,67
Ballina,1993,5,70,0,70
Ballina,1993,6,68,0,68
Ballina,1993,7,70,0,70
Ballina,1993,8,71,0,71
Ballina,1993,9,69,0,69
Ballina,1993,10,70,0,70
Ballina,1993,11,69,0,69
Ballina,1993,12,78,0,78
Ballina,1994,1,81,0,81
Ballina,1994,2,64,0,64
Ballina,1994,3,77,0,77
Ballina,1994,4,73,0,73
Ballina,1994,5,77,0,77
Ballina,1994,6,72,0,72
Ballina,1994,7,76,0,76
Ballina,1994,8,76,0,76
Ballina,1994,9,73,0,73
Ballina,1994,10,78,0,78
Ballina,1994,11,74,0,74
Ballina,1994,12,80,0,80
Ballina,1995,1,85,0,85
Ballina,1995,2,76,0,76
Ballina,1995,3,101,0,101
Ballina,1995,4,106,0,106
Ballina,1995,5,104,0,104
Ballina,1995,6,104,0,104
Ballina,1995,7,106,0,106
Ballina,1995,8,110,0,110
Ballina,1995,9,105,0,105
Ballina,1995,10,98,0,98
Ballina,1995,11,101,0,101
Ballina,1995,12,101,0,101
Ballina,1996,1,110,0,110
Ballina,1996,2,104,0,104
Ballina,1996,3,107,0,107
Ballina,1996,4,84,0,84
Ballina,1996,5,84,0,84
Ballina,1996,6,78,0,78
Ballina,1996,7,85,0,85
Ballina,1996,8,82,0,82
Ballina,1996,9,108,0,108
Ballina,1996,10,115,0,115
Ballina,1996,11,106,0,106
Ballina,1996,12,111,0,111
Ballina,1997,1,112,0,112
Ballina,1997,2,100,0,100
Ballina,1997,3,107,0,107
Ballina,1997,4,107,0,107
Ballina,1997,5,110,0,110
Ballina,1997,6,106,0,106
Ballina,1997,7,111,0,111
Ballina,1997,8,109,0,109
Ballina,1997,9,108,0,108
Ballina,1997,10,113,0,113
Ballina,1997,11,105,0,105
Ballina,1997,12,112,0,112
Ballina,1998,1,110,0,110
Ballina,1998,2,100,0,100
Ballina,1998,3,111,0,111
Ballina,1998,4,107,0,107
Ballina,1998,5,108,0,108
Ballina,1998,6,108,0,108
Ballina,1998,7,112,0,112
Ballina,1998,8,107,0,107
Ballina,1998,9,108,0,108
Ballina,1998,10,113,0,113
Ballina,1998,11,114,0,114
Ballina,1998,12,130,0,130
Ballina,1999,1,135,0,135
Ballina,1999,2,130,0,130
Ballina,1999,3,144,0,144
Ballina,1999,4,138,0,138
Ballina,1999,5,144,0,144
Ballina,1999,6,139,0,139
Ballina,1999,7,135,0,135
Ballina,1999,8,140,0,140
Ballina,1999,9,132,0,132
Ballina,1999,10,137,0,137
Ballina,1999,11,133,0,133
Ballina,1999,12,136,0,136
Ballina,2000,1,137,0,137
Ballina,2000,2,130,0,130
Ballina,2000,3,148,0,148
Ballina,2000,4,189,0,189
Ballina,2000,5,240,0,240
Ballina,2000,6,270,0,270
Ballina,2000,7,278,0,278
Ballina,2000,8,280,0,280
Ballina,2000,9,268,0,268
Ballina,2000,10,281,0,281
Ballina,2000,11,202,0,202
Ballina,2000,12,210,0,210
Ballina,2001,1,213,0,213
Ballina,2001,2,189,0,189
Ballina,2001,3,185,0,185
Ballina,2001,4,179,0,179
Ballina,2001,5,191,0,191
Ballina,2001,6,181,0,181
Ballina,2001,7,252,0,252
Ballina,2001,8,303,0,303
Ballina,2001,9,205,0,205
Ballina,2001,10,220,0,220
Ballina,2001,11,231,0,231
Ballina,2001,12,232,0,232
Ballina,2002,1,224,0,224
Ballina,2002,2,219,0,219
Ballina,2002,3,251,0,251
Ballina,2002,4,244,0,244
Ballina,2002,5,247,0,247
Ballina,2002,6,230,0,230
Ballina,2002,7,244,0,244
Ballina,2002,8,224,0,224
Ballina,2002,9,294,0,294
Ballina,2002,10,305,0,305
Ballina,2002,11,267,0,267
Ballina,2002,12,267,0,267
Ballina,2003,1,277,0,277
Ballina,2003,2,249,0,249
Ballina,2003,3,273,0,273
Ballina,2003,4,264,0,264
Ballina,2003,5,269,0,269
Ballina,2003,6,253,0,253
Ballina,2003,7,260,0,260
Ballina,2003,8,203,0,203
Ballina,2003,9,188,0,188
Ballina,2003,10,192,0,192
Ballina,2003,11,184,0,184
Ballina,2003,12,202,0,202
Ballina,2004,1,209,0,209
Ballina,2004,2,158,0,158
Ballina,2004,3,169,0,169
Ballina,2004,4,160,0,160
Ballina,2004,5,170,0,170
Ballina,2004,6,169,0,169
Ballina,2004,7,189,0,189
Ballina,2004,8,213,0,213
Ballina,2004,9,207,0,207
Ballina,2004,10,206,0,206
Ballina,2004,11,205,0,205
Ballina,2004,12,218,0,218
Ballina,2005,1,210,0,210
Ballina,2005,2,193,0,193
Ballina,2005,3,217,0,217
Ballina,2005,4,207,0,207
Ballina,2005,5,212,0,212
Ballina,2005,6,210,0,210
Ballina,2005,7,189,0,189
Ballina,2005,8,169,0,169
Ballina,2005,9,164,0,164
Ballina,2005,10,167,0,167
Ballina,2005,11,162,0,162
Ballina,2005,12,189,0,189
Ballina,2006,1,185,0,185
Ballina,2006,2,152,0,152
Ballina,2006,3,171,0,171
Ballina,2006,4,190,0,190
Ballina,2006,5,182,0,182
Ballina,2006,6,179,0,179
Ballina,2006,7,194,0,194
Ballina,2006,8,193,0,193
Ballina,2006,9,187,0,187
Ballina,2006,10,192,0,192
Ballina,2006,11,177,0,177
Ballina,2006,12,202,0,202
Ballina,2007,1,198,0,198
Ballina,2007,2,165,0,165
Ballina,2007,3,182,0,182
Ballina,2007,4,182,0,182
Ballina,2007,5,183,0,183
Ballina,2007,6,178,0,178
Ballina,2007,7,179,0,179
Ballina,2007,8,178,0,178
Ballina,2007,9,171,0,171
Ballina,2007,10,175,0,175
Ballina,2007,11,176,0,176
Ballina,2007,12,197,0,197
Ballina,2008,1,194,0,194
Ballina,2008,2,167,0,167
Ballina,2008,3,180,0,180
Ballina,2008,4,171,0,171
Ballina,2008,5,177,0,177
Ballina,2008,6,152,0,152
Ballina,2008,7,162,0,162
Ballina,2008,8,160,0,160
Ballina,2008,9,157,0,157
Ballina,2008,10,173,0,173
Ballina,2008,11,168,0,168
Ballina,2008,12,184,0,184
Ballina,2009,1,178,0,178
Ballina,2009,2,153,0,153
Ballina,2009,3,167,0,167
Ballina,2009,4,169,0,169
Ballina,2009,5,166,0,166
Ballina,2009,6,163,0,163
Ballina,2009,7,177,0,177
Ballina,2009,8,145,0,145
Ballina,2009,9,140,0,140
Ballina,2009,10,169,0,169
Ballina,2009,11,159,0,159
Ballina,2009,12,173,0,173
Ballina,2010,1,164,0,164
Ballina,2010,2,139,0,139
Ballina,2010,3,154,0,154
Ballina,2010,4,151,0,151
Ballina,2010,5,140,0,140
Ballina,2010,6,141,0,141
Ballina,2010,7,146,0,146
Ballina,2010,8,151,0,151
Ballina,2010,9,164,0,164
Ballina,2010,10,169,0,169
Ballina,2010,11,150,0,150
Ballina,2010,12,190,0,190
Ballina,2011,1,170,0,170
Ballina,2011,2,141,0,141
Ballina,2011,3,159,0,159
Ballina,2011,4,159,0,159
Ballina,2011,5,152,0,152
Ballina,2011,6,140,0,140
Ballina,2011,7,156,0,156
Ballina,2011,8,155,0,155
Ballina,2011,9,159,0,159
Ballina,2011,10,158,0,158
Ballina,2011,11,155,0,155
Ballina,2011,12,170,0,170
Ballina,2012,1,187,0,187
Ballina,2012,2,149,0,149
Ballina,2012,3,161,0,161
Ballina,2012,4,178,0,178
Ballina,2012,5,170,0,170
Ballina,2012,6,154,0,154
Ballina,2012,7,194,0,194
Ballina,2012,8,185,0,185
Ballina,2012,9,175,0,175
Ballina,2012,10,189,0,189
Ballina,2012,11,168,0,168
Ballina,2012,12,187,0,187
Ballina,2013,1,196,0,196
Ballina,2013,2,140,0,140
Ballina,2013,3,173,0,173
Ballina,2013,4,206,0,206
Ballina,2013,5,183,0,183
Ballina,2013,6,183,0,183
Ballina,2013,7,197,0,197
Ballina,2013,8,178,0,178
Ballina,2013,9,199,0,199
Ballina,2013,10,202,0,202
Ballina,2013,11,178,0,178
Ballina,2013,12,210,0,210
Ballina,2014,1,207,0,207
Ballina,2014,2,162,0,162
Ballina,2014,3,184,0,184
Ballina,2014,4,192,0,192
Ballina,2014,5,158,0,158
Ballina,2014,6,164,0,164
Ballina,2014,7,193,0,193
Ballina,2014,8,171,0,171
Ballina,2014,9,196,0,196
Ballina,2014,10,194,0,194
Ballina,2014,11,175,0,175
Ballina,2014,12,189,0,189
Ballina,2015,1,193,0,193
Ballina,2015,2,149,0,149
Ballina,2015,3,175,0,175
Ballina,2015,4,186,0,186
Ballina,2015,5,168,0,168
Ballina,2015,6,170,0,170
Ballina,2015,7,190,0,190
Ballina,2015,8,176,0,176
Ballina,2015,9,199,0,199
Ballina,2015,10,192,0,192
Ballina,2015,11,145,0,145
Ballina,2015,12,176,0,176
Ballina,2016,1,184,0,184
Ballina,2016,2,170,0,170
Ballina,2016,3,197,0,197
Ballina,2016,4,181,0,181
Ballina,2016,5,168,0,168
Ballina,2016,6,174,0,174
Ballina,2016,7,198,0,198
Ballina,2016,8,178,0,178
Ballina,2016,9,195,0,195
Ballina,2016,10,201,0,201
Ballina,2016,11,177,0,177
Ballina,2016,12,223,0,223
Ballina,2017,1,224,0,224
Ballina,2017,2,168,0,168
Ballina,2017,3,189,0,189
Ballina,2017,4,214,0,214
Ballina,2017,5,171,0,171
Ballina,2017,6,171,0,171
Ballina,2017,7,194,0,194
Ballina,2017,8,172,0,172
Ballina,2017,9,195,0,195
Ballina,2017,10,210,0,210
Ballina,2017,11,181,0,181
Ballina,2017,12,210,0,210
Ballina,2018,1,209,0,209
Ballina,2018,2,176,0,176
Ballina,2018,3,194,0,194
Ballina,2018,4,197,0,197
Ballina,2018,5,172,0,172
Ballina,2018,6,167,0,167
Ballina,2018,7,205,0,205
Ballina,2018,8,187,0,187
Ballina,2018,9,187,0,187
Ballina,2018,10,209,0,209
Ballina,2018,11,178,0,178
Ballina,2018,12,207,0,207
Ballina,2019,1,205,0,205
Ballina,2019,2,162,0,162
Ballina,2019,3,187,0,187
Ballina,2019,4,206,0,206
Ballina,2019,5,172,0,172
Ballina,2019,6,166,0,166
Ballina,2019,7,198,0,198
Ballina,2019,8,175,0,175
Ballina,2019,9,184,0,184
Ballina,2019,10,196,0,196
Ballina,2019,11,184,0,184
Ballina,2019,12,202,0,202
Ballina,2020,1,207,0,207
Ballina,2020,2,171,0,171
Ballina,2020,3,153,0,153
Ballina,2020,4,11,0,11
Ballina,2020,5,25,0,25
Ballina,2020,6,53,0,53
Ballina,2020,7,169,0,169
Ballina,2020,8,158,0,158
Ballina,2020,9,187,0,187
Ballina,2020,10,261,0,261
Ballina,2020,11,275,0,275
Ballina,2020,12,350,0,350
Ballina,2021,1,307,0,307
Ballina,2021,2,251,0,251
Ballina,2021,3,309,0,309
Ballina,2021,4,360,0,360
Ballina,2021,5,302,0,302
Ballina,2021,6,275,0,275
Ballina,2021,7,125,0,125
Ballina,2021,8,64,0,64
Ballina,2021,9,51,0,51
Ballina,2021,10,72,0,72
Ballina,2021,11,395,0,395
Ballina,2021,12,500,0,500
Ballina,2022,1,421,0,421
Ballina,2022,2,237,0,237
Ballina,2022,3,268,0,268
Ballina,2022,4,356,0,356
Ballina,2022,5,346,0,346
Ballina,2022,6,295,0,295
Ballina,2022,7,246,0,246
Ballina,2022,8,238,0,238
Ballina,2022,9,226,0,226
Ballina,2022,10,237,0,237
Ballina,2022,11,262,0,262
Ballina,2022,12,278,0,278
Ballina,2023,1,289,0,289
Ballina,2023,2,230,0,230
Ballina,2023,3,266,0,266
Ballina,2023,4,250,0,250
Ballina,2023,5,227,0,227
Ballina,2023,6,235,0,235
Ballina,2023,7,253,0,253
Ballina,2023,8,251,0,251
Ballina,2023,9,233,0,233
Ballina,2023,10,219,0,219
Ballina,2023,11,206,0,206
Ballina,2023,12,225,0,225
Ballina,2024,1,218,0,218
Ballina,2024,2,194,0,194
Ballina,2024,3,211,0,211
Ballina,2024,4,209,0,209
Ballina,2024,5,183,0,183
Ballina,2024,6,176,0,176
Ballina,2024,7,217,0,217
Ballina,2024,8,201,0,201
Ballina,2024,9,201,0,201
Ballina,2024,10,212,0,212
Ballina,2024,11,202,0,202
Ballina,2024,12,209,0,209
BRISBANE,1985,1,2064,183,2247
BRISBANE,1985,2,1825,158,1983
BRISBANE,1985,3,2049,189,2238
BRISBANE,1985,4,1938,171,2109
BRISBANE,1985,5,2157,184,2341
BRISBANE,1985,6,1904,174,2078
BRISBANE,1985,7,1895,178,2073
BRISBANE,1985,8,2084,192,2276
BRISBANE,1985,9,2054,176,2230
BRISBANE,1985,10,2122,176,2298
BRISBANE,1985,11,1897,192,2089
BRISBANE,1985,12,1957,217,2174
BRISBANE,1986,1,2002,220,2222
BRISBANE,1986,2,1610,200,1810
BRISBANE,1986,3,1900,229,2129
BRISBANE,1986,4,1862,225,2087
BRISBANE,1986,5,2041,255,2296
BRISBANE,1986,6,1866,231,2097
BRISBANE,1986,7,1980,235,2215
BRISBANE,1986,8,2134,236,2370
BRISBANE,1986,9,2070,239,2309
BRISBANE,1986,10,2203,240,2443
BRISBANE,1986,11,2036,242,2278
BRISBANE,1986,12,2143,246,2389
BRISBANE,1987,1,2084,269,2353
BRISBANE,1987,2,1857,220,2077
BRISBANE,1987,3,2006,255,2261
BRISBANE,1987,4,2149,264,2413
BRISBANE,1987,5,2068,279,2347
BRISBANE,1987,6,2252,263,2515
BRISBANE,1987,7,2496,286,2782
BRISBANE,1987,8,2411,293,2704
BRISBANE,1987,9,2308,267,2575
BRISBANE,1987,10,2406,289,2695
BRISBANE,1987,11,2396,273,2669
BRISBANE,1987,12,2438,303,2741
BRISBANE,1988,1,2425,323,2748
BRISBANE,1988,2,2185,287,2472
BRISBANE,1988,3,2417,281,2698
BRISBANE,1988,4,2357,356,2713
BRISBANE,1988,5,2460,383,2843
BRISBANE,1988,6,2594,371,2965
BRISBANE,1988,7,2841,419,3260
BRISBANE,1988,8,2649,389,3038
BRISBANE,1988,9,2801,366,3167
BRISBANE,1988,10,2811,361,3172
BRISBANE,1988,11,2481,327,2808
BRISBANE,1988,12,2482,390,2872
BRISBANE,1989,1,2346,395,2741
BRISBANE,1989,2,2150,333,2483
BRISBANE,1989,3,2626,343,2969
BRISBANE,1989,4,2513,399,2912
BRISBANE,1989,5,2435,386,2821
BRISBANE,1989,6,2455,362,2817
BRISBANE,1989,7,2597,394,2991
BRISBANE,1989,8,1865,392,2257
BRISBANE,1989,9,1136,385,1521
BRISBANE,1989,10,1397,397,1794
BRISBANE,1989,11,1578,391,1969
BRISBANE,1989,12,1844,421,2265
BRISBANE,1990,1,1953,426,2379
BRISBANE,1990,2,1865,384,2249
BRISBANE,1990,3,2259,419,2678
BRISBANE,1990,4,2353,436,2789
BRISBANE,1990,5,2572,445,3017
BRISBANE,1990,6,2470,426,2896
BRISBANE,1990,7,2637,432,3069
BRISBANE,1990,8,2578,436,3014
BRISBANE,1990,9,2648,442,3090
BRISBANE,1990,10,2779,464,3243
BRISBANE,1990,11,2723,471,3194
BRISBANE,1990,12,2560,500,3060
BRISBANE,1991,1,2845,496,3341
BRISBANE,1991,2,2527,436,2963
BRISBANE,1991,3,2888,481,3369
BRISBANE,1991,4,2980,457,3437
BRISBANE,1991,5,3092,466,3558
BRISBANE,1991,6,3102,485,3587
BRISBANE,1991,7,3398,500,3898
BRISBANE,1991,8,3353,498,3851
BRISBANE,1991,9,3423,487,3910
BRISBANE,1991,10,3521,502,4023
BRISBANE,1991,11,3441,477,3918
BRISBANE,1991,12,3710,508,4218
BRISBANE,1992,1,3579,513,4092
BRISBANE,1992,2,3082,472,3554
BRISBANE,1992,3,3344,502,3846
BRISBANE,1992,4,3421,487,3908
BRISBANE,1992,5,3469,499,3968
BRISBANE,1992,6,3457,481,3938
BRISBANE,1992,7,3716,507,4223
BRISBANE,1992,8,3560,502,4062
BRISBANE,1992,9,3719,495,4214
BRISBANE,1992,10,3860,505,4365
BRISBANE,1992,11,3741,508,4249
BRISBANE,1992,12,3797,567,4364
BRISBANE,1993,1,3765,561,4326
BRISBANE,1993,2,3329,502,3831
BRISBANE,1993,3,3561,542,4103
BRISBANE,1993,4,3427,539,3966
BRISBANE,1993,5,3580,571,4151
BRISBANE,1993,6,3551,543,4094
BRISBANE,1993,7,3767,571,4338
BRISBANE,1993,8,3808,566,4374
BRISBANE,1993,9,3841,557,4398
BRISBANE,1993,10,3976,586,4562
BRISBANE,1993,11,3727,571,4298
BRISBANE,1993,12,3836,607,4443
BRISBANE,1994,1,3716,628,4344
BRISBANE,1994,2,3433,562,3995
BRISBANE,1994,3,3938,588,4526
BRISBANE,1994,4,3832,544,4376
BRISBANE,1994,5,4032,556,4588
BRISBANE,1994,6,4040,546,4586
BRISBANE,1994,7,4235,570,4805
BRISBANE,1994,8,4226,577,4803
BRISBANE,1994,9,4220,605,4825
BRISBANE,1994,10,4326,639,4965
BRISBANE,1994,11,4151,641,4792
BRISBANE,1994,12,4254,676,4930
BRISBANE,1995,1,4172,704,4876
BRISBANE,1995,2,3814,617,4431
BRISBANE,1995,3,4233,678,4911
BRISBANE,1995,4,4278,684,4962
BRISBANE,1995,5,4441,696,5137
BRISBANE,1995,6,4315,682,4997
BRISBANE,1995,7,4574,703,5277
BRISBANE,1995,8,4489,704,5193
BRISBANE,1995,9,4411,679,5090
BRISBANE,1995,10,4592,721,5313
BRISBANE,1995,11,4445,685,5130
BRISBANE,1995,12,4487,738,5225
BRISBANE,1996,1,4627,729,5356
BRISBANE,1996,2,4360,687,5047
BRISBANE,1996,3,4654,712,5366
BRISBANE,1996,4,4587,718,5305
BRISBANE,1996,5,4632,729,5361
BRISBANE,1996,6,4481,733,5214
BRISBANE,1996,7,4786,777,5563
BRISBANE,1996,8,4695,767,5462
BRISBANE,1996,9,4623,736,5359
BRISBANE,1996,10,4837,737,5574
BRISBANE,1996,11,4492,748,5240
BRISBANE,1996,12,4436,798,5234
BRISBANE,1997,1,4298,803,5101
BRISBANE,1997,2,3974,736,4710
BRISBANE,1997,3,4398,778,5176
BRISBANE,1997,4,4295,730,5025
BRISBANE,1997,5,4252,767,5019
BRISBANE,1997,6,4334,714,5048
BRISBANE,1997,7,4764,782,5546
BRISBANE,1997,8,4675,784,5459
BRISBANE,1997,9,4565,750,5315
BRISBANE,1997,10,4743,791,5534
BRISBANE,1997,11,4429,817,5246
BRISBANE,1997,12,4425,859,5284
BRISBANE,1998,1,4292,862,5154
BRISBANE,1998,2,3883,729,4612
BRISBANE,1998,3,4419,758,5177
BRISBANE,1998,4,4402,728,5130
BRISBANE,1998,5,4443,752,5195
BRISBANE,1998,6,4385,722,5107
BRISBANE,1998,7,4693,743,5436
BRISBANE,1998,8,4633,771,5404
BRISBANE,1998,9,4599,746,5345
BRISBANE,1998,10,4784,767,5551
BRISBANE,1998,11,4687,728,5415
BRISBANE,1998,12,4721,776,5497
BRISBANE,1999,1,4606,805,5411
BRISBANE,1999,2,4222,698,4920
BRISBANE,1999,3,4764,744,5508
BRISBANE,1999,4,4693,669,5362
BRISBANE,1999,5,4729,697,5426
BRISBANE,1999,6,4651,666,5317
BRISBANE,1999,7,4913,707,5620
BRISBANE,1999,8,4922,713,5635
BRISBANE,1999,9,4870,684,5554
BRISBANE,1999,10,5100,709,5809
BRISBANE,1999,11,4755,684,5439
BRISBANE,1999,12,4895,747,5642
BRISBANE,2000,1,4720,770,5490
BRISBANE,2000,2,4386,703,5089
BRISBANE,2000,3,4868,721,5589
BRISBANE,2000,4,4705,730,5435
BRISBANE,2000,5,4944,723,5667
BRISBANE,2000,6,4978,690,5668
BRISBANE,2000,7,5068,749,5817
BRISBANE,2000,8,5197,735,5932
BRISBANE,2000,9,5426,707,6133
BRISBANE,2000,10,5750,723,6473
BRISBANE,2000,11,5560,689,6249
BRISBANE,2000,12,5720,740,6460
BRISBANE,2001,1,5760,742,6502
BRISBANE,2001,2,5268,644,5912
BRISBANE,2001,3,5930,726,6656
BRISBANE,2001,4,5879,755,6634
BRISBANE,2001,5,5917,742,6659
BRISBANE,2001,6,5549,742,6291
BRISBANE,2001,7,5540,767,6307
BRISBANE,2001,8,5538,771,6309
BRISBANE,2001,9,4320,734,5054
BRISBANE,2001,10,4240,723,4963
BRISBANE,2001,11,4567,630,5197
BRISBANE,2001,12,4631,711,5342
BRISBANE,2002,1,4528,702,5230
BRISBANE,2002,2,4172,630,4802
BRISBANE,2002,3,4248,680,4928
BRISBANE,2002,4,4135,700,4835
BRISBANE,2002,5,4255,730,4985
BRISBANE,2002,6,4088,727,4815
BRISBANE,2002,7,4328,795,5123
BRISBANE,2002,8,4274,795,5069
BRISBANE,2002,9,4268,747,5015
BRISBANE,2002,10,4441,757,5198
BRISBANE,2002,11,4206,728,4934
BRISBANE,2002,12,4290,711,5001
BRISBANE,2003,1,4164,724,4888
BRISBANE,2003,2,3661,644,4305
BRISBANE,2003,3,4066,686,4752
BRISBANE,2003,4,4021,670,4691
BRISBANE,2003,5,4048,667,4715
BRISBANE,2003,6,3954,645,4599
BRISBANE,2003,7,4113,698,4811
BRISBANE,2003,8,4107,677,4784
BRISBANE,2003,9,4200,661,4861
BRISBANE,2003,10,4448,706,5154
BRISBANE,2003,11,4382,764,5146
BRISBANE,2003,12,4470,808,5278
BRISBANE,2004,1,4506,848,5354
BRISBANE,2004,2,4253,797,5050
BRISBANE,2004,3,4551,828,5379
BRISBANE,2004,4,4398,821,5219
BRISBANE,2004,5,4642,841,5483
BRISBANE,2004,6,4658,823,5481
BRISBANE,2004,7,4888,923,5811
BRISBANE,2004,8,4977,915,5892
BRISBANE,2004,9,4879,902,5781
BRISBANE,2004,10,4974,934,5908
BRISBANE,2004,11,4814,925,5739
BRISBANE,2004,12,5038,968,6006
BRISBANE,2005,1,4849,976,5825
BRISBANE,2005,2,4554,837,5391
BRISBANE,2005,3,5028,912,5940
BRISBANE,2005,4,4922,929,5851
BRISBANE,2005,5,5078,964,6042
BRISBANE,2005,6,4897,952,5849
BRISBANE,2005,7,5140,1004,6144
BRISBANE,2005,8,5131,986,6117
BRISBANE,2005,9,5041,958,5999
BRISBANE,2005,10,5138,975,6113
BRISBANE,2005,11,4918,885,5803
BRISBANE,2005,12,4957,922,5879
BRISBANE,2006,1,4830,946,5776
BRISBANE,2006,2,4523,834,5357
BRISBANE,2006,3,5083,886,5969
BRISBANE,2006,4,4886,924,5810
BRISBANE,2006,5,5147,916,6063
BRISBANE,2006,6,4936,927,5863
BRISBANE,2006,7,5147,1050,6197
BRISBANE,2006,8,5172,1036,6208
BRISBANE,2006,9,5031,1009,6040
BRISBANE,2006,10,5183,1005,6188
BRISBANE,2006,11,5040,949,5989
BRISBANE,2006,12,5012,995,6007
BRISBANE,2007,1,4942,991,5933
BRISBANE,2007,2,4599,862,5461
BRISBANE,2007,3,5142,985,6127
BRISBANE,2007,4,4951,992,5943
BRISBANE,2007,5,5130,1005,6135
BRISBANE,2007,6,4951,985,5936
BRISBANE,2007,7,5206,1038,6244
BRISBANE,2007,8,5280,1027,6307
BRISBANE,2007,9,5019,1004,6023
BRISBANE,2007,10,5423,1022,6445
BRISBANE,2007,11,5366,941,6307
BRISBANE,2007,12,5489,1065,6554
BRISBANE,2008,1,5400,1075,6475
BRISBANE,2008,2,4924,993,5917
BRISBANE,2008,3,5203,1034,6237
BRISBANE,2008,4,5142,1044,6186
BRISBANE,2008,5,5392,1087,6479
BRISBANE,2008,6,5178,1074,6252
BRISBANE,2008,7,5566,1172,6738
BRISBANE,2008,8,5646,1149,6795
BRISBANE,2008,9,5563,1086,6649
BRISBANE,2008,10,5910,1069,6979
BRISBANE,2008,11,5616,1038,6654
BRISBANE,2008,12,5694,1144,6838
BRISBANE,2009,1,5440,1163,6603
BRISBANE,2009,2,4946,1020,5966
BRISBANE,2009,3,5476,1087,6563
BRISBANE,2009,4,5300,1096,6396
BRISBANE,2009,5,5281,1091,6372
BRISBANE,2009,6,5202,1069,6271
BRISBANE,2009,7,5509,1152,6661
BRISBANE,2009,8,5358,1157,6515
BRISBANE,2009,9,5393,1099,6492
BRISBANE,2009,10,5606,1113,6719
BRISBANE,2009,11,5261,1049,6310
BRISBANE,2009,12,5427,1115,6542
BRISBANE,2010,1,5311,1150,6461
BRISBANE,2010,2,4934,1015,5949
BRISBANE,2010,3,5532,1110,6642
BRISBANE,2010,4,5758,1115,6873
BRISBANE,2010,5,5801,1131,6932
BRISBANE,2010,6,5673,1105,6778
BRISBANE,2010,7,6066,1222,7288
BRISBANE,2010,8,5958,1181,7139
BRISBANE,2010,9,5887,1140,7027
BRISBANE,2010,10,6092,1111,7203
BRISBANE,2010,11,5957,1068,7025
BRISBANE,2010,12,6032,1162,7194
BRISBANE,2011,1,5532,1192,6724
BRISBANE,2011,2,5268,1039,6307
BRISBANE,2011,3,6041,1127,7168
BRISBANE,2011,4,5940,1123,7063
BRISBANE,2011,5,6075,1150,7225
BRISBANE,2011,6,5794,1068,6862
BRISBANE,2011,7,6236,1210,7446
BRISBANE,2011,8,6264,1204,7468
BRISBANE,2011,9,6109,1153,7262
BRISBANE,2011,10,6293,1190,7483
BRISBANE,2011,11,6269,1090,7359
BRISBANE,2011,12,6417,1154,7571
BRISBANE,2012,1,6284,1163,7447
BRISBANE,2012,2,6128,1020,7148
BRISBANE,2012,3,6600,1068,7668
BRISBANE,2012,4,6345,1106,7451
BRISBANE,2012,5,6443,1056,7499
BRISBANE,2012,6,6180,1096,7276
BRISBANE,2012,7,6803,1202,8005
BRISBANE,2012,8,6971,1175,8146
BRISBANE,2012,9,6718,1120,7838
BRISBANE,2012,10,7006,1135,8141
BRISBANE,2012,11,6779,1055,7834
BRISBANE,2012,12,6684,1150,7834
BRISBANE,2013,1,6620,1165,7785
BRISBANE,2013,2,6111,1034,7145
BRISBANE,2013,3,6734,1137,7871
BRISBANE,2013,4,6751,1139,7890
BRISBANE,2013,5,6914,1120,8034
BRISBANE,2013,6,6619,1151,7770
BRISBANE,2013,7,7218,1249,8467
BRISBANE,2013,8,7084,1261,8345
BRISBANE,2013,9,6972,1218,8190
BRISBANE,2013,10,7310,1236,8546
BRISBANE,2013,11,6871,1170,8041
BRISBANE,2013,12,6955,1270,8225
BRISBANE,2014,1,6858,1279,8137
BRISBANE,2014,2,6139,1105,7244
BRISBANE,2014,3,6874,1208,8082
BRISBANE,2014,4,6878,1204,8082
BRISBANE,2014,5,7005,1168,8173
BRISBANE,2014,6,6793,1182,7975
BRISBANE,2014,7,7247,1299,8546
BRISBANE,2014,8,7057,1283,8340
BRISBANE,2014,9,7005,1232,8237
BRISBANE,2014,10,7252,1205,8457
BRISBANE,2014,11,6717,1148,7865
BRISBANE,2014,12,7003,1279,8282
BRISBANE,2015,1,6833,1292,8125
BRISBANE,2015,2,6187,1118,7305
BRISBANE,2015,3,7024,1203,8227
BRISBANE,2015,4,6877,1205,8082
BRISBANE,2015,5,6906,1177,8083
BRISBANE,2015,6,6861,1164,8025
BRISBANE,2015,7,7240,1274,8514
BRISBANE,2015,8,7043,1244,8287
BRISBANE,2015,9,6948,1205,8153
BRISBANE,2015,10,7039,1226,8265
BRISBANE,2015,11,6863,1121,7984
BRISBANE,2015,12,6978,1338,8316
BRISBANE,2016,1,6717,1368,8085
BRISBANE,2016,2,6463,1173,7636
BRISBANE,2016,3,6913,1212,8125
BRISBANE,2016,4,6611,1188,7799
BRISBANE,2016,5,6611,1174,7785
BRISBANE,2016,6,6464,1210,7674
BRISBANE,2016,7,6909,1342,8251
BRISBANE,2016,8,6948,1279,8227
BRISBANE,2016,9,6875,1273,8148
BRISBANE,2016,10,6867,1318,8185
BRISBANE,2016,11,6709,1235,7944
BRISBANE,2016,12,6818,1396,8214
BRISBANE,2017,1,6666,1410,8076
BRISBANE,2017,2,6018,1199,7217
BRISBANE,2017,3,6616,1310,7926
BRISBANE,2017,4,6505,1355,7860
BRISBANE,2017,5,6630,1299,7929
BRISBANE,2017,6,6510,1309,7819
BRISBANE,2017,7,6908,1393,8301
BRISBANE,2017,8,7002,1372,8374
BRISBANE,2017,9,6702,1359,8061
BRISBANE,2017,10,6885,1385,8270
BRISBANE,2017,11,6702,1299,8001
BRISBANE,2017,12,6635,1519,8154
BRISBANE,2018,1,6469,1550,8019
BRISBANE,2018,2,6011,1314,7325
BRISBANE,2018,3,6596,1422,8018
BRISBANE,2018,4,6476,1408,7884
BRISBANE,2018,5,6539,1378,7917
BRISBANE,2018,6,6150,1383,7533
BRISBANE,2018,7,6781,1517,8298
BRISBANE,2018,8,6675,1485,8160
BRISBANE,2018,9,6426,1427,7853
BRISBANE,2018,10,6842,1457,8299
BRISBANE,2018,11,6564,1368,7932
BRISBANE,2018,12,6549,1534,8083
BRISBANE,2019,1,6447,1572,8019
BRISBANE,2019,2,6028,1336,7364
BRISBANE,2019,3,6649,1441,8090
BRISBANE,2019,4,6681,1425,8106
BRISBANE,2019,5,6818,1361,8179
BRISBANE,2019,6,6472,1394,7866
BRISBANE,2019,7,7142,1562,8704
BRISBANE,2019,8,6842,1535,8377
BRISBANE,2019,9,6771,1492,8263
BRISBANE,2019,10,7032,1511,8543
BRISBANE,2019,11,6600,1427,8027
BRISBANE,2019,12,6700,1592,8292
BRISBANE,2020,1,6510,1627,8137
BRISBANE,2020,2,6104,1328,7432
BRISBANE,2020,3,5429,974,6403
BRISBANE,2020,4,1030,113,1143
BRISBANE,2020,5,837,141,978
BRISBANE,2020,6,1220,158,1378
BRISBANE,2020,7,2103,171,2274
BRISBANE,2020,8,2166,183,2349
BRISBANE,2020,9,2273,170,2443
BRISBANE,2020,10,2470,185,2655
BRISBANE,2020,11,2724,192,2916
BRISBANE,2020,12,4298,211,4509
BRISBANE,2021,1,3641,179,3820
BRISBANE,2021,2,3549,170,3719
BRISBANE,2021,3,4794,189,4983
BRISBANE,2021,4,4677,248,4925
BRISBANE,2021,5,5179,365,5544
BRISBANE,2021,6,4828,377,5205
BRISBANE,2021,7,3659,370,4029
BRISBANE,2021,8,2287,253,2540
BRISBANE,2021,9,2934,270,3204
BRISBANE,2021,10,3148,269,3417
BRISBANE,2021,11,3387,292,3679
BRISBANE,2021,12,4889,308,5197
BRISBANE,2022,1,4513,271,4784
BRISBANE,2022,2,3903,300,4203
BRISBANE,2022,3,5368,351,5719
BRISBANE,2022,4,6021,474,6495
BRISBANE,2022,5,6359,531,6890
BRISBANE,2022,6,6134,556,6690
BRISBANE,2022,7,6019,688,6707
BRISBANE,2022,8,5944,694,6638
BRISBANE,2022,9,5813,707,6520
BRISBANE,2022,10,6059,769,6828
BRISBANE,2022,11,6200,840,7040
BRISBANE,2022,12,6368,918,7286
BRISBANE,2023,1,6369,964,7333
BRISBANE,2023,2,5928,820,6748
BRISBANE,2023,3,6721,902,7623
BRISBANE,2023,4,6475,975,7450
BRISBANE,2023,5,6843,965,7808
BRISBANE,2023,6,6599,1012,7611
BRISBANE,2023,7,6741,1071,7812
BRISBANE,2023,8,6877,1061,7938
BRISBANE,2023,9,6678,1062,7740
BRISBANE,2023,10,6840,1078,7918
BRISBANE,2023,11,6633,1177,7810
BRISBANE,2023,12,6476,1373,7849
BRISBANE,2024,1,6369,1376,7745
BRISBANE,2024,2,6274,1225,7499
BRISBANE,2024,3,6670,1314,7984
BRISBANE,2024,4,6721,1231,7952
BRISBANE,2024,5,6909,1204,8113
BRISBANE,2024,6,6558,1214,7772
BRISBANE,2024,7,7089,1293,8382
BRISBANE,2024,8,6613,1282,7895
BRISBANE,2024,9,6659,1275,7934
BRISBANE,2024,10,6853,1303,8156
BRISBANE,2024,11,6470,1330,7800
BRISBANE,2024,12,6545,1505,8050
Cairns,1985,1,494,36,530
Cairns,1985,2,383,29,412
Cairns,1985,3,447,35,482
Cairns,1985,4,446,34,480
Cairns,1985,5,482,35,517
Cairns,1985,6,463,36,499
Cairns,1985,7,455,37,492
Cairns,1985,8,447,35,482
Cairns,1985,9,411,35,446
Cairns,1985,10,373,33,406
Cairns,1985,11,442,41,483
Cairns,1985,12,462,43,505
Cairns,1986,1,438,40,478
Cairns,1986,2,352,37,389
Cairns,1986,3,442,46,488
Cairns,1986,4,445,45,490
Cairns,1986,5,474,47,521
Cairns,1986,6,477,43,520
Cairns,1986,7,480,44,524
Cairns,1986,8,567,39,606
Cairns,1986,9,579,40,619
Cairns,1986,10,639,46,685
Cairns,1986,11,562,45,607
Cairns,1986,12,596,46,642
Cairns,1987,1,580,52,632
Cairns,1987,2,477,44,521
Cairns,1987,3,550,47,597
Cairns,1987,4,593,58,651
Cairns,1987,5,572,58,630
Cairns,1987,6,590,54,644
Cairns,1987,7,646,61,707
Cairns,1987,8,633,56,689
Cairns,1987,9,640,64,704
Cairns,1987,10,721,73,794
Cairns,1987,11,674,77,751
Cairns,1987,12,729,81,810
Cairns,1988,1,703,81,784
Cairns,1988,2,553,75,628
Cairns,1988,3,639,87,726
Cairns,1988,4,658,79,737
Cairns,1988,5,608,91,699
Cairns,1988,6,655,95,750
Cairns,1988,7,755,94,849
Cairns,1988,8,707,100,807
Cairns,1988,9,686,99,785
Cairns,1988,10,708,96,804
Cairns,1988,11,688,125,813
Cairns,1988,12,721,138,859
Cairns,1989,1,706,143,849
Cairns,1989,2,609,121,730
Cairns,1989,3,691,130,821
Cairns,1989,4,692,125,817
Cairns,1989,5,693,124,817
Cairns,1989,6,715,127,842
Cairns,1989,7,809,140,949
Cairns,1989,8,577,131,708
Cairns,1989,9,285,138,423
Cairns,1989,10,306,132,438
Cairns,1989,11,330,126,456
Cairns,1989,12,400,130,530
Cairns,1990,1,459,130,589
Cairns,1990,2,410,114,524
Cairns,1990,3,522,132,654
Cairns,1990,4,526,131,657
Cairns,1990,5,576,134,710
Cairns,1990,6,626,133,759
Cairns,1990,7,716,157,873
Cairns,1990,8,878,156,1034
Cairns,1990,9,821,165,986
Cairns,1990,10,856,162,1018
Cairns,1990,11,868,218,1086
Cairns,1990,12,658,226,884
Cairns,1991,1,891,228,1119
Cairns,1991,2,743,204,947
Cairns,1991,3,920,232,1152
Cairns,1991,4,957,196,1153
Cairns,1991,5,1022,200,1222
Cairns,1991,6,1042,203,1245
Cairns,1991,7,1140,206,1346
Cairns,1991,8,1129,210,1339
Cairns,1991,9,1150,193,1343
Cairns,1991,10,1215,197,1412
Cairns,1991,11,1160,253,1413
Cairns,1991,12,1137,284,1421
Cairns,1992,1,1117,280,1397
Cairns,1992,2,950,259,1209
Cairns,1992,3,997,279,1276
Cairns,1992,4,1069,324,1393
Cairns,1992,5,1037,324,1361
Cairns,1992,6,1046,319,1365
Cairns,1992,7,1182,331,1513
Cairns,1992,8,1161,330,1491
Cairns,1992,9,1139,324,1463
Cairns,1992,10,1220,335,1555
Cairns,1992,11,1184,353,1537
Cairns,1992,12,1190,380,1570
Cairns,1993,1,1145,391,1536
Cairns,1993,2,984,330,1314
Cairns,1993,3,1122,361,1483
Cairns,1993,4,1129,357,1486
Cairns,1993,5,1114,370,1484
Cairns,1993,6,1114,354,1468
Cairns,1993,7,1222,378,1600
Cairns,1993,8,1221,372,1593
Cairns,1993,9,1209,363,1572
Cairns,1993,10,1291,371,1662
Cairns,1993,11,1235,373,1608
Cairns,1993,12,1228,394,1622
Cairns,1994,1,1244,395,1639
Cairns,1994,2,1094,351,1445
Cairns,1994,3,1263,387,1650
Cairns,1994,4,1279,383,1662
Cairns,1994,5,1269,397,1666
Cairns,1994,6,1266,388,1654
Cairns,1994,7,1397,393,1790
Cairns,1994,8,1416,401,1817
Cairns,1994,9,1361,385,1746
Cairns,1994,10,1443,395,1838
Cairns,1994,11,1353,393,1746
Cairns,1994,12,1377,393,1770
Cairns,1995,1,1339,399,1738
Cairns,1995,2,1172,353,1525
Cairns,1995,3,1346,389,1735
Cairns,1995,4,1358,384,1742
Cairns,1995,5,1370,396,1766
Cairns,1995,6,1340,386,1726
Cairns,1995,7,1454,402,1856
Cairns,1995,8,1470,406,1876
Cairns,1995,9,1428,380,1808
Cairns,1995,10,1490,394,1884
Cairns,1995,11,1404,392,1796
Cairns,1995,12,1424,415,1839
Cairns,1996,1,1397,414,1811
Cairns,1996,2,1265,392,1657
Cairns,1996,3,1353,414,1767
Cairns,1996,4,1372,392,1764
Cairns,1996,5,1346,407,1753
Cairns,1996,6,1335,400,1735
Cairns,1996,7,1436,437,1873
Cairns,1996,8,1440,432,1872
Cairns,1996,9,1393,427,1820
Cairns,1996,10,1527,427,1954
Cairns,1996,11,1464,417,1881
Cairns,1996,12,1517,443,1960
Cairns,1997,1,1452,430,1882
Cairns,1997,2,1323,384,1707
Cairns,1997,3,1389,424,1813
Cairns,1997,4,1395,357,1752
Cairns,1997,5,1385,363,1748
Cairns,1997,6,1372,372,1744
Cairns,1997,7,1474,387,1861
Cairns,1997,8,1458,388,1846
Cairns,1997,9,1429,365,1794
Cairns,1997,10,1511,381,1892
Cairns,1997,11,1404,348,1752
Cairns,1997,12,1448,354,1802
Cairns,1998,1,1442,347,1789
Cairns,1998,2,1237,303,1540
Cairns,1998,3,1399,331,1730
Cairns,1998,4,1390,316,1706
Cairns,1998,5,1396,323,1719
Cairns,1998,6,1367,308,1675
Cairns,1998,7,1468,333,1801
Cairns,1998,8,1455,323,1778
Cairns,1998,9,1446,310,1756
Cairns,1998,10,1524,310,1834
Cairns,1998,11,1426,296,1722
Cairns,1998,12,1461,308,1769
Cairns,1999,1,1411,312,1723
Cairns,1999,2,1239,279,1518
Cairns,1999,3,1427,320,1747
Cairns,1999,4,1393,314,1707
Cairns,1999,5,1421,316,1737
Cairns,1999,6,1419,286,1705
Cairns,1999,7,1517,315,1832
Cairns,1999,8,1470,301,1771
Cairns,1999,9,1430,301,1731
Cairns,1999,10,1490,302,1792
Cairns,1999,11,1401,274,1675
Cairns,1999,12,1435,285,1720
Cairns,2000,1,1415,270,1685
Cairns,2000,2,1314,255,1569
Cairns,2000,3,1456,279,1735
Cairns,2000,4,1408,270,1678
Cairns,2000,5,1496,275,1771
Cairns,2000,6,1471,273,1744
Cairns,2000,7,1560,281,1841
Cairns,2000,8,1550,268,1818
Cairns,2000,9,1504,251,1755
Cairns,2000,10,1566,252,1818
Cairns,2000,11,1484,241,1725
Cairns,2000,12,1500,251,1751
Cairns,2001,1,1473,250,1723
Cairns,2001,2,1322,224,1546
Cairns,2001,3,1490,247,1737
Cairns,2001,4,1474,243,1717
Cairns,2001,5,1531,252,1783
Cairns,2001,6,1458,246,1704
Cairns,2001,7,1481,228,1709
Cairns,2001,8,1431,233,1664
Cairns,2001,9,1198,240,1438
Cairns,2001,10,1129,255,1384
Cairns,2001,11,1110,250,1360
Cairns,2001,12,1149,265,1414
Cairns,2002,1,1097,264,1361
Cairns,2002,2,1046,234,1280
Cairns,2002,3,1176,259,1435
Cairns,2002,4,1162,243,1405
Cairns,2002,5,1277,307,1584
Cairns,2002,6,1227,301,1528
Cairns,2002,7,1389,306,1695
Cairns,2002,8,1421,309,1730
Cairns,2002,9,1321,294,1615
Cairns,2002,10,1389,314,1703
Cairns,2002,11,1278,337,1615
Cairns,2002,12,1263,348,1611
Cairns,2003,1,1226,353,1579
Cairns,2003,2,1164,321,1485
Cairns,2003,3,1291,351,1642
Cairns,2003,4,1248,329,1577
Cairns,2003,5,1286,264,1550
Cairns,2003,6,1234,231,1465
Cairns,2003,7,1339,264,1603
Cairns,2003,8,1417,280,1697
Cairns,2003,9,1404,274,1678
Cairns,2003,10,1463,304,1767
Cairns,2003,11,1399,359,1758
Cairns,2003,12,1473,368,1841
Cairns,2004,1,1433,379,1812
Cairns,2004,2,1269,348,1617
Cairns,2004,3,1407,370,1777
Cairns,2004,4,1451,355,1806
Cairns,2004,5,1468,368,1836
Cairns,2004,6,1436,358,1794
Cairns,2004,7,1572,368,1940
Cairns,2004,8,1629,367,1996
Cairns,2004,9,1554,355,1909
Cairns,2004,10,1610,365,1975
Cairns,2004,11,1570,363,1933
Cairns,2004,12,1501,350,1851
Cairns,2005,1,1458,335,1793
Cairns,2005,2,1407,317,1724
Cairns,2005,3,1558,347,1905
Cairns,2005,4,1539,332,1871
Cairns,2005,5,1578,335,1913
Cairns,2005,6,1586,332,1918
Cairns,2005,7,1644,347,1991
Cairns,2005,8,1708,366,2074
Cairns,2005,9,1698,352,2050
Cairns,2005,10,1719,357,2076
Cairns,2005,11,1658,356,2014
Cairns,2005,12,1627,378,2005
Cairns,2006,1,1592,371,1963
Cairns,2006,2,1346,338,1684
Cairns,2006,3,1509,368,1877
Cairns,2006,4,1425,329,1754
Cairns,2006,5,1518,346,1864
Cairns,2006,6,1534,343,1877
Cairns,2006,7,1641,342,1983
Cairns,2006,8,1623,343,1966
Cairns,2006,9,1581,334,1915
Cairns,2006,10,1617,330,1947
Cairns,2006,11,1586,336,1922
Cairns,2006,12,1478,340,1818
Cairns,2007,1,1454,359,1813
Cairns,2007,2,1388,322,1710
Cairns,2007,3,1533,348,1881
Cairns,2007,4,1460,312,1772
Cairns,2007,5,1569,328,1897
Cairns,2007,6,1533,319,1852
Cairns,2007,7,1525,331,1856
Cairns,2007,8,1536,330,1866
Cairns,2007,9,1449,315,1764
Cairns,2007,10,1499,319,1818
Cairns,2007,11,1501,304,1805
Cairns,2007,12,1489,313,1802
Cairns,2008,1,1479,317,1796
Cairns,2008,2,1389,301,1690
Cairns,2008,3,1519,315,1834
Cairns,2008,4,1481,307,1788
Cairns,2008,5,1556,314,1870
Cairns,2008,6,1555,297,1852
Cairns,2008,7,1595,318,1913
Cairns,2008,8,1605,334,1939
Cairns,2008,9,1504,328,1832
Cairns,2008,10,1466,336,1802
Cairns,2008,11,1339,324,1663
Cairns,2008,12,1326,278,1604
Cairns,2009,1,1298,211,1509
Cairns,2009,2,1178,183,1361
Cairns,2009,3,1314,211,1525
Cairns,2009,4,1340,209,1549
Cairns,2009,5,1314,215,1529
Cairns,2009,6,1320,203,1523
Cairns,2009,7,1474,204,1678
Cairns,2009,8,1423,205,1628
Cairns,2009,9,1392,199,1591
Cairns,2009,10,1436,201,1637
Cairns,2009,11,1396,189,1585
Cairns,2009,12,1394,195,1589
Cairns,2010,1,1367,193,1560
Cairns,2010,2,1289,179,1468
Cairns,2010,3,1430,208,1638
Cairns,2010,4,1491,222,1713
Cairns,2010,5,1455,224,1679
Cairns,2010,6,1470,220,1690
Cairns,2010,7,1563,266,1829
Cairns,2010,8,1518,262,1780
Cairns,2010,9,1530,252,1782
Cairns,2010,10,1583,252,1835
Cairns,2010,11,1522,246,1768
Cairns,2010,12,1548,258,1806
Cairns,2011,1,1503,265,1768
Cairns,2011,2,1294,217,1511
Cairns,2011,3,1498,259,1757
Cairns,2011,4,1569,248,1817
Cairns,2011,5,1556,256,1812
Cairns,2011,6,1558,237,1795
Cairns,2011,7,1664,272,1936
Cairns,2011,8,1668,277,1945
Cairns,2011,9,1585,263,1848
Cairns,2011,10,1600,253,1853
Cairns,2011,11,1489,230,1719
Cairns,2011,12,1498,243,1741
Cairns,2012,1,1524,245,1769
Cairns,2012,2,1418,231,1649
Cairns,2012,3,1553,236,1789
Cairns,2012,4,1633,229,1862
Cairns,2012,5,1627,229,1856
Cairns,2012,6,1565,223,1788
Cairns,2012,7,1766,243,2009
Cairns,2012,8,1723,246,1969
Cairns,2012,9,1659,234,1893
Cairns,2012,10,1743,237,1980
Cairns,2012,11,1585,223,1808
Cairns,2012,12,1602,233,1835
Cairns,2013,1,1630,219,1849
Cairns,2013,2,1414,213,1627
Cairns,2013,3,1565,222,1787
Cairns,2013,4,1713,218,1931
Cairns,2013,5,1652,233,1885
Cairns,2013,6,1646,231,1877
Cairns,2013,7,1847,258,2105
Cairns,2013,8,1794,256,2050
Cairns,2013,9,1755,229,1984
Cairns,2013,10,1809,230,2039
Cairns,2013,11,1578,204,1782
Cairns,2013,12,1642,204,1846
Cairns,2014,1,1678,213,1891
Cairns,2014,2,1367,196,1563
Cairns,2014,3,1497,208,1705
Cairns,2014,4,1620,191,1811
Cairns,2014,5,1587,218,1805
Cairns,2014,6,1603,212,1815
Cairns,2014,7,1791,230,2021
Cairns,2014,8,1718,239,1957
Cairns,2014,9,1730,223,1953
Cairns,2014,10,1751,225,1976
Cairns,2014,11,1545,189,1734
Cairns,2014,12,1628,204,1832
Cairns,2015,1,1621,206,1827
Cairns,2015,2,1465,217,1682
Cairns,2015,3,1584,207,1791
Cairns,2015,4,1606,229,1835
Cairns,2015,5,1577,217,1794
Cairns,2015,6,1640,225,1865
Cairns,2015,7,1855,254,2109
Cairns,2015,8,1825,273,2098
Cairns,2015,9,1819,243,2062
Cairns,2015,10,1827,242,2069
Cairns,2015,11,1661,218,1879
Cairns,2015,12,1779,258,2037
Cairns,2016,1,1753,287,2040
Cairns,2016,2,1616,281,1897
Cairns,2016,3,1729,286,2015
Cairns,2016,4,1771,281,2052
Cairns,2016,5,1712,262,1974
Cairns,2016,6,1761,256,2017
Cairns,2016,7,1909,279,2188
Cairns,2016,8,1889,281,2170
Cairns,2016,9,1882,273,2155
Cairns,2016,10,1882,267,2149
Cairns,2016,11,1718,231,1949
Cairns,2016,12,1805,253,2058
Cairns,2017,1,1811,264,2075
Cairns,2017,2,1529,225,1754
Cairns,2017,3,1725,239,1964
Cairns,2017,4,1777,244,2021
Cairns,2017,5,1732,226,1958
Cairns,2017,6,1744,226,1970
Cairns,2017,7,1972,261,2233
Cairns,2017,8,1917,279,2196
Cairns,2017,9,1851,247,2098
Cairns,2017,10,1892,246,2138
Cairns,2017,11,1687,212,1899
Cairns,2017,12,1732,210,1942
Cairns,2018,1,1815,228,2043
Cairns,2018,2,1521,203,1724
Cairns,2018,3,1671,208,1879
Cairns,2018,4,1810,200,2010
Cairns,2018,5,1694,195,1889
Cairns,2018,6,1686,185,1871
Cairns,2018,7,1919,226,2145
Cairns,2018,8,1860,234,2094
Cairns,2018,9,1786,213,1999
Cairns,2018,10,1850,215,2065
Cairns,2018,11,1643,154,1797
Cairns,2018,12,1706,183,1889
Cairns,2019,1,1790,192,1982
Cairns,2019,2,1516,172,1688
Cairns,2019,3,1606,176,1782
Cairns,2019,4,1744,218,1962
Cairns,2019,5,1678,211,1889
Cairns,2019,6,1622,213,1835
Cairns,2019,7,1899,238,2137
Cairns,2019,8,1771,243,2014
Cairns,2019,9,1734,223,1957
Cairns,2019,10,1812,220,2032
Cairns,2019,11,1608,184,1792
Cairns,2019,12,1667,158,1825
Cairns,2020,1,1699,168,1867
Cairns,2020,2,1449,145,1594
Cairns,2020,3,1290,111,1401
Cairns,2020,4,230,12,242
Cairns,2020,5,277,17,294
Cairns,2020,6,357,18,375
Cairns,2020,7,688,17,705
Cairns,2020,8,735,18,753
Cairns,2020,9,935,17,952
Cairns,2020,10,975,20,995
Cairns,2020,11,901,22,923
Cairns,2020,12,1160,22,1182
Cairns,2021,1,1131,23,1154
Cairns,2021,2,925,24,949
Cairns,2021,3,1176,25,1201
Cairns,2021,4,1488,20,1508
Cairns,2021,5,1427,16,1443
Cairns,2021,6,1436,19,1455
Cairns,2021,7,1443,19,1462
Cairns,2021,8,1019,13,1032
Cairns,2021,9,1211,14,1225
Cairns,2021,10,1237,13,1250
Cairns,2021,11,1242,15,1257
Cairns,2021,12,1525,18,1543
Cairns,2022,1,1442,64,1506
Cairns,2022,2,1029,65,1094
Cairns,2022,3,1389,74,1463
Cairns,2022,4,1736,89,1825
Cairns,2022,5,1602,92,1694
Cairns,2022,6,1634,95,1729
Cairns,2022,7,1698,71,1769
Cairns,2022,8,1649,91,1740
Cairns,2022,9,1642,65,1707
Cairns,2022,10,1661,83,1744
Cairns,2022,11,1514,80,1594
Cairns,2022,12,1587,81,1668
Cairns,2023,1,1548,88,1636
Cairns,2023,2,1293,89,1382
Cairns,2023,3,1523,106,1629
Cairns,2023,4,1667,121,1788
Cairns,2023,5,1631,119,1750
Cairns,2023,6,1661,121,1782
Cairns,2023,7,1791,169,1960
Cairns,2023,8,1775,175,1950
Cairns,2023,9,1757,165,1922
Cairns,2023,10,1823,159,1982
Cairns,2023,11,1595,152,1747
Cairns,2023,12,1470,154,1624
Cairns,2024,1,1706,171,1877
Cairns,2024,2,1480,158,1638
Cairns,2024,3,1597,166,1763
Cairns,2024,4,1819,157,1976
Cairns,2024,5,1693,160,1853
Cairns,2024,6,1680,151,1831
Cairns,2024,7,1954,163,2117
Cairns,2024,8,1865,172,2037
Cairns,2024,9,1847,167,2014
Cairns,2024,10,1850,167,2017
Cairns,2024,11,1619,160,1779
Cairns,2024,12,1698,196,1894
Canberra,1985,1,684,0,684
Canberra,1985,2,739,0,739
Canberra,1985,3,794,0,794
Canberra,1985,4,762,0,762
Canberra,1985,5,836,0,836
Canberra,1985,6,699,0,699
Canberra,1985,7,767,0,767
Canberra,1985,8,840,0,840
Canberra,1985,9,888,0,888
Canberra,1985,10,959,0,959
Canberra,1985,11,891,0,891
Canberra,1985,12,840,0,840
Canberra,1986,1,740,0,740
Canberra,1986,2,805,0,805
Canberra,1986,3,906,0,906
Canberra,1986,4,908,0,908
Canberra,1986,5,906,0,906
Canberra,1986,6,859,0,859
Canberra,1986,7,874,0,874
Canberra,1986,8,926,0,926
Canberra,1986,9,923,0,923
Canberra,1986,10,966,0,966
Canberra,1986,11,921,0,921
Canberra,1986,12,879,0,879
Canberra,1987,1,774,0,774
Canberra,1987,2,835,0,835
Canberra,1987,3,947,0,947
Canberra,1987,4,898,0,898
Canberra,1987,5,952,0,952
Canberra,1987,6,902,0,902
Canberra,1987,7,969,0,969
Canberra,1987,8,946,0,946
Canberra,1987,9,964,0,964
Canberra,1987,10,1003,0,1003
Canberra,1987,11,968,0,968
Canberra,1987,12,890,0,890
Canberra,1988,1,732,0,732
Canberra,1988,2,835,0,835
Canberra,1988,3,908,0,908
Canberra,1988,4,813,0,813
Canberra,1988,5,907,0,907
Canberra,1988,6,900,0,900
Canberra,1988,7,829,0,829
Canberra,1988,8,965,0,965
Canberra,1988,9,936,0,936
Canberra,1988,10,889,0,889
Canberra,1988,11,924,0,924
Canberra,1988,12,819,0,819
Canberra,1989,1,621,0,621
Canberra,1989,2,796,0,796
Canberra,1989,3,875,0,875
Canberra,1989,4,852,0,852
Canberra,1989,5,965,0,965
Canberra,1989,6,914,0,914
Canberra,1989,7,968,0,968
Canberra,1989,8,631,0,631
Canberra,1989,9,269,0,269
Canberra,1989,10,552,0,552
Canberra,1989,11,675,0,675
Canberra,1989,12,534,0,534
Canberra,1990,1,436,0,436
Canberra,1990,2,538,0,538
Canberra,1990,3,611,0,611
Canberra,1990,4,691,0,691
Canberra,1990,5,840,0,840
Canberra,1990,6,824,0,824
Canberra,1990,7,903,0,903
Canberra,1990,8,1006,0,1006
Canberra,1990,9,927,0,927
Canberra,1990,10,982,0,982
Canberra,1990,11,979,0,979
Canberra,1990,12,907,0,907
Canberra,1991,1,745,0,745
Canberra,1991,2,863,0,863
Canberra,1991,3,953,0,953
Canberra,1991,4,921,0,921
Canberra,1991,5,1062,0,1062
Canberra,1991,6,980,0,980
Canberra,1991,7,1093,0,1093
Canberra,1991,8,1114,0,1114
Canberra,1991,9,1087,0,1087
Canberra,1991,10,1131,0,1131
Canberra,1991,11,1166,0,1166
Canberra,1991,12,1027,0,1027
Canberra,1992,1,749,0,749
Canberra,1992,2,1055,0,1055
Canberra,1992,3,1126,0,1126
Canberra,1992,4,1144,0,1144
Canberra,1992,5,1162,0,1162
Canberra,1992,6,1141,0,1141
Canberra,1992,7,1211,0,1211
Canberra,1992,8,1195,0,1195
Canberra,1992,9,1248,0,1248
Canberra,1992,10,1281,0,1281
Canberra,1992,11,1240,0,1240
Canberra,1992,12,1131,0,1131
Canberra,1993,1,897,0,897
Canberra,1993,2,1152,0,1152
Canberra,1993,3,1329,0,1329
Canberra,1993,4,1253,0,1253
Canberra,1993,5,1318,0,1318
Canberra,1993,6,1264,0,1264
Canberra,1993,7,1264,0,1264
Canberra,1993,8,1285,0,1285
Canberra,1993,9,1240,0,1240
Canberra,1993,10,1274,0,1274
Canberra,1993,11,1301,0,1301
Canberra,1993,12,1197,0,1197
Canberra,1994,1,953,0,953
Canberra,1994,2,1279,0,1279
Canberra,1994,3,1462,0,1462
Canberra,1994,4,1390,0,1390
Canberra,1994,5,1529,0,1529
Canberra,1994,6,1460,0,1460
Canberra,1994,7,1467,0,1467
Canberra,1994,8,1526,0,1526
Canberra,1994,9,1539,0,1539
Canberra,1994,10,1498,0,1498
Canberra,1994,11,1555,0,1555
Canberra,1994,12,1447,0,1447
Canberra,1995,1,1145,0,1145
Canberra,1995,2,1436,0,1436
Canberra,1995,3,1635,0,1635
Canberra,1995,4,1452,0,1452
Canberra,1995,5,1594,0,1594
Canberra,1995,6,1512,0,1512
Canberra,1995,7,1570,0,1570
Canberra,1995,8,1587,0,1587
Canberra,1995,9,1538,0,1538
Canberra,1995,10,1599,0,1599
Canberra,1995,11,1585,0,1585
Canberra,1995,12,1405,0,1405
Canberra,1996,1,1284,0,1284
Canberra,1996,2,1474,0,1474
Canberra,1996,3,1553,0,1553
Canberra,1996,4,1593,0,1593
Canberra,1996,5,1733,0,1733
Canberra,1996,6,1556,0,1556
Canberra,1996,7,1689,0,1689
Canberra,1996,8,1689,0,1689
Canberra,1996,9,1634,0,1634
Canberra,1996,10,1723,0,1723
Canberra,1996,11,1623,0,1623
Canberra,1996,12,1458,0,1458
Canberra,1997,1,1207,0,1207
Canberra,1997,2,1525,0,1525
Canberra,1997,3,1635,0,1635
Canberra,1997,4,1640,0,1640
Canberra,1997,5,1653,0,1653
Canberra,1997,6,1592,0,1592
Canberra,1997,7,1718,0,1718
Canberra,1997,8,1665,0,1665
Canberra,1997,9,1648,0,1648
Canberra,1997,10,1717,0,1717
Canberra,1997,11,1623,0,1623
Canberra,1997,12,1489,0,1489
Canberra,1998,1,1276,0,1276
Canberra,1998,2,1540,0,1540
Canberra,1998,3,1710,0,1710
Canberra,1998,4,1582,0,1582
Canberra,1998,5,1647,0,1647
Canberra,1998,6,1590,0,1590
Canberra,1998,7,1695,0,1695
Canberra,1998,8,1639,0,1639
Canberra,1998,9,1623,0,1623
Canberra,1998,10,1660,0,1660
Canberra,1998,11,1596,0,1596
Canberra,1998,12,1481,0,1481
Canberra,1999,1,1236,0,1236
Canberra,1999,2,1548,0,1548
Canberra,1999,3,1702,0,1702
Canberra,1999,4,1572,0,1572
Canberra,1999,5,1653,0,1653
Canberra,1999,6,1624,0,1624
Canberra,1999,7,1726,0,1726
Canberra,1999,8,1730,0,1730
Canberra,1999,9,1698,0,1698
Canberra,1999,10,1708,0,1708
Canberra,1999,11,1681,0,1681
Canberra,1999,12,1610,0,1610
Canberra,2000,1,1397,0,1397
Canberra,2000,2,1641,0,1641
Canberra,2000,3,1814,0,1814
Canberra,2000,4,1625,0,1625
Canberra,2000,5,1827,0,1827
Canberra,2000,6,2012,0,2012
Canberra,2000,7,2140,0,2140
Canberra,2000,8,2160,0,2160
Canberra,2000,9,2024,0,2024
Canberra,2000,10,2140,0,2140
Canberra,2000,11,2130,0,2130
Canberra,2000,12,1949,0,1949
Canberra,2001,1,1779,0,1779
Canberra,2001,2,2191,0,2191
Canberra,2001,3,2489,0,2489
Canberra,2001,4,2417,0,2417
Canberra,2001,5,2521,0,2521
Canberra,2001,6,2065,0,2065
Canberra,2001,7,2170,0,2170
Canberra,2001,8,2295,0,2295
Canberra,2001,9,1600,0,1600
Canberra,2001,10,1490,0,1490
Canberra,2001,11,1611,0,1611
Canberra,2001,12,1539,0,1539
Canberra,2002,1,1383,0,1383
Canberra,2002,2,1531,0,1531
Canberra,2002,3,1578,0,1578
Canberra,2002,4,1557,0,1557
Canberra,2002,5,1622,0,1622
Canberra,2002,6,1482,0,1482
Canberra,2002,7,1503,0,1503
Canberra,2002,8,1475,0,1475
Canberra,2002,9,1521,0,1521
Canberra,2002,10,1661,0,1661
Canberra,2002,11,1518,0,1518
Canberra,2002,12,1388,0,1388
Canberra,2003,1,1277,0,1277
Canberra,2003,2,1411,0,1411
Canberra,2003,3,1564,0,1564
Canberra,2003,4,1403,0,1403
Canberra,2003,5,1621,0,1621
Canberra,2003,6,1632,0,1632
Canberra,2003,7,1751,0,1751
Canberra,2003,8,1622,0,1622
Canberra,2003,9,1669,0,1669
Canberra,2003,10,1690,0,1690
Canberra,2003,11,1553,0,1553
Canberra,2003,12,1477,0,1477
Canberra,2004,1,1350,0,1350
Canberra,2004,2,1590,0,1590
Canberra,2004,3,1776,0,1776
Canberra,2004,4,1671,0,1671
Canberra,2004,5,1747,0,1747
Canberra,2004,6,1702,0,1702
Canberra,2004,7,1741,8,1749
Canberra,2004,8,1791,9,1800
Canberra,2004,9,1683,4,1687
Canberra,2004,10,1689,0,1689
Canberra,2004,11,1709,0,1709
Canberra,2004,12,1531,0,1531
Canberra,2005,1,1268,0,1268
Canberra,2005,2,1439,0,1439
Canberra,2005,3,1569,0,1569
Canberra,2005,4,1497,0,1497
Canberra,2005,5,1610,0,1610
Canberra,2005,6,1580,0,1580
Canberra,2005,7,1595,0,1595
Canberra,2005,8,1689,0,1689
Canberra,2005,9,1653,0,1653
Canberra,2005,10,1669,0,1669
Canberra,2005,11,1669,0,1669
Canberra,2005,12,1407,0,1407
Canberra,2006,1,1196,0,1196
Canberra,2006,2,1487,0,1487
Canberra,2006,3,1673,0,1673
Canberra,2006,4,1524,0,1524
Canberra,2006,5,1779,0,1779
Canberra,2006,6,1641,0,1641
Canberra,2006,7,1673,0,1673
Canberra,2006,8,1759,0,1759
Canberra,2006,9,1647,0,1647
Canberra,2006,10,1669,0,1669
Canberra,2006,11,1657,0,1657
Canberra,2006,12,1382,0,1382
Canberra,2007,1,1222,0,1222
Canberra,2007,2,1524,0,1524
Canberra,2007,3,1696,0,1696
Canberra,2007,4,1464,0,1464
Canberra,2007,5,1743,0,1743
Canberra,2007,6,1588,0,1588
Canberra,2007,7,1554,0,1554
Canberra,2007,8,1784,0,1784
Canberra,2007,9,1616,0,1616
Canberra,2007,10,1674,0,1674
Canberra,2007,11,1677,0,1677
Canberra,2007,12,1459,0,1459
Canberra,2008,1,1318,0,1318
Canberra,2008,2,1716,0,1716
Canberra,2008,3,1887,0,1887
Canberra,2008,4,1923,0,1923
Canberra,2008,5,1993,0,1993
Canberra,2008,6,1884,0,1884
Canberra,2008,7,1970,0,1970
Canberra,2008,8,1949,0,1949
Canberra,2008,9,1952,0,1952
Canberra,2008,10,1996,0,1996
Canberra,2008,11,1878,0,1878
Canberra,2008,12,1705,0,1705
Canberra,2009,1,1600,0,1600
Canberra,2009,2,1754,0,1754
Canberra,2009,3,1939,0,1939
Canberra,2009,4,1890,0,1890
Canberra,2009,5,1999,0,1999
Canberra,2009,6,1924,0,1924
Canberra,2009,7,1959,0,1959
Canberra,2009,8,1945,0,1945
Canberra,2009,9,1905,0,1905
Canberra,2009,10,1806,0,1806
Canberra,2009,11,1861,0,1861
Canberra,2009,12,1762,0,1762
Canberra,2010,1,1561,0,1561
Canberra,2010,2,1767,0,1767
Canberra,2010,3,1974,0,1974
Canberra,2010,4,1850,0,1850
Canberra,2010,5,1916,0,1916
Canberra,2010,6,1849,0,1849
Canberra,2010,7,1868,0,1868
Canberra,2010,8,1851,0,1851
Canberra,2010,9,1751,0,1751
Canberra,2010,10,1895,0,1895
Canberra,2010,11,1882,0,1882
Canberra,2010,12,1768,0,1768
Canberra,2011,1,1535,0,1535
Canberra,2011,2,1736,0,1736
Canberra,2011,3,1956,0,1956
Canberra,2011,4,1768,0,1768
Canberra,2011,5,1875,0,1875
Canberra,2011,6,1733,0,1733
Canberra,2011,7,1862,0,1862
Canberra,2011,8,1907,0,1907
Canberra,2011,9,1848,0,1848
Canberra,2011,10,1811,0,1811
Canberra,2011,11,1876,0,1876
Canberra,2011,12,1726,0,1726
Canberra,2012,1,1489,0,1489
Canberra,2012,2,1779,0,1779
Canberra,2012,3,1866,0,1866
Canberra,2012,4,1754,0,1754
Canberra,2012,5,1825,0,1825
Canberra,2012,6,1650,0,1650
Canberra,2012,7,1788,0,1788
Canberra,2012,8,1848,0,1848
Canberra,2012,9,1732,0,1732
Canberra,2012,10,1826,0,1826
Canberra,2012,11,1804,0,1804
Canberra,2012,12,1576,0,1576
Canberra,2013,1,1480,0,1480
Canberra,2013,2,1667,0,1667
Canberra,2013,3,1821,0,1821
Canberra,2013,4,1747,0,1747
Canberra,2013,5,1850,0,1850
Canberra,2013,6,1719,0,1719
Canberra,2013,7,1810,0,1810
Canberra,2013,8,1787,0,1787
Canberra,2013,9,1742,0,1742
Canberra,2013,10,1812,0,1812
Canberra,2013,11,1743,0,1743
Canberra,2013,12,1634,0,1634
Canberra,2014,1,1424,0,1424
Canberra,2014,2,1560,0,1560
Canberra,2014,3,1704,0,1704
Canberra,2014,4,1629,0,1629
Canberra,2014,5,1713,0,1713
Canberra,2014,6,1639,0,1639
Canberra,2014,7,1712,0,1712
Canberra,2014,8,1709,0,1709
Canberra,2014,9,1683,0,1683
Canberra,2014,10,1733,0,1733
Canberra,2014,11,1609,0,1609
Canberra,2014,12,1570,0,1570
Canberra,2015,1,1378,0,1378
Canberra,2015,2,1524,0,1524
Canberra,2015,3,1679,0,1679
Canberra,2015,4,1532,0,1532
Canberra,2015,5,1613,0,1613
Canberra,2015,6,1612,0,1612
Canberra,2015,7,1674,0,1674
Canberra,2015,8,1662,0,1662
Canberra,2015,9,1639,0,1639
Canberra,2015,10,1699,0,1699
Canberra,2015,11,1670,0,1670
Canberra,2015,12,1474,0,1474
Canberra,2016,1,1276,0,1276
Canberra,2016,2,1620,0,1620
Canberra,2016,3,1671,0,1671
Canberra,2016,4,1618,0,1618
Canberra,2016,5,1673,0,1673
Canberra,2016,6,1543,0,1543
Canberra,2016,7,1634,0,1634
Canberra,2016,8,1724,0,1724
Canberra,2016,9,1625,12,1637
Canberra,2016,10,1622,36,1658
Canberra,2016,11,1636,34,1670
Canberra,2016,12,1467,36,1503
Canberra,2017,1,1239,36,1275
Canberra,2017,2,1565,35,1600
Canberra,2017,3,1720,36,1756
Canberra,2017,4,1488,35,1523
Canberra,2017,5,1698,35,1733
Canberra,2017,6,1590,35,1625
Canberra,2017,7,1690,36,1726
Canberra,2017,8,1746,33,1779
Canberra,2017,9,1627,32,1659
Canberra,2017,10,1686,34,1720
Canberra,2017,11,1687,34,1721
Canberra,2017,12,1488,36,1524
Canberra,2018,1,1278,36,1314
Canberra,2018,2,1555,49,1604
Canberra,2018,3,1707,60,1767
Canberra,2018,4,1515,65,1580
Canberra,2018,5,1724,62,1786
Canberra,2018,6,1600,60,1660
Canberra,2018,7,1694,63,1757
Canberra,2018,8,1746,62,1808
Canberra,2018,9,1645,60,1705
Canberra,2018,10,1703,62,1765
Canberra,2018,11,1662,60,1722
Canberra,2018,12,1454,61,1515
Canberra,2019,1,1284,63,1347
Canberra,2019,2,1546,56,1602
Canberra,2019,3,1678,62,1740
Canberra,2019,4,1588,60,1648
Canberra,2019,5,1686,62,1748
Canberra,2019,6,1581,60,1641
Canberra,2019,7,1706,62,1768
Canberra,2019,8,1690,62,1752
Canberra,2019,9,1678,60,1738
Canberra,2019,10,1725,61,1786
Canberra,2019,11,1643,58,1701
Canberra,2019,12,1477,62,1539
Canberra,2020,1,1230,62,1292
Canberra,2020,2,1532,58,1590
Canberra,2020,3,1280,43,1323
Canberra,2020,4,126,0,126
Canberra,2020,5,91,0,91
Canberra,2020,6,155,0,155
Canberra,2020,7,228,0,228
Canberra,2020,8,199,0,199
Canberra,2020,9,170,0,170
Canberra,2020,10,320,0,320
Canberra,2020,11,492,1,493
Canberra,2020,12,711,0,711
Canberra,2021,1,706,0,706
Canberra,2021,2,849,0,849
Canberra,2021,3,950,0,950
Canberra,2021,4,1056,0,1056
Canberra,2021,5,1387,0,1387
Canberra,2021,6,1168,0,1168
Canberra,2021,7,715,0,715
Canberra,2021,8,273,0,273
Canberra,2021,9,158,0,158
Canberra,2021,10,167,0,167
Canberra,2021,11,528,0,528
Canberra,2021,12,999,0,999
Canberra,2022,1,866,0,866
Canberra,2022,2,902,0,902
Canberra,2022,3,1345,0,1345
Canberra,2022,4,1668,0,1668
Canberra,2022,5,1832,0,1832
Canberra,2022,6,1657,0,1657
Canberra,2022,7,1663,0,1663
Canberra,2022,8,1662,0,1662
Canberra,2022,9,1562,0,1562
Canberra,2022,10,1591,0,1591
Canberra,2022,11,1634,0,1634
Canberra,2022,12,1570,0,1570
Canberra,2023,1,1385,0,1385
Canberra,2023,2,1538,0,1538
Canberra,2023,3,1748,0,1748
Canberra,2023,4,1618,1,1619
Canberra,2023,5,1818,0,1818
Canberra,2023,6,1726,0,1726
Canberra,2023,7,1710,3,1713
Canberra,2023,8,1791,9,1800
Canberra,2023,9,1726,9,1735
Canberra,2023,10,1742,14,1756
Canberra,2023,11,1699,12,1711
Canberra,2023,12,1488,14,1502
Canberra,2024,1,1292,13,1305
Canberra,2024,2,1591,8,1599
Canberra,2024,3,1682,10,1692
Canberra,2024,4,1585,13,1598
Canberra,2024,5,1664,9,1673
Canberra,2024,6,1546,19,1565
Canberra,2024,7,1602,25,1627
Canberra,2024,8,1578,21,1599
Canberra,2024,9,1532,19,1551
Canberra,2024,10,1596,21,1617
Canberra,2024,11,1590,13,1603
Canberra,2024,12,1354,19,1373
Darwin,1985,1,470,29,499
Darwin,1985,2,405,24,429
Darwin,1985,3,424,29,453
Darwin,1985,4,392,28,420
Darwin,1985,5,413,27,440
Darwin,1985,6,419,28,447
Darwin,1985,7,441,33,474
Darwin,1985,8,461,26,487
Darwin,1985,9,439,28,467
Darwin,1985,10,470,27,497
Darwin,1985,11,439,27,466
Darwin,1985,12,421,32,453
Darwin,1986,1,416,32,448
Darwin,1986,2,335,24,359
Darwin,1986,3,396,29,425
Darwin,1986,4,359,48,407
Darwin,1986,5,388,45,433
Darwin,1986,6,459,40,499
Darwin,1986,7,510,49,559
Darwin,1986,8,493,49,542
Darwin,1986,9,458,39,497
Darwin,1986,10,540,44,584
Darwin,1986,11,435,39,474
Darwin,1986,12,491,51,542
Darwin,1987,1,464,53,517
Darwin,1987,2,376,40,416
Darwin,1987,3,462,45,507
Darwin,1987,4,408,52,460
Darwin,1987,5,457,50,507
Darwin,1987,6,502,49,551
Darwin,1987,7,485,54,539
Darwin,1987,8,451,49,500
Darwin,1987,9,484,51,535
Darwin,1987,10,505,55,560
Darwin,1987,11,429,56,485
Darwin,1987,12,454,60,514
Darwin,1988,1,436,61,497
Darwin,1988,2,401,56,457
Darwin,1988,3,462,55,517
Darwin,1988,4,409,63,472
Darwin,1988,5,418,63,481
Darwin,1988,6,469,60,529
Darwin,1988,7,587,67,654
Darwin,1988,8,525,62,587
Darwin,1988,9,471,59,530
Darwin,1988,10,454,65,519
Darwin,1988,11,399,54,453
Darwin,1988,12,424,54,478
Darwin,1989,1,406,53,459
Darwin,1989,2,380,49,429
Darwin,1989,3,210,54,264
Darwin,1989,4,441,52,493
Darwin,1989,5,216,53,269
Darwin,1989,6,226,55,281
Darwin,1989,7,264,56,320
Darwin,1989,8,184,58,242
Darwin,1989,9,14,62,76
Darwin,1989,10,43,62,105
Darwin,1989,11,103,56,159
Darwin,1989,12,153,53,206
Darwin,1990,1,180,60,240
Darwin,1990,2,180,48,228
Darwin,1990,3,196,54,250
Darwin,1990,4,199,54,253
Darwin,1990,5,212,57,269
Darwin,1990,6,223,56,279
Darwin,1990,7,249,61,310
Darwin,1990,8,243,59,302
Darwin,1990,9,228,53,281
Darwin,1990,10,237,52,289
Darwin,1990,11,232,62,294
Darwin,1990,12,241,66,307
Darwin,1991,1,246,65,311
Darwin,1991,2,203,56,259
Darwin,1991,3,223,64,287
Darwin,1991,4,210,67,277
Darwin,1991,5,228,76,304
Darwin,1991,6,285,70,355
Darwin,1991,7,328,68,396
Darwin,1991,8,321,74,395
Darwin,1991,9,310,70,380
Darwin,1991,10,378,70,448
Darwin,1991,11,505,72,577
Darwin,1991,12,541,78,619
Darwin,1992,1,567,79,646
Darwin,1992,2,513,74,587
Darwin,1992,3,565,79,644
Darwin,1992,4,521,80,601
Darwin,1992,5,557,81,638
Darwin,1992,6,563,74,637
Darwin,1992,7,594,80,674
Darwin,1992,8,498,81,579
Darwin,1992,9,584,78,662
Darwin,1992,10,547,82,629
Darwin,1992,11,527,82,609
Darwin,1992,12,598,83,681
Darwin,1993,1,558,77,635
Darwin,1993,2,493,68,561
Darwin,1993,3,552,75,627
Darwin,1993,4,576,88,664
Darwin,1993,5,592,90,682
Darwin,1993,6,586,84,670
Darwin,1993,7,654,104,758
Darwin,1993,8,618,98,716
Darwin,1993,9,634,101,735
Darwin,1993,10,649,115,764
Darwin,1993,11,630,108,738
Darwin,1993,12,641,122,763
Darwin,1994,1,620,120,740
Darwin,1994,2,555,105,660
Darwin,1994,3,649,117,766
Darwin,1994,4,615,123,738
Darwin,1994,5,662,125,787
Darwin,1994,6,685,127,812
Darwin,1994,7,722,142,864
Darwin,1994,8,714,133,847
Darwin,1994,9,702,133,835
Darwin,1994,10,721,139,860
Darwin,1994,11,708,125,833
Darwin,1994,12,731,141,872
Darwin,1995,1,726,137,863
Darwin,1995,2,658,121,779
Darwin,1995,3,731,132,863
Darwin,1995,4,757,128,885
Darwin,1995,5,788,139,927
Darwin,1995,6,758,134,892
Darwin,1995,7,832,150,982
Darwin,1995,8,842,140,982
Darwin,1995,9,835,136,971
Darwin,1995,10,879,138,1017
Darwin,1995,11,810,137,947
Darwin,1995,12,820,142,962
Darwin,1996,1,889,140,1029
Darwin,1996,2,804,127,931
Darwin,1996,3,862,138,1000
Darwin,1996,4,892,144,1036
Darwin,1996,5,899,145,1044
Darwin,1996,6,833,146,979
Darwin,1996,7,892,162,1054
Darwin,1996,8,881,147,1028
Darwin,1996,9,847,150,997
Darwin,1996,10,898,158,1056
Darwin,1996,11,861,155,1016
Darwin,1996,12,875,166,1041
Darwin,1997,1,861,165,1026
Darwin,1997,2,752,146,898
Darwin,1997,3,837,162,999
Darwin,1997,4,838,163,1001
Darwin,1997,5,866,168,1034
Darwin,1997,6,834,170,1004
Darwin,1997,7,846,168,1014
Darwin,1997,8,830,170,1000
Darwin,1997,9,814,165,979
Darwin,1997,10,845,171,1016
Darwin,1997,11,791,176,967
Darwin,1997,12,828,182,1010
Darwin,1998,1,807,181,988
Darwin,1998,2,740,163,903
Darwin,1998,3,821,179,1000
Darwin,1998,4,817,167,984
Darwin,1998,5,834,171,1005
Darwin,1998,6,826,168,994
Darwin,1998,7,890,171,1061
Darwin,1998,8,869,167,1036
Darwin,1998,9,851,165,1016
Darwin,1998,10,887,170,1057
Darwin,1998,11,892,164,1056
Darwin,1998,12,913,171,1084
Darwin,1999,1,886,168,1054
Darwin,1999,2,830,153,983
Darwin,1999,3,927,167,1094
Darwin,1999,4,880,156,1036
Darwin,1999,5,893,161,1054
Darwin,1999,6,878,158,1036
Darwin,1999,7,821,162,983
Darwin,1999,8,844,157,1001
Darwin,1999,9,834,156,990
Darwin,1999,10,829,158,987
Darwin,1999,11,797,147,944
Darwin,1999,12,746,138,884
Darwin,2000,1,726,135,861
Darwin,2000,2,689,126,815
Darwin,2000,3,827,139,966
Darwin,2000,4,742,131,873
Darwin,2000,5,777,157,934
Darwin,2000,6,789,155,944
Darwin,2000,7,808,163,971
Darwin,2000,8,828,191,1019
Darwin,2000,9,802,190,992
Darwin,2000,10,802,191,993
Darwin,2000,11,774,181,955
Darwin,2000,12,735,187,922
Darwin,2001,1,708,188,896
Darwin,2001,2,673,112,785
Darwin,2001,3,765,121,886
Darwin,2001,4,753,120,873
Darwin,2001,5,793,125,918
Darwin,2001,6,749,116,865
Darwin,2001,7,810,123,933
Darwin,2001,8,791,122,913
Darwin,2001,9,624,113,737
Darwin,2001,10,491,114,605
Darwin,2001,11,516,108,624
Darwin,2001,12,514,72,586
Darwin,2002,1,615,72,687
Darwin,2002,2,595,49,644
Darwin,2002,3,663,54,717
Darwin,2002,4,656,49,705
Darwin,2002,5,683,59,742
Darwin,2002,6,682,57,739
Darwin,2002,7,723,57,780
Darwin,2002,8,725,60,785
Darwin,2002,9,706,59,765
Darwin,2002,10,722,58,780
Darwin,2002,11,643,52,695
Darwin,2002,12,640,61,701
Darwin,2003,1,636,60,696
Darwin,2003,2,563,44,607
Darwin,2003,3,626,50,676
Darwin,2003,4,636,49,685
Darwin,2003,5,675,53,728
Darwin,2003,6,665,52,717
Darwin,2003,7,754,53,807
Darwin,2003,8,734,55,789
Darwin,2003,9,702,52,754
Darwin,2003,10,716,55,771
Darwin,2003,11,634,55,689
Darwin,2003,12,520,59,579
Darwin,2004,1,545,59,604
Darwin,2004,2,508,53,561
Darwin,2004,3,566,57,623
Darwin,2004,4,605,58,663
Darwin,2004,5,672,71,743
Darwin,2004,6,644,78,722
Darwin,2004,7,660,85,745
Darwin,2004,8,659,83,742
Darwin,2004,9,626,82,708
Darwin,2004,10,626,84,710
Darwin,2004,11,552,74,626
Darwin,2004,12,558,92,650
Darwin,2005,1,559,81,640
Darwin,2005,2,534,68,602
Darwin,2005,3,598,74,672
Darwin,2005,4,640,83,723
Darwin,2005,5,662,86,748
Darwin,2005,6,686,101,787
Darwin,2005,7,650,110,760
Darwin,2005,8,666,92,758
Darwin,2005,9,485,82,567
Darwin,2005,10,615,83,698
Darwin,2005,11,577,74,651
Darwin,2005,12,573,83,656
Darwin,2006,1,563,104,667
Darwin,2006,2,517,96,613
Darwin,2006,3,571,107,678
Darwin,2006,4,580,108,688
Darwin,2006,5,687,108,795
Darwin,2006,6,669,107,776
Darwin,2006,7,675,128,803
Darwin,2006,8,688,123,811
Darwin,2006,9,633,107,740
Darwin,2006,10,647,114,761
Darwin,2006,11,622,123,745
Darwin,2006,12,577,131,708
Darwin,2007,1,585,128,713
Darwin,2007,2,547,113,660
Darwin,2007,3,614,127,741
Darwin,2007,4,605,124,729
Darwin,2007,5,640,127,767
Darwin,2007,6,648,131,779
Darwin,2007,7,678,140,818
Darwin,2007,8,676,138,814
Darwin,2007,9,625,138,763
Darwin,2007,10,665,142,807
Darwin,2007,11,633,132,765
Darwin,2007,12,658,144,802
Darwin,2008,1,662,143,805
Darwin,2008,2,616,112,728
Darwin,2008,3,653,124,777
Darwin,2008,4,675,148,823
Darwin,2008,5,688,176,864
Darwin,2008,6,682,173,855
Darwin,2008,7,707,180,887
Darwin,2008,8,691,176,867
Darwin,2008,9,657,209,866
Darwin,2008,10,664,217,881
Darwin,2008,11,675,189,864
Darwin,2008,12,739,256,995
Darwin,2009,1,714,252,966
Darwin,2009,2,654,227,881
Darwin,2009,3,731,245,976
Darwin,2009,4,766,218,984
Darwin,2009,5,852,220,1072
Darwin,2009,6,877,214,1091
Darwin,2009,7,927,212,1139
Darwin,2009,8,917,212,1129
Darwin,2009,9,899,207,1106
Darwin,2009,10,910,211,1121
Darwin,2009,11,861,206,1067
Darwin,2009,12,866,226,1092
Darwin,2010,1,852,227,1079
Darwin,2010,2,813,189,1002
Darwin,2010,3,931,210,1141
Darwin,2010,4,899,188,1087
Darwin,2010,5,926,191,1117
Darwin,2010,6,902,197,1099
Darwin,2010,7,991,221,1212
Darwin,2010,8,997,219,1216
Darwin,2010,9,949,211,1160
Darwin,2010,10,970,218,1188
Darwin,2010,11,902,214,1116
Darwin,2010,12,927,209,1136
Darwin,2011,1,896,206,1102
Darwin,2011,2,761,183,944
Darwin,2011,3,937,222,1159
Darwin,2011,4,920,223,1143
Darwin,2011,5,933,227,1160
Darwin,2011,6,926,220,1146
Darwin,2011,7,1082,170,1252
Darwin,2011,8,1072,163,1235
Darwin,2011,9,1011,163,1174
Darwin,2011,10,1000,161,1161
Darwin,2011,11,959,143,1102
Darwin,2011,12,950,158,1108
Darwin,2012,1,938,157,1095
Darwin,2012,2,890,127,1017
Darwin,2012,3,1004,140,1144
Darwin,2012,4,974,185,1159
Darwin,2012,5,969,161,1130
Darwin,2012,6,941,167,1108
Darwin,2012,7,1027,182,1209
Darwin,2012,8,1038,163,1201
Darwin,2012,9,997,152,1149
Darwin,2012,10,1060,156,1216
Darwin,2012,11,1024,128,1152
Darwin,2012,12,779,144,923
Darwin,2013,1,932,138,1070
Darwin,2013,2,878,115,993
Darwin,2013,3,982,132,1114
Darwin,2013,4,985,129,1114
Darwin,2013,5,1021,127,1148
Darwin,2013,6,957,186,1143
Darwin,2013,7,1074,217,1291
Darwin,2013,8,1069,208,1277
Darwin,2013,9,992,163,1155
Darwin,2013,10,1026,170,1196
Darwin,2013,11,955,166,1121
Darwin,2013,12,940,186,1126
Darwin,2014,1,954,190,1144
Darwin,2014,2,857,151,1008
Darwin,2014,3,989,166,1155
Darwin,2014,4,1047,134,1181
Darwin,2014,5,1093,134,1227
Darwin,2014,6,1030,134,1164
Darwin,2014,7,1063,148,1211
Darwin,2014,8,1041,146,1187
Darwin,2014,9,1022,139,1161
Darwin,2014,10,1083,134,1217
Darwin,2014,11,982,111,1093
Darwin,2014,12,989,128,1117
Darwin,2015,1,950,131,1081
Darwin,2015,2,879,104,983
Darwin,2015,3,988,112,1100
Darwin,2015,4,1056,106,1162
Darwin,2015,5,1031,107,1138
Darwin,2015,6,1064,121,1185
Darwin,2015,7,1119,127,1246
Darwin,2015,8,1072,120,1192
Darwin,2015,9,1063,111,1174
Darwin,2015,10,1078,111,1189
Darwin,2015,11,1006,104,1110
Darwin,2015,12,1032,126,1158
Darwin,2016,1,973,131,1104
Darwin,2016,2,941,106,1047
Darwin,2016,3,1027,114,1141
Darwin,2016,4,1029,125,1154
Darwin,2016,5,1015,127,1142
Darwin,2016,6,1082,124,1206
Darwin,2016,7,1126,140,1266
Darwin,2016,8,1131,123,1254
Darwin,2016,9,1082,121,1203
Darwin,2016,10,1093,124,1217
Darwin,2016,11,1038,113,1151
Darwin,2016,12,1030,143,1173
Darwin,2017,1,976,144,1120
Darwin,2017,2,901,120,1021
Darwin,2017,3,1014,124,1138
Darwin,2017,4,973,124,1097
Darwin,2017,5,1033,116,1149
Darwin,2017,6,1069,130,1199
Darwin,2017,7,1104,124,1228
Darwin,2017,8,1151,111,1262
Darwin,2017,9,1029,101,1130
Darwin,2017,10,1058,105,1163
Darwin,2017,11,1017,105,1122
Darwin,2017,12,941,127,1068
Darwin,2018,1,929,130,1059
Darwin,2018,2,846,91,937
Darwin,2018,3,932,88,1020
Darwin,2018,4,987,64,1051
Darwin,2018,5,1022,53,1075
Darwin,2018,6,1040,78,1118
Darwin,2018,7,1126,72,1198
Darwin,2018,8,1091,81,1172
Darwin,2018,9,1012,73,1085
Darwin,2018,10,1021,70,1091
Darwin,2018,11,953,70,1023
Darwin,2018,12,922,87,1009
Darwin,2019,1,898,89,987
Darwin,2019,2,827,69,896
Darwin,2019,3,934,69,1003
Darwin,2019,4,960,86,1046
Darwin,2019,5,1011,96,1107
Darwin,2019,6,992,94,1086
Darwin,2019,7,1042,103,1145
Darwin,2019,8,1024,94,1118
Darwin,2019,9,983,91,1074
Darwin,2019,10,1042,87,1129
Darwin,2019,11,916,81,997
Darwin,2019,12,904,95,999
Darwin,2020,1,889,103,992
Darwin,2020,2,831,73,904
Darwin,2020,3,768,50,818
Darwin,2020,4,230,0,230
Darwin,2020,5,215,0,215
Darwin,2020,6,367,1,368
Darwin,2020,7,518,0,518
Darwin,2020,8,587,22,609
Darwin,2020,9,608,28,636
Darwin,2020,10,681,26,707
Darwin,2020,11,690,31,721
Darwin,2020,12,696,22,718
Darwin,2021,1,700,25,725
Darwin,2021,2,656,19,675
Darwin,2021,3,793,29,822
Darwin,2021,4,863,30,893
Darwin,2021,5,936,31,967
Darwin,2021,6,929,59,988
Darwin,2021,7,904,27,931
Darwin,2021,8,869,75,944
Darwin,2021,9,934,73,1007
Darwin,2021,10,910,68,978
Darwin,2021,11,770,88,858
Darwin,2021,12,725,152,877
Darwin,2022,1,633,181,814
Darwin,2022,2,543,158,701
Darwin,2022,3,764,197,961
Darwin,2022,4,876,214,1090
Darwin,2022,5,927,225,1152
Darwin,2022,6,976,140,1116
Darwin,2022,7,1003,109,1112
Darwin,2022,8,971,100,1071
Darwin,2022,9,949,59,1008
Darwin,2022,10,926,48,974
Darwin,2022,11,903,74,977
Darwin,2022,12,856,70,926
Darwin,2023,1,841,82,923
Darwin,2023,2,779,62,841
Darwin,2023,3,905,67,972
Darwin,2023,4,918,65,983
Darwin,2023,5,1022,66,1088
Darwin,2023,6,1019,64,1083
Darwin,2023,7,1103,75,1178
Darwin,2023,8,1104,76,1180
Darwin,2023,9,1087,73,1160
Darwin,2023,10,1065,60,1125
Darwin,2023,11,876,73,949
Darwin,2023,12,865,75,940
Darwin,2024,1,913,75,988
Darwin,2024,2,866,71,937
Darwin,2024,3,917,75,992
Darwin,2024,4,984,80,1064
Darwin,2024,5,1005,82,1087
Darwin,2024,6,1004,82,1086
Darwin,2024,7,1099,82,1181
Darwin,2024,8,1057,79,1136
Darwin,2024,9,1024,80,1104
Darwin,2024,10,1023,82,1105
Darwin,2024,11,922,73,995
Darwin,2024,12,926,82,1008
Gold Coast,1985,1,718,0,718
Gold Coast,1985,2,545,0,545
Gold Coast,1985,3,621,0,621
Gold Coast,1985,4,609,0,609
Gold Coast,1985,5,669,0,669
Gold Coast,1985,6,449,0,449
Gold Coast,1985,7,447,0,447
Gold Coast,1985,8,577,0,577
Gold Coast,1985,9,578,0,578
Gold Coast,1985,10,549,0,549
Gold Coast,1985,11,508,0,508
Gold Coast,1985,12,563,0,563
Gold Coast,1986,1,609,0,609
Gold Coast,1986,2,471,0,471
Gold Coast,1986,3,539,0,539
Gold Coast,1986,4,519,0,519
Gold Coast,1986,5,587,0,587
Gold Coast,1986,6,522,0,522
Gold Coast,1986,7,532,0,532
Gold Coast,1986,8,649,0,649
Gold Coast,1986,9,645,0,645
Gold Coast,1986,10,745,0,745
Gold Coast,1986,11,708,0,708
Gold Coast,1986,12,768,0,768
Gold Coast,1987,1,842,0,842
Gold Coast,1987,2,630,0,630
Gold Coast,1987,3,697,0,697
Gold Coast,1987,4,742,0,742
Gold Coast,1987,5,657,0,657
Gold Coast,1987,6,745,0,745
Gold Coast,1987,7,848,0,848
Gold Coast,1987,8,814,0,814
Gold Coast,1987,9,847,0,847
Gold Coast,1987,10,880,0,880
Gold Coast,1987,11,758,0,758
Gold Coast,1987,12,882,0,882
Gold Coast,1988,1,890,0,890
Gold Coast,1988,2,718,0,718
Gold Coast,1988,3,759,0,759
Gold Coast,1988,4,821,0,821
Gold Coast,1988,5,793,0,793
Gold Coast,1988,6,818,0,818
Gold Coast,1988,7,961,0,961
Gold Coast,1988,8,925,0,925
Gold Coast,1988,9,974,0,974
Gold Coast,1988,10,1032,0,1032
Gold Coast,1988,11,875,0,875
Gold Coast,1988,12,969,0,969
Gold Coast,1989,1,1002,0,1002
Gold Coast,1989,2,783,0,783
Gold Coast,1989,3,948,0,948
Gold Coast,1989,4,878,0,878
Gold Coast,1989,5,843,0,843
Gold Coast,1989,6,924,0,924
Gold Coast,1989,7,956,0,956
Gold Coast,1989,8,606,0,606
Gold Coast,1989,9,377,0,377
Gold Coast,1989,10,466,0,466
Gold Coast,1989,11,472,0,472
Gold Coast,1989,12,630,0,630
Gold Coast,1990,1,781,0,781
Gold Coast,1990,2,654,0,654
Gold Coast,1990,3,773,0,773
Gold Coast,1990,4,892,0,892
Gold Coast,1990,5,822,0,822
Gold Coast,1990,6,847,0,847
Gold Coast,1990,7,786,0,786
Gold Coast,1990,8,720,0,720
Gold Coast,1990,9,884,0,884
Gold Coast,1990,10,897,0,897
Gold Coast,1990,11,804,0,804
Gold Coast,1990,12,901,0,901
Gold Coast,1991,1,1140,0,1140
Gold Coast,1991,2,910,0,910
Gold Coast,1991,3,1095,0,1095
Gold Coast,1991,4,1074,0,1074
Gold Coast,1991,5,1036,0,1036
Gold Coast,1991,6,1063,0,1063
Gold Coast,1991,7,1154,0,1154
Gold Coast,1991,8,1150,0,1150
Gold Coast,1991,9,1207,0,1207
Gold Coast,1991,10,1186,0,1186
Gold Coast,1991,11,1167,0,1167
Gold Coast,1991,12,1156,0,1156
Gold Coast,1992,1,1231,0,1231
Gold Coast,1992,2,896,0,896
Gold Coast,1992,3,915,0,915
Gold Coast,1992,4,982,0,982
Gold Coast,1992,5,1067,0,1067
Gold Coast,1992,6,1058,0,1058
Gold Coast,1992,7,1120,0,1120
Gold Coast,1992,8,1084,0,1084
Gold Coast,1992,9,1048,0,1048
Gold Coast,1992,10,1108,0,1108
Gold Coast,1992,11,1062,0,1062
Gold Coast,1992,12,1189,0,1189
Gold Coast,1993,1,1306,0,1306
Gold Coast,1993,2,983,0,983
Gold Coast,1993,3,1068,0,1068
Gold Coast,1993,4,1100,0,1100
Gold Coast,1993,5,1083,0,1083
Gold Coast,1993,6,1034,0,1034
Gold Coast,1993,7,1073,0,1073
Gold Coast,1993,8,1092,0,1092
Gold Coast,1993,9,1116,0,1116
Gold Coast,1993,10,1214,0,1214
Gold Coast,1993,11,1206,0,1206
Gold Coast,1993,12,1365,0,1365
Gold Coast,1994,1,1235,0,1235
Gold Coast,1994,2,992,0,992
Gold Coast,1994,3,1093,0,1093
Gold Coast,1994,4,1086,0,1086
Gold Coast,1994,5,1065,0,1065
Gold Coast,1994,6,1083,0,1083
Gold Coast,1994,7,1179,0,1179
Gold Coast,1994,8,1110,0,1110
Gold Coast,1994,9,1107,0,1107
Gold Coast,1994,10,1139,0,1139
Gold Coast,1994,11,1085,0,1085
Gold Coast,1994,12,1221,0,1221
Gold Coast,1995,1,1263,0,1263
Gold Coast,1995,2,1000,0,1000
Gold Coast,1995,3,1111,0,1111
Gold Coast,1995,4,1098,0,1098
Gold Coast,1995,5,1042,0,1042
Gold Coast,1995,6,1062,0,1062
Gold Coast,1995,7,1148,0,1148
Gold Coast,1995,8,1070,0,1070
Gold Coast,1995,9,1102,0,1102
Gold Coast,1995,10,1116,0,1116
Gold Coast,1995,11,1041,0,1041
Gold Coast,1995,12,1151,0,1151
Gold Coast,1996,1,1233,0,1233
Gold Coast,1996,2,1002,0,1002
Gold Coast,1996,3,1100,0,1100
Gold Coast,1996,4,1121,0,1121
Gold Coast,1996,5,1035,0,1035
Gold Coast,1996,6,1106,0,1106
Gold Coast,1996,7,1160,0,1160
Gold Coast,1996,8,1082,0,1082
Gold Coast,1996,9,1091,0,1091
Gold Coast,1996,10,1126,0,1126
Gold Coast,1996,11,1012,0,1012
Gold Coast,1996,12,1105,3,1108
Gold Coast,1997,1,1093,4,1097
Gold Coast,1997,2,866,0,866
Gold Coast,1997,3,930,2,932
Gold Coast,1997,4,899,4,903
Gold Coast,1997,5,852,5,857
Gold Coast,1997,6,860,5,865
Gold Coast,1997,7,949,8,957
Gold Coast,1997,8,923,9,932
Gold Coast,1997,9,953,9,962
Gold Coast,1997,10,976,8,984
Gold Coast,1997,11,894,9,903
Gold Coast,1997,12,994,9,1003
Gold Coast,1998,1,1057,9,1066
Gold Coast,1998,2,842,6,848
Gold Coast,1998,3,926,8,934
Gold Coast,1998,4,903,8,911
Gold Coast,1998,5,886,5,891
Gold Coast,1998,6,889,4,893
Gold Coast,1998,7,926,6,932
Gold Coast,1998,8,900,10,910
Gold Coast,1998,9,882,9,891
Gold Coast,1998,10,956,8,964
Gold Coast,1998,11,913,4,917
Gold Coast,1998,12,990,4,994
Gold Coast,1999,1,1091,5,1096
Gold Coast,1999,2,841,4,845
Gold Coast,1999,3,936,5,941
Gold Coast,1999,4,911,8,919
Gold Coast,1999,5,861,5,866
Gold Coast,1999,6,849,6,855
Gold Coast,1999,7,912,9,921
Gold Coast,1999,8,878,8,886
Gold Coast,1999,9,892,9,901
Gold Coast,1999,10,954,9,963
Gold Coast,1999,11,833,4,837
Gold Coast,1999,12,906,6,912
Gold Coast,2000,1,963,8,971
Gold Coast,2000,2,795,9,804
Gold Coast,2000,3,849,9,858
Gold Coast,2000,4,874,13,887
Gold Coast,2000,5,828,12,840
Gold Coast,2000,6,863,14,877
Gold Coast,2000,7,857,13,870
Gold Coast,2000,8,846,14,860
Gold Coast,2000,9,843,18,861
Gold Coast,2000,10,874,16,890
Gold Coast,2000,11,814,8,822
Gold Coast,2000,12,888,13,901
Gold Coast,2001,1,924,16,940
Gold Coast,2001,2,726,12,738
Gold Coast,2001,3,825,16,841
Gold Coast,2001,4,797,17,814
Gold Coast,2001,5,775,18,793
Gold Coast,2001,6,864,17,881
Gold Coast,2001,7,888,17,905
Gold Coast,2001,8,825,18,843
Gold Coast,2001,9,692,18,710
Gold Coast,2001,10,629,17,646
Gold Coast,2001,11,481,24,505
Gold Coast,2001,12,531,33,564
Gold Coast,2002,1,580,36,616
Gold Coast,2002,2,512,28,540
Gold Coast,2002,3,586,36,622
Gold Coast,2002,4,601,35,636
Gold Coast,2002,5,620,39,659
Gold Coast,2002,6,788,37,825
Gold Coast,2002,7,928,40,968
Gold Coast,2002,8,908,39,947
Gold Coast,2002,9,905,43,948
Gold Coast,2002,10,915,56,971
Gold Coast,2002,11,787,96,883
Gold Coast,2002,12,888,87,975
Gold Coast,2003,1,833,83,916
Gold Coast,2003,2,691,70,761
Gold Coast,2003,3,740,75,815
Gold Coast,2003,4,761,86,847
Gold Coast,2003,5,727,88,815
Gold Coast,2003,6,675,91,766
Gold Coast,2003,7,684,92,776
Gold Coast,2003,8,628,81,709
Gold Coast,2003,9,671,77,748
Gold Coast,2003,10,758,78,836
Gold Coast,2003,11,764,73,837
Gold Coast,2003,12,817,73,890
Gold Coast,2004,1,848,71,919
Gold Coast,2004,2,727,74,801
Gold Coast,2004,3,793,83,876
Gold Coast,2004,4,844,77,921
Gold Coast,2004,5,914,83,997
Gold Coast,2004,6,1013,81,1094
Gold Coast,2004,7,1079,80,1159
Gold Coast,2004,8,1058,85,1143
Gold Coast,2004,9,1032,79,1111
Gold Coast,2004,10,1065,83,1148
Gold Coast,2004,11,1009,77,1086
Gold Coast,2004,12,1131,85,1216
Gold Coast,2005,1,1172,92,1264
Gold Coast,2005,2,988,96,1084
Gold Coast,2005,3,1083,109,1192
Gold Coast,2005,4,1075,105,1180
Gold Coast,2005,5,1067,116,1183
Gold Coast,2005,6,983,110,1093
Gold Coast,2005,7,1054,120,1174
Gold Coast,2005,8,1036,119,1155
Gold Coast,2005,9,1045,117,1162
Gold Coast,2005,10,1065,119,1184
Gold Coast,2005,11,1000,84,1084
Gold Coast,2005,12,1114,110,1224
Gold Coast,2006,1,1112,113,1225
Gold Coast,2006,2,928,98,1026
Gold Coast,2006,3,1033,107,1140
Gold Coast,2006,4,1034,93,1127
Gold Coast,2006,5,1036,83,1119
Gold Coast,2006,6,1028,81,1109
Gold Coast,2006,7,1058,89,1147
Gold Coast,2006,8,1028,86,1114
Gold Coast,2006,9,1043,85,1128
Gold Coast,2006,10,1096,67,1163
Gold Coast,2006,11,1043,71,1114
Gold Coast,2006,12,1103,76,1179
Gold Coast,2007,1,1113,76,1189
Gold Coast,2007,2,979,55,1034
Gold Coast,2007,3,1092,66,1158
Gold Coast,2007,4,1064,65,1129
Gold Coast,2007,5,1096,67,1163
Gold Coast,2007,6,1032,67,1099
Gold Coast,2007,7,1057,72,1129
Gold Coast,2007,8,1102,72,1174
Gold Coast,2007,9,1143,74,1217
Gold Coast,2007,10,1180,64,1244
Gold Coast,2007,11,1162,72,1234
Gold Coast,2007,12,1257,91,1348
Gold Coast,2008,1,1335,94,1429
Gold Coast,2008,2,1248,75,1323
Gold Coast,2008,3,1377,82,1459
Gold Coast,2008,4,1274,86,1360
Gold Coast,2008,5,1372,86,1458
Gold Coast,2008,6,1321,86,1407
Gold Coast,2008,7,1375,109,1484
Gold Coast,2008,8,1234,101,1335
Gold Coast,2008,9,1145,101,1246
Gold Coast,2008,10,1152,149,1301
Gold Coast,2008,11,1152,150,1302
Gold Coast,2008,12,1183,169,1352
Gold Coast,2009,1,1265,185,1450
Gold Coast,2009,2,1016,137,1153
Gold Coast,2009,3,1167,159,1326
Gold Coast,2009,4,1236,160,1396
Gold Coast,2009,5,1197,186,1383
Gold Coast,2009,6,1165,137,1302
Gold Coast,2009,7,1275,150,1425
Gold Coast,2009,8,1217,185,1402
Gold Coast,2009,9,1222,187,1409
Gold Coast,2009,10,1268,194,1462
Gold Coast,2009,11,1203,191,1394
Gold Coast,2009,12,1237,201,1438
Gold Coast,2010,1,1362,208,1570
Gold Coast,2010,2,1225,187,1412
Gold Coast,2010,3,1389,213,1602
Gold Coast,2010,4,1371,176,1547
Gold Coast,2010,5,1325,167,1492
Gold Coast,2010,6,1319,159,1478
Gold Coast,2010,7,1491,191,1682
Gold Coast,2010,8,1338,197,1535
Gold Coast,2010,9,1399,180,1579
Gold Coast,2010,10,1415,182,1597
Gold Coast,2010,11,1401,180,1581
Gold Coast,2010,12,1549,197,1746
Gold Coast,2011,1,1714,204,1918
Gold Coast,2011,2,1192,174,1366
Gold Coast,2011,3,1366,178,1544
Gold Coast,2011,4,1326,159,1485
Gold Coast,2011,5,1320,161,1481
Gold Coast,2011,6,1208,126,1334
Gold Coast,2011,7,1319,157,1476
Gold Coast,2011,8,1235,178,1413
Gold Coast,2011,9,1268,157,1425
Gold Coast,2011,10,1328,173,1501
Gold Coast,2011,11,1290,166,1456
Gold Coast,2011,12,1407,188,1595
Gold Coast,2012,1,1473,197,1670
Gold Coast,2012,2,1261,168,1429
Gold Coast,2012,3,1366,178,1544
Gold Coast,2012,4,1369,169,1538
Gold Coast,2012,5,1239,144,1383
Gold Coast,2012,6,1229,170,1399
Gold Coast,2012,7,1460,206,1666
Gold Coast,2012,8,1402,202,1604
Gold Coast,2012,9,1502,192,1694
Gold Coast,2012,10,1555,201,1756
Gold Coast,2012,11,1459,186,1645
Gold Coast,2012,12,1589,217,1806
Gold Coast,2013,1,1583,213,1796
Gold Coast,2013,2,1243,181,1424
Gold Coast,2013,3,1407,203,1610
Gold Coast,2013,4,1506,183,1689
Gold Coast,2013,5,1208,161,1369
Gold Coast,2013,6,1286,160,1446
Gold Coast,2013,7,1471,193,1664
Gold Coast,2013,8,1386,187,1573
Gold Coast,2013,9,1512,191,1703
Gold Coast,2013,10,1551,204,1755
Gold Coast,2013,11,1347,191,1538
Gold Coast,2013,12,1539,228,1767
Gold Coast,2014,1,1603,231,1834
Gold Coast,2014,2,1215,186,1401
Gold Coast,2014,3,1423,203,1626
Gold Coast,2014,4,1459,187,1646
Gold Coast,2014,5,1274,176,1450
Gold Coast,2014,6,1275,179,1454
Gold Coast,2014,7,1490,202,1692
Gold Coast,2014,8,1400,187,1587
Gold Coast,2014,9,1464,183,1647
Gold Coast,2014,10,1539,192,1731
Gold Coast,2014,11,1358,180,1538
Gold Coast,2014,12,1552,219,1771
Gold Coast,2015,1,1578,227,1805
Gold Coast,2015,2,1183,176,1359
Gold Coast,2015,3,1376,195,1571
Gold Coast,2015,4,1450,210,1660
Gold Coast,2015,5,1296,201,1497
Gold Coast,2015,6,1333,200,1533
Gold Coast,2015,7,1512,248,1760
Gold Coast,2015,8,1430,214,1644
Gold Coast,2015,9,1540,218,1758
Gold Coast,2015,10,1560,230,1790
Gold Coast,2015,11,1441,205,1646
Gold Coast,2015,12,1636,247,1883
Gold Coast,2016,1,1707,258,1965
Gold Coast,2016,2,1331,214,1545
Gold Coast,2016,3,1479,239,1718
Gold Coast,2016,4,1512,265,1777
Gold Coast,2016,5,1338,259,1597
Gold Coast,2016,6,1331,259,1590
Gold Coast,2016,7,1578,311,1889
Gold Coast,2016,8,1450,299,1749
Gold Coast,2016,9,1557,291,1848
Gold Coast,2016,10,1599,292,1891
Gold Coast,2016,11,1442,265,1707
Gold Coast,2016,12,1655,299,1954
Gold Coast,2017,1,1688,303,1991
Gold Coast,2017,2,1294,254,1548
Gold Coast,2017,3,1417,281,1698
Gold Coast,2017,4,1560,272,1832
Gold Coast,2017,5,1308,261,1569
Gold Coast,2017,6,1346,254,1600
Gold Coast,2017,7,1571,299,1870
Gold Coast,2017,8,1420,283,1703
Gold Coast,2017,9,1506,276,1782
Gold Coast,2017,10,1580,288,1868
Gold Coast,2017,11,1455,260,1715
Gold Coast,2017,12,1651,298,1949
Gold Coast,2018,1,1743,298,2041
Gold Coast,2018,2,1291,240,1531
Gold Coast,2018,3,1499,261,1760
Gold Coast,2018,4,1633,272,1905
Gold Coast,2018,5,1306,236,1542
Gold Coast,2018,6,1299,247,1546
Gold Coast,2018,7,1491,278,1769
Gold Coast,2018,8,1411,261,1672
Gold Coast,2018,9,1465,245,1710
Gold Coast,2018,10,1542,262,1804
Gold Coast,2018,11,1378,229,1607
Gold Coast,2018,12,1567,262,1829
Gold Coast,2019,1,1679,264,1943
Gold Coast,2019,2,1226,199,1425
Gold Coast,2019,3,1361,209,1570
Gold Coast,2019,4,1588,209,1797
Gold Coast,2019,5,1415,178,1593
Gold Coast,2019,6,1378,194,1572
Gold Coast,2019,7,1593,231,1824
Gold Coast,2019,8,1427,201,1628
Gold Coast,2019,9,1493,192,1685
Gold Coast,2019,10,1584,204,1788
Gold Coast,2019,11,1395,190,1585
Gold Coast,2019,12,1580,255,1835
Gold Coast,2020,1,1634,258,1892
Gold Coast,2020,2,1250,207,1457
Gold Coast,2020,3,1044,141,1185
Gold Coast,2020,4,22,0,22
Gold Coast,2020,5,13,0,13
Gold Coast,2020,6,22,0,22
Gold Coast,2020,7,157,0,157
Gold Coast,2020,8,65,0,65
Gold Coast,2020,9,100,1,101
Gold Coast,2020,10,155,0,155
Gold Coast,2020,11,169,0,169
Gold Coast,2020,12,726,0,726
Gold Coast,2021,1,748,0,748
Gold Coast,2021,2,639,0,639
Gold Coast,2021,3,987,0,987
Gold Coast,2021,4,1517,27,1544
Gold Coast,2021,5,1400,79,1479
Gold Coast,2021,6,1053,64,1117
Gold Coast,2021,7,571,55,626
Gold Coast,2021,8,171,0,171
Gold Coast,2021,9,184,0,184
Gold Coast,2021,10,193,0,193
Gold Coast,2021,11,201,0,201
Gold Coast,2021,12,1034,0,1034
Gold Coast,2022,1,1539,0,1539
Gold Coast,2022,2,1037,6,1043
Gold Coast,2022,3,1420,26,1446
Gold Coast,2022,4,1862,46,1908
Gold Coast,2022,5,1674,51,1725
Gold Coast,2022,6,1567,85,1652
Gold Coast,2022,7,1558,136,1694
Gold Coast,2022,8,1428,145,1573
Gold Coast,2022,9,1425,145,1570
Gold Coast,2022,10,1499,148,1647
Gold Coast,2022,11,1471,155,1626
Gold Coast,2022,12,1577,147,1724
Gold Coast,2023,1,1670,160,1830
Gold Coast,2023,2,1275,145,1420
Gold Coast,2023,3,1379,163,1542
Gold Coast,2023,4,1466,210,1676
Gold Coast,2023,5,1351,197,1548
Gold Coast,2023,6,1348,206,1554
Gold Coast,2023,7,1516,222,1738
Gold Coast,2023,8,1424,194,1618
Gold Coast,2023,9,1492,209,1701
Gold Coast,2023,10,1503,189,1692
Gold Coast,2023,11,1426,149,1575
Gold Coast,2023,12,1626,175,1801
Gold Coast,2024,1,1792,184,1976
Gold Coast,2024,2,1348,138,1486
Gold Coast,2024,3,1558,150,1708
Gold Coast,2024,4,1630,183,1813
Gold Coast,2024,5,1336,147,1483
Gold Coast,2024,6,1337,157,1494
Gold Coast,2024,7,1531,179,1710
Gold Coast,2024,8,1273,152,1425
Gold Coast,2024,9,1376,171,1547
Gold Coast,2024,10,1460,160,1620
Gold Coast,2024,11,1305,124,1429
Gold Coast,2024,12,1615,184,1799
HAMILTON ISLAND,1985,1,53,0,53
HAMILTON ISLAND,1985,2,50,0,50
HAMILTON ISLAND,1985,3,58,0,58
HAMILTON ISLAND,1985,4,61,0,61
HAMILTON ISLAND,1985,5,68,0,68
HAMILTON ISLAND,1985,6,53,0,53
HAMILTON ISLAND,1985,7,58,0,58
HAMILTON ISLAND,1985,8,68,0,68
HAMILTON ISLAND,1985,9,65,0,65
HAMILTON ISLAND,1985,10,60,0,60
HAMILTON ISLAND,1985,11,63,0,63
HAMILTON ISLAND,1985,12,55,0,55
HAMILTON ISLAND,1986,1,63,0,63
HAMILTON ISLAND,1986,2,57,0,57
HAMILTON ISLAND,1986,3,72,0,72
HAMILTON ISLAND,1986,4,69,0,69
HAMILTON ISLAND,1986,5,64,0,64
HAMILTON ISLAND,1986,6,55,0,55
HAMILTON ISLAND,1986,7,72,0,72
HAMILTON ISLAND,1986,8,112,0,112
HAMILTON ISLAND,1986,9,103,0,103
HAMILTON ISLAND,1986,10,114,0,114
HAMILTON ISLAND,1986,11,114,0,114
HAMILTON ISLAND,1986,12,119,0,119
HAMILTON ISLAND,1987,1,129,0,129
HAMILTON ISLAND,1987,2,102,0,102
HAMILTON ISLAND,1987,3,102,0,102
HAMILTON ISLAND,1987,4,113,0,113
HAMILTON ISLAND,1987,5,112,0,112
HAMILTON ISLAND,1987,6,106,0,106
HAMILTON ISLAND,1987,7,122,0,122
HAMILTON ISLAND,1987,8,125,0,125
HAMILTON ISLAND,1987,9,126,0,126
HAMILTON ISLAND,1987,10,145,0,145
HAMILTON ISLAND,1987,11,135,0,135
HAMILTON ISLAND,1987,12,126,0,126
HAMILTON ISLAND,1988,1,132,0,132
HAMILTON ISLAND,1988,2,113,0,113
HAMILTON ISLAND,1988,3,135,0,135
HAMILTON ISLAND,1988,4,132,0,132
HAMILTON ISLAND,1988,5,121,0,121
HAMILTON ISLAND,1988,6,125,0,125
HAMILTON ISLAND,1988,7,141,0,141
HAMILTON ISLAND,1988,8,133,0,133
HAMILTON ISLAND,1988,9,142,0,142
HAMILTON ISLAND,1988,10,164,0,164
HAMILTON ISLAND,1988,11,154,0,154
HAMILTON ISLAND,1988,12,146,0,146
HAMILTON ISLAND,1989,1,148,0,148
HAMILTON ISLAND,1989,2,122,0,122
HAMILTON ISLAND,1989,3,140,0,140
HAMILTON ISLAND,1989,4,141,0,141
HAMILTON ISLAND,1989,5,122,0,122
HAMILTON ISLAND,1989,6,119,0,119
HAMILTON ISLAND,1989,7,128,0,128
HAMILTON ISLAND,1989,8,71,0,71
HAMILTON ISLAND,1989,9,34,0,34
HAMILTON ISLAND,1989,10,51,0,51
HAMILTON ISLAND,1989,11,43,0,43
HAMILTON ISLAND,1989,12,49,0,49
HAMILTON ISLAND,1990,1,96,0,96
HAMILTON ISLAND,1990,2,71,0,71
HAMILTON ISLAND,1990,3,89,0,89
HAMILTON ISLAND,1990,4,100,0,100
HAMILTON ISLAND,1990,5,117,0,117
HAMILTON ISLAND,1990,6,111,0,111
HAMILTON ISLAND,1990,7,127,0,127
HAMILTON ISLAND,1990,8,118,0,118
HAMILTON ISLAND,1990,9,127,0,127
HAMILTON ISLAND,1990,10,116,0,116
HAMILTON ISLAND,1990,11,154,0,154
HAMILTON ISLAND,1990,12,139,0,139
HAMILTON ISLAND,1991,1,137,0,137
HAMILTON ISLAND,1991,2,108,0,108
HAMILTON ISLAND,1991,3,118,0,118
HAMILTON ISLAND,1991,4,118,0,118
HAMILTON ISLAND,1991,5,114,0,114
HAMILTON ISLAND,1991,6,129,0,129
HAMILTON ISLAND,1991,7,154,0,154
HAMILTON ISLAND,1991,8,125,0,125
HAMILTON ISLAND,1991,9,145,0,145
HAMILTON ISLAND,1991,10,161,0,161
HAMILTON ISLAND,1991,11,148,0,148
HAMILTON ISLAND,1991,12,155,0,155
HAMILTON ISLAND,1992,1,147,0,147
HAMILTON ISLAND,1992,2,110,0,110
HAMILTON ISLAND,1992,3,123,0,123
HAMILTON ISLAND,1992,4,115,0,115
HAMILTON ISLAND,1992,5,106,0,106
HAMILTON ISLAND,1992,6,104,0,104
HAMILTON ISLAND,1992,7,101,0,101
HAMILTON ISLAND,1992,8,106,0,106
HAMILTON ISLAND,1992,9,111,0,111
HAMILTON ISLAND,1992,10,130,0,130
HAMILTON ISLAND,1992,11,156,0,156
HAMILTON ISLAND,1992,12,159,0,159
HAMILTON ISLAND,1993,1,152,0,152
HAMILTON ISLAND,1993,2,124,0,124
HAMILTON ISLAND,1993,3,142,0,142
HAMILTON ISLAND,1993,4,150,0,150
HAMILTON ISLAND,1993,5,126,0,126
HAMILTON ISLAND,1993,6,118,0,118
HAMILTON ISLAND,1993,7,142,0,142
HAMILTON ISLAND,1993,8,155,0,155
HAMILTON ISLAND,1993,9,146,0,146
HAMILTON ISLAND,1993,10,186,0,186
HAMILTON ISLAND,1993,11,169,0,169
HAMILTON ISLAND,1993,12,178,0,178
HAMILTON ISLAND,1994,1,176,0,176
HAMILTON ISLAND,1994,2,151,0,151
HAMILTON ISLAND,1994,3,176,0,176
HAMILTON ISLAND,1994,4,171,0,171
HAMILTON ISLAND,1994,5,166,0,166
HAMILTON ISLAND,1994,6,157,0,157
HAMILTON ISLAND,1994,7,172,0,172
HAMILTON ISLAND,1994,8,171,0,171
HAMILTON ISLAND,1994,9,179,0,179
HAMILTON ISLAND,1994,10,210,0,210
HAMILTON ISLAND,1994,11,197,0,197
HAMILTON ISLAND,1994,12,212,0,212
HAMILTON ISLAND,1995,1,195,0,195
HAMILTON ISLAND,1995,2,153,0,153
HAMILTON ISLAND,1995,3,173,0,173
HAMILTON ISLAND,1995,4,184,0,184
HAMILTON ISLAND,1995,5,168,0,168
HAMILTON ISLAND,1995,6,152,0,152
HAMILTON ISLAND,1995,7,174,0,174
HAMILTON ISLAND,1995,8,177,0,177
HAMILTON ISLAND,1995,9,178,0,178
HAMILTON ISLAND,1995,10,212,0,212
HAMILTON ISLAND,1995,11,205,0,205
HAMILTON ISLAND,1995,12,207,0,207
HAMILTON ISLAND,1996,1,195,0,195
HAMILTON ISLAND,1996,2,158,0,158
HAMILTON ISLAND,1996,3,162,0,162
HAMILTON ISLAND,1996,4,173,0,173
HAMILTON ISLAND,1996,5,151,0,151
HAMILTON ISLAND,1996,6,150,0,150
HAMILTON ISLAND,1996,7,161,0,161
HAMILTON ISLAND,1996,8,150,0,150
HAMILTON ISLAND,1996,9,163,0,163
HAMILTON ISLAND,1996,10,187,0,187
HAMILTON ISLAND,1996,11,172,0,172
HAMILTON ISLAND,1996,12,183,0,183
HAMILTON ISLAND,1997,1,179,0,179
HAMILTON ISLAND,1997,2,142,0,142
HAMILTON ISLAND,1997,3,161,0,161
HAMILTON ISLAND,1997,4,155,0,155
HAMILTON ISLAND,1997,5,139,0,139
HAMILTON ISLAND,1997,6,144,0,144
HAMILTON ISLAND,1997,7,148,0,148
HAMILTON ISLAND,1997,8,150,0,150
HAMILTON ISLAND,1997,9,159,0,159
HAMILTON ISLAND,1997,10,174,0,174
HAMILTON ISLAND,1997,11,165,0,165
HAMILTON ISLAND,1997,12,172,0,172
HAMILTON ISLAND,1998,1,187,0,187
HAMILTON ISLAND,1998,2,128,0,128
HAMILTON ISLAND,1998,3,157,0,157
HAMILTON ISLAND,1998,4,167,0,167
HAMILTON ISLAND,1998,5,166,0,166
HAMILTON ISLAND,1998,6,138,0,138
HAMILTON ISLAND,1998,7,145,0,145
HAMILTON ISLAND,1998,8,144,0,144
HAMILTON ISLAND,1998,9,150,0,150
HAMILTON ISLAND,1998,10,161,0,161
HAMILTON ISLAND,1998,11,166,0,166
HAMILTON ISLAND,1998,12,173,0,173
HAMILTON ISLAND,1999,1,182,0,182
HAMILTON ISLAND,1999,2,144,0,144
HAMILTON ISLAND,1999,3,151,0,151
HAMILTON ISLAND,1999,4,148,0,148
HAMILTON ISLAND,1999,5,141,0,141
HAMILTON ISLAND,1999,6,136,0,136
HAMILTON ISLAND,1999,7,157,0,157
HAMILTON ISLAND,1999,8,159,0,159
HAMILTON ISLAND,1999,9,153,0,153
HAMILTON ISLAND,1999,10,167,0,167
HAMILTON ISLAND,1999,11,169,0,169
HAMILTON ISLAND,1999,12,178,0,178
HAMILTON ISLAND,2000,1,194,0,194
HAMILTON ISLAND,2000,2,177,0,177
HAMILTON ISLAND,2000,3,192,0,192
HAMILTON ISLAND,2000,4,207,0,207
HAMILTON ISLAND,2000,5,190,0,190
HAMILTON ISLAND,2000,6,197,0,197
HAMILTON ISLAND,2000,7,187,0,187
HAMILTON ISLAND,2000,8,195,0,195
HAMILTON ISLAND,2000,9,201,0,201
HAMILTON ISLAND,2000,10,210,0,210
HAMILTON ISLAND,2000,11,214,0,214
HAMILTON ISLAND,2000,12,228,0,228
HAMILTON ISLAND,2001,1,229,0,229
HAMILTON ISLAND,2001,2,191,0,191
HAMILTON ISLAND,2001,3,214,0,214
HAMILTON ISLAND,2001,4,204,0,204
HAMILTON ISLAND,2001,5,205,0,205
HAMILTON ISLAND,2001,6,203,0,203
HAMILTON ISLAND,2001,7,212,0,212
HAMILTON ISLAND,2001,8,210,0,210
HAMILTON ISLAND,2001,9,181,0,181
HAMILTON ISLAND,2001,10,159,0,159
HAMILTON ISLAND,2001,11,150,0,150
HAMILTON ISLAND,2001,12,162,0,162
HAMILTON ISLAND,2002,1,156,0,156
HAMILTON ISLAND,2002,2,133,0,133
HAMILTON ISLAND,2002,3,156,0,156
HAMILTON ISLAND,2002,4,150,0,150
HAMILTON ISLAND,2002,5,149,0,149
HAMILTON ISLAND,2002,6,129,0,129
HAMILTON ISLAND,2002,7,176,0,176
HAMILTON ISLAND,2002,8,181,0,181
HAMILTON ISLAND,2002,9,176,0,176
HAMILTON ISLAND,2002,10,179,0,179
HAMILTON ISLAND,2002,11,173,0,173
HAMILTON ISLAND,2002,12,188,0,188
HAMILTON ISLAND,2003,1,190,0,190
HAMILTON ISLAND,2003,2,168,0,168
HAMILTON ISLAND,2003,3,189,0,189
HAMILTON ISLAND,2003,4,166,0,166
HAMILTON ISLAND,2003,5,154,0,154
HAMILTON ISLAND,2003,6,146,0,146
HAMILTON ISLAND,2003,7,160,0,160
HAMILTON ISLAND,2003,8,202,0,202
HAMILTON ISLAND,2003,9,203,0,203
HAMILTON ISLAND,2003,10,228,0,228
HAMILTON ISLAND,2003,11,209,0,209
HAMILTON ISLAND,2003,12,227,0,227
HAMILTON ISLAND,2004,1,234,0,234
HAMILTON ISLAND,2004,2,194,0,194
HAMILTON ISLAND,2004,3,192,0,192
HAMILTON ISLAND,2004,4,195,0,195
HAMILTON ISLAND,2004,5,188,0,188
HAMILTON ISLAND,2004,6,166,0,166
HAMILTON ISLAND,2004,7,168,0,168
HAMILTON ISLAND,2004,8,180,0,180
HAMILTON ISLAND,2004,9,177,0,177
HAMILTON ISLAND,2004,10,191,0,191
HAMILTON ISLAND,2004,11,165,0,165
HAMILTON ISLAND,2004,12,186,0,186
HAMILTON ISLAND,2005,1,174,0,174
HAMILTON ISLAND,2005,2,146,0,146
HAMILTON ISLAND,2005,3,155,0,155
HAMILTON ISLAND,2005,4,151,0,151
HAMILTON ISLAND,2005,5,148,0,148
HAMILTON ISLAND,2005,6,151,0,151
HAMILTON ISLAND,2005,7,197,0,197
HAMILTON ISLAND,2005,8,199,0,199
HAMILTON ISLAND,2005,9,194,0,194
HAMILTON ISLAND,2005,10,206,0,206
HAMILTON ISLAND,2005,11,218,0,218
HAMILTON ISLAND,2005,12,225,0,225
HAMILTON ISLAND,2006,1,218,0,218
HAMILTON ISLAND,2006,2,168,0,168
HAMILTON ISLAND,2006,3,186,0,186
HAMILTON ISLAND,2006,4,189,0,189
HAMILTON ISLAND,2006,5,185,0,185
HAMILTON ISLAND,2006,6,179,0,179
HAMILTON ISLAND,2006,7,193,0,193
HAMILTON ISLAND,2006,8,183,0,183
HAMILTON ISLAND,2006,9,181,0,181
HAMILTON ISLAND,2006,10,197,0,197
HAMILTON ISLAND,2006,11,213,0,213
HAMILTON ISLAND,2006,12,215,0,215
HAMILTON ISLAND,2007,1,208,0,208
HAMILTON ISLAND,2007,2,164,0,164
HAMILTON ISLAND,2007,3,195,0,195
HAMILTON ISLAND,2007,4,186,0,186
HAMILTON ISLAND,2007,5,183,0,183
HAMILTON ISLAND,2007,6,185,0,185
HAMILTON ISLAND,2007,7,192,0,192
HAMILTON ISLAND,2007,8,187,0,187
HAMILTON ISLAND,2007,9,182,0,182
HAMILTON ISLAND,2007,10,190,0,190
HAMILTON ISLAND,2007,11,193,0,193
HAMILTON ISLAND,2007,12,195,0,195
HAMILTON ISLAND,2008,1,194,0,194
HAMILTON ISLAND,2008,2,152,0,152
HAMILTON ISLAND,2008,3,183,0,183
HAMILTON ISLAND,2008,4,180,0,180
HAMILTON ISLAND,2008,5,170,0,170
HAMILTON ISLAND,2008,6,169,0,169
HAMILTON ISLAND,2008,7,180,0,180
HAMILTON ISLAND,2008,8,162,0,162
HAMILTON ISLAND,2008,9,170,0,170
HAMILTON ISLAND,2008,10,183,0,183
HAMILTON ISLAND,2008,11,155,0,155
HAMILTON ISLAND,2008,12,158,0,158
HAMILTON ISLAND,2009,1,161,0,161
HAMILTON ISLAND,2009,2,136,0,136
HAMILTON ISLAND,2009,3,151,0,151
HAMILTON ISLAND,2009,4,150,0,150
HAMILTON ISLAND,2009,5,150,0,150
HAMILTON ISLAND,2009,6,148,0,148
HAMILTON ISLAND,2009,7,180,0,180
HAMILTON ISLAND,2009,8,187,0,187
HAMILTON ISLAND,2009,9,180,0,180
HAMILTON ISLAND,2009,10,186,0,186
HAMILTON ISLAND,2009,11,180,0,180
HAMILTON ISLAND,2009,12,186,0,186
HAMILTON ISLAND,2010,1,185,0,185
HAMILTON ISLAND,2010,2,166,0,166
HAMILTON ISLAND,2010,3,175,0,175
HAMILTON ISLAND,2010,4,179,0,179
HAMILTON ISLAND,2010,5,170,0,170
HAMILTON ISLAND,2010,6,164,0,164
HAMILTON ISLAND,2010,7,183,0,183
HAMILTON ISLAND,2010,8,185,0,185
HAMILTON ISLAND,2010,9,176,0,176
HAMILTON ISLAND,2010,10,186,0,186
HAMILTON ISLAND,2010,11,180,0,180
HAMILTON ISLAND,2010,12,183,0,183
HAMILTON ISLAND,2011,1,185,0,185
HAMILTON ISLAND,2011,2,144,0,144
HAMILTON ISLAND,2011,3,167,0,167
HAMILTON ISLAND,2011,4,178,0,178
HAMILTON ISLAND,2011,5,161,0,161
HAMILTON ISLAND,2011,6,145,0,145
HAMILTON ISLAND,2011,7,183,0,183
HAMILTON ISLAND,2011,8,184,0,184
HAMILTON ISLAND,2011,9,177,0,177
HAMILTON ISLAND,2011,10,185,0,185
HAMILTON ISLAND,2011,11,180,0,180
HAMILTON ISLAND,2011,12,182,0,182
HAMILTON ISLAND,2012,1,173,0,173
HAMILTON ISLAND,2012,2,148,0,148
HAMILTON ISLAND,2012,3,159,0,159
HAMILTON ISLAND,2012,4,159,0,159
HAMILTON ISLAND,2012,5,154,0,154
HAMILTON ISLAND,2012,6,152,0,152
HAMILTON ISLAND,2012,7,148,0,148
HAMILTON ISLAND,2012,8,161,0,161
HAMILTON ISLAND,2012,9,160,0,160
HAMILTON ISLAND,2012,10,161,0,161
HAMILTON ISLAND,2012,11,160,0,160
HAMILTON ISLAND,2012,12,166,0,166
HAMILTON ISLAND,2013,1,159,0,159
HAMILTON ISLAND,2013,2,136,0,136
HAMILTON ISLAND,2013,3,157,0,157
HAMILTON ISLAND,2013,4,157,0,157
HAMILTON ISLAND,2013,5,148,0,148
HAMILTON ISLAND,2013,6,155,0,155
HAMILTON ISLAND,2013,7,162,0,162
HAMILTON ISLAND,2013,8,174,0,174
HAMILTON ISLAND,2013,9,177,0,177
HAMILTON ISLAND,2013,10,182,0,182
HAMILTON ISLAND,2013,11,182,0,182
HAMILTON ISLAND,2013,12,187,0,187
HAMILTON ISLAND,2014,1,172,0,172
HAMILTON ISLAND,2014,2,145,0,145
HAMILTON ISLAND,2014,3,158,0,158
HAMILTON ISLAND,2014,4,164,0,164
HAMILTON ISLAND,2014,5,164,0,164
HAMILTON ISLAND,2014,6,164,0,164
HAMILTON ISLAND,2014,7,196,0,196
HAMILTON ISLAND,2014,8,194,0,194
HAMILTON ISLAND,2014,9,192,0,192
HAMILTON ISLAND,2014,10,188,0,188
HAMILTON ISLAND,2014,11,175,0,175
HAMILTON ISLAND,2014,12,192,0,192
HAMILTON ISLAND,2015,1,197,0,197
HAMILTON ISLAND,2015,2,150,0,150
HAMILTON ISLAND,2015,3,172,0,172
HAMILTON ISLAND,2015,4,173,0,173
HAMILTON ISLAND,2015,5,164,0,164
HAMILTON ISLAND,2015,6,169,0,169
HAMILTON ISLAND,2015,7,169,0,169
HAMILTON ISLAND,2015,8,185,0,185
HAMILTON ISLAND,2015,9,189,0,189
HAMILTON ISLAND,2015,10,199,0,199
HAMILTON ISLAND,2015,11,194,0,194
HAMILTON ISLAND,2015,12,202,0,202
HAMILTON ISLAND,2016,1,211,0,211
HAMILTON ISLAND,2016,2,179,0,179
HAMILTON ISLAND,2016,3,202,0,202
HAMILTON ISLAND,2016,4,205,0,205
HAMILTON ISLAND,2016,5,200,0,200
HAMILTON ISLAND,2016,6,190,0,190
HAMILTON ISLAND,2016,7,220,0,220
HAMILTON ISLAND,2016,8,219,0,219
HAMILTON ISLAND,2016,9,217,0,217
HAMILTON ISLAND,2016,10,224,0,224
HAMILTON ISLAND,2016,11,226,0,226
HAMILTON ISLAND,2016,12,243,0,243
HAMILTON ISLAND,2017,1,244,0,244
HAMILTON ISLAND,2017,2,187,0,187
HAMILTON ISLAND,2017,3,189,0,189
HAMILTON ISLAND,2017,4,142,0,142
HAMILTON ISLAND,2017,5,174,0,174
HAMILTON ISLAND,2017,6,171,0,171
HAMILTON ISLAND,2017,7,204,0,204
HAMILTON ISLAND,2017,8,211,0,211
HAMILTON ISLAND,2017,9,214,0,214
HAMILTON ISLAND,2017,10,208,0,208
HAMILTON ISLAND,2017,11,207,0,207
HAMILTON ISLAND,2017,12,203,0,203
HAMILTON ISLAND,2018,1,217,0,217
HAMILTON ISLAND,2018,2,160,0,160
HAMILTON ISLAND,2018,3,179,0,179
HAMILTON ISLAND,2018,4,193,0,193
HAMILTON ISLAND,2018,5,172,0,172
HAMILTON ISLAND,2018,6,167,0,167
HAMILTON ISLAND,2018,7,205,0,205
HAMILTON ISLAND,2018,8,199,0,199
HAMILTON ISLAND,2018,9,202,0,202
HAMILTON ISLAND,2018,10,212,0,212
HAMILTON ISLAND,2018,11,184,0,184
HAMILTON ISLAND,2018,12,211,0,211
HAMILTON ISLAND,2019,1,216,0,216
HAMILTON ISLAND,2019,2,167,0,167
HAMILTON ISLAND,2019,3,189,0,189
HAMILTON ISLAND,2019,4,197,0,197
HAMILTON ISLAND,2019,5,178,0,178
HAMILTON ISLAND,2019,6,181,0,181
HAMILTON ISLAND,2019,7,203,0,203
HAMILTON ISLAND,2019,8,192,0,192
HAMILTON ISLAND,2019,9,209,0,209
HAMILTON ISLAND,2019,10,212,0,212
HAMILTON ISLAND,2019,11,203,0,203
HAMILTON ISLAND,2019,12,216,0,216
HAMILTON ISLAND,2020,1,222,0,222
HAMILTON ISLAND,2020,2,160,0,160
HAMILTON ISLAND,2020,3,139,0,139
HAMILTON ISLAND,2020,4,0,0,0
HAMILTON ISLAND,2020,5,0,0,0
HAMILTON ISLAND,2020,6,0,0,0
HAMILTON ISLAND,2020,7,6,0,6
HAMILTON ISLAND,2020,8,69,0,69
HAMILTON ISLAND,2020,9,76,0,76
HAMILTON ISLAND,2020,10,80,0,80
HAMILTON ISLAND,2020,11,72,0,72
HAMILTON ISLAND,2020,12,151,0,151
HAMILTON ISLAND,2021,1,137,0,137
HAMILTON ISLAND,2021,2,104,0,104
HAMILTON ISLAND,2021,3,163,0,163
HAMILTON ISLAND,2021,4,199,0,199
HAMILTON ISLAND,2021,5,164,0,164
HAMILTON ISLAND,2021,6,176,0,176
HAMILTON ISLAND,2021,7,132,0,132
HAMILTON ISLAND,2021,8,69,0,69
HAMILTON ISLAND,2021,9,83,0,83
HAMILTON ISLAND,2021,10,102,0,102
HAMILTON ISLAND,2021,11,99,0,99
HAMILTON ISLAND,2021,12,169,0,169
HAMILTON ISLAND,2022,1,181,0,181
HAMILTON ISLAND,2022,2,138,0,138
HAMILTON ISLAND,2022,3,171,0,171
HAMILTON ISLAND,2022,4,243,0,243
HAMILTON ISLAND,2022,5,188,0,188
HAMILTON ISLAND,2022,6,176,0,176
HAMILTON ISLAND,2022,7,186,0,186
HAMILTON ISLAND,2022,8,160,0,160
HAMILTON ISLAND,2022,9,165,0,165
HAMILTON ISLAND,2022,10,184,0,184
HAMILTON ISLAND,2022,11,161,0,161
HAMILTON ISLAND,2022,12,178,0,178
HAMILTON ISLAND,2023,1,188,0,188
HAMILTON ISLAND,2023,2,133,0,133
HAMILTON ISLAND,2023,3,158,0,158
HAMILTON ISLAND,2023,4,177,0,177
HAMILTON ISLAND,2023,5,139,0,139
HAMILTON ISLAND,2023,6,154,0,154
HAMILTON ISLAND,2023,7,175,0,175
HAMILTON ISLAND,2023,8,164,0,164
HAMILTON ISLAND,2023,9,176,0,176
HAMILTON ISLAND,2023,10,172,0,172
HAMILTON ISLAND,2023,11,162,0,162
HAMILTON ISLAND,2023,12,194,0,194
HAMILTON ISLAND,2024,1,193,0,193
HAMILTON ISLAND,2024,2,146,0,146
HAMILTON ISLAND,2024,3,170,0,170
HAMILTON ISLAND,2024,4,160,0,160
HAMILTON ISLAND,2024,5,141,0,141
HAMILTON ISLAND,2024,6,143,0,143
HAMILTON ISLAND,2024,7,161,0,161
HAMILTON ISLAND,2024,8,157,0,157
HAMILTON ISLAND,2024,9,164,0,164
HAMILTON ISLAND,2024,10,163,0,163
HAMILTON ISLAND,2024,11,154,0,154
HAMILTON ISLAND,2024,12,184,0,184
HOBART,1985,1,473,8,481
HOBART,1985,2,391,8,399
HOBART,1985,3,422,9,431
HOBART,1985,4,422,8,430
HOBART,1985,5,444,8,452
HOBART,1985,6,419,8,427
HOBART,1985,7,402,6,408
HOBART,1985,8,530,7,537
HOBART,1985,9,569,8,577
HOBART,1985,10,523,7,530
HOBART,1985,11,502,8,510
HOBART,1985,12,535,12,547
HOBART,1986,1,578,12,590
HOBART,1986,2,443,11,454
HOBART,1986,3,504,14,518
HOBART,1986,4,484,12,496
HOBART,1986,5,506,14,520
HOBART,1986,6,470,11,481
HOBART,1986,7,442,9,451
HOBART,1986,8,470,11,481
HOBART,1986,9,484,12,496
HOBART,1986,10,488,12,500
HOBART,1986,11,463,13,476
HOBART,1986,12,503,12,515
HOBART,1987,1,567,14,581
HOBART,1987,2,469,12,481
HOBART,1987,3,513,12,525
HOBART,1987,4,459,8,467
HOBART,1987,5,452,9,461
HOBART,1987,6,467,9,476
HOBART,1987,7,478,8,486
HOBART,1987,8,489,10,499
HOBART,1987,9,495,8,503
HOBART,1987,10,523,9,532
HOBART,1987,11,491,9,500
HOBART,1987,12,532,12,544
HOBART,1988,1,557,14,571
HOBART,1988,2,469,13,482
HOBART,1988,3,455,11,466
HOBART,1988,4,411,9,420
HOBART,1988,5,397,9,406
HOBART,1988,6,383,8,391
HOBART,1988,7,396,9,405
HOBART,1988,8,422,9,431
HOBART,1988,9,432,8,440
HOBART,1988,10,415,10,425
HOBART,1988,11,395,12,407
HOBART,1988,12,432,12,444
HOBART,1989,1,456,14,470
HOBART,1989,2,375,15,390
HOBART,1989,3,419,16,435
HOBART,1989,4,401,13,414
HOBART,1989,5,404,13,417
HOBART,1989,6,386,9,395
HOBART,1989,7,402,14,416
HOBART,1989,8,333,13,346
HOBART,1989,9,252,16,268
HOBART,1989,10,250,21,271
HOBART,1989,11,308,16,324
HOBART,1989,12,303,18,321
HOBART,1990,1,355,18,373
HOBART,1990,2,329,16,345
HOBART,1990,3,393,15,408
HOBART,1990,4,384,13,397
HOBART,1990,5,368,13,381
HOBART,1990,6,357,13,370
HOBART,1990,7,350,13,363
HOBART,1990,8,354,13,367
HOBART,1990,9,369,13,382
HOBART,1990,10,351,13,364
HOBART,1990,11,381,13,394
HOBART,1990,12,411,13,424
HOBART,1991,1,455,13,468
HOBART,1991,2,401,12,413
HOBART,1991,3,425,13,438
HOBART,1991,4,415,4,419
HOBART,1991,5,430,4,434
HOBART,1991,6,425,5,430
HOBART,1991,7,435,4,439
HOBART,1991,8,435,5,440
HOBART,1991,9,431,5,436
HOBART,1991,10,446,4,450
HOBART,1991,11,428,5,433
HOBART,1991,12,468,6,474
HOBART,1992,1,520,6,526
HOBART,1992,2,413,5,418
HOBART,1992,3,436,4,440
HOBART,1992,4,442,4,446
HOBART,1992,5,430,5,435
HOBART,1992,6,402,4,406
HOBART,1992,7,402,4,406
HOBART,1992,8,390,6,396
HOBART,1992,9,390,5,395
HOBART,1992,10,402,5,407
HOBART,1992,11,413,4,417
HOBART,1992,12,451,4,455
HOBART,1993,1,516,6,522
HOBART,1993,2,478,8,486
HOBART,1993,3,462,5,467
HOBART,1993,4,545,4,549
HOBART,1993,5,533,5,538
HOBART,1993,6,436,4,440
HOBART,1993,7,528,5,533
HOBART,1993,8,446,4,450
HOBART,1993,9,438,4,442
HOBART,1993,10,451,5,456
HOBART,1993,11,441,4,445
HOBART,1993,12,472,4,476
HOBART,1994,1,493,5,498
HOBART,1994,2,414,4,418
HOBART,1994,3,482,4,486
HOBART,1994,4,452,5,457
HOBART,1994,5,500,4,504
HOBART,1994,6,497,4,501
HOBART,1994,7,518,4,522
HOBART,1994,8,515,4,519
HOBART,1994,9,493,4,497
HOBART,1994,10,517,5,522
HOBART,1994,11,495,4,499
HOBART,1994,12,546,5,551
HOBART,1995,1,651,4,655
HOBART,1995,2,479,3,482
HOBART,1995,3,514,4,518
HOBART,1995,4,478,5,483
HOBART,1995,5,490,4,494
HOBART,1995,6,444,4,448
HOBART,1995,7,442,5,447
HOBART,1995,8,431,4,435
HOBART,1995,9,432,5,437
HOBART,1995,10,467,4,471
HOBART,1995,11,470,4,474
HOBART,1995,12,501,5,506
HOBART,1996,1,581,4,585
HOBART,1996,2,457,4,461
HOBART,1996,3,484,5,489
HOBART,1996,4,447,4,451
HOBART,1996,5,443,4,447
HOBART,1996,6,412,2,414
HOBART,1996,7,424,0,424
HOBART,1996,8,422,0,422
HOBART,1996,9,448,0,448
HOBART,1996,10,416,2,418
HOBART,1996,11,390,5,395
HOBART,1996,12,436,4,440
HOBART,1997,1,473,4,477
HOBART,1997,2,362,4,366
HOBART,1997,3,361,5,366
HOBART,1997,4,329,4,333
HOBART,1997,5,326,0,326
HOBART,1997,6,321,0,321
HOBART,1997,7,330,0,330
HOBART,1997,8,326,0,326
HOBART,1997,9,333,0,333
HOBART,1997,10,344,0,344
HOBART,1997,11,355,5,360
HOBART,1997,12,392,4,396
HOBART,1998,1,431,5,436
HOBART,1998,2,327,4,331
HOBART,1998,3,391,4,395
HOBART,1998,4,413,4,417
HOBART,1998,5,411,0,411
HOBART,1998,6,403,0,403
HOBART,1998,7,404,0,404
HOBART,1998,8,404,0,404
HOBART,1998,9,417,0,417
HOBART,1998,10,423,0,423
HOBART,1998,11,378,0,378
HOBART,1998,12,433,0,433
HOBART,1999,1,476,0,476
HOBART,1999,2,372,0,372
HOBART,1999,3,404,0,404
HOBART,1999,4,385,0,385
HOBART,1999,5,379,0,379
HOBART,1999,6,371,0,371
HOBART,1999,7,379,0,379
HOBART,1999,8,396,0,396
HOBART,1999,9,413,0,413
HOBART,1999,10,419,0,419
HOBART,1999,11,398,0,398
HOBART,1999,12,446,0,446
HOBART,2000,1,457,0,457
HOBART,2000,2,420,0,420
HOBART,2000,3,414,0,414
HOBART,2000,4,514,0,514
HOBART,2000,5,551,0,551
HOBART,2000,6,578,0,578
HOBART,2000,7,599,0,599
HOBART,2000,8,586,0,586
HOBART,2000,9,583,0,583
HOBART,2000,10,627,0,627
HOBART,2000,11,586,0,586
HOBART,2000,12,645,0,645
HOBART,2001,1,714,0,714
HOBART,2001,2,563,0,563
HOBART,2001,3,597,0,597
HOBART,2001,4,669,0,669
HOBART,2001,5,703,0,703
HOBART,2001,6,729,0,729
HOBART,2001,7,760,0,760
HOBART,2001,8,750,0,750
HOBART,2001,9,530,0,530
HOBART,2001,10,395,0,395
HOBART,2001,11,463,0,463
HOBART,2001,12,479,0,479
HOBART,2002,1,495,0,495
HOBART,2002,2,486,0,486
HOBART,2002,3,475,0,475
HOBART,2002,4,432,0,432
HOBART,2002,5,429,0,429
HOBART,2002,6,437,0,437
HOBART,2002,7,452,0,452
HOBART,2002,8,448,0,448
HOBART,2002,9,467,0,467
HOBART,2002,10,483,0,483
HOBART,2002,11,453,0,453
HOBART,2002,12,493,0,493
HOBART,2003,1,535,0,535
HOBART,2003,2,485,0,485
HOBART,2003,3,505,0,505
HOBART,2003,4,488,0,488
HOBART,2003,5,477,0,477
HOBART,2003,6,436,0,436
HOBART,2003,7,456,0,456
HOBART,2003,8,443,0,443
HOBART,2003,9,464,0,464
HOBART,2003,10,505,0,505
HOBART,2003,11,518,0,518
HOBART,2003,12,537,0,537
HOBART,2004,1,587,0,587
HOBART,2004,2,537,0,537
HOBART,2004,3,578,0,578
HOBART,2004,4,554,0,554
HOBART,2004,5,583,0,583
HOBART,2004,6,603,0,603
HOBART,2004,7,606,0,606
HOBART,2004,8,628,0,628
HOBART,2004,9,646,0,646
HOBART,2004,10,646,0,646
HOBART,2004,11,656,0,656
HOBART,2004,12,744,0,744
HOBART,2005,1,735,0,735
HOBART,2005,2,626,0,626
HOBART,2005,3,704,0,704
HOBART,2005,4,660,0,660
HOBART,2005,5,659,0,659
HOBART,2005,6,615,0,615
HOBART,2005,7,637,0,637
HOBART,2005,8,603,0,603
HOBART,2005,9,582,0,582
HOBART,2005,10,594,0,594
HOBART,2005,11,611,0,611
HOBART,2005,12,639,0,639
HOBART,2006,1,640,0,640
HOBART,2006,2,565,0,565
HOBART,2006,3,622,0,622
HOBART,2006,4,549,0,549
HOBART,2006,5,565,0,565
HOBART,2006,6,546,0,546
HOBART,2006,7,546,0,546
HOBART,2006,8,556,0,556
HOBART,2006,9,539,0,539
HOBART,2006,10,563,0,563
HOBART,2006,11,562,0,562
HOBART,2006,12,595,0,595
HOBART,2007,1,584,0,584
HOBART,2007,2,524,0,524
HOBART,2007,3,578,0,578
HOBART,2007,4,557,0,557
HOBART,2007,5,578,0,578
HOBART,2007,6,551,0,551
HOBART,2007,7,560,0,560
HOBART,2007,8,575,0,575
HOBART,2007,9,557,0,557
HOBART,2007,10,578,0,578
HOBART,2007,11,586,0,586
HOBART,2007,12,631,0,631
HOBART,2008,1,660,0,660
HOBART,2008,2,582,0,582
HOBART,2008,3,624,0,624
HOBART,2008,4,612,0,612
HOBART,2008,5,646,0,646
HOBART,2008,6,615,0,615
HOBART,2008,7,621,0,621
HOBART,2008,8,622,0,622
HOBART,2008,9,642,0,642
HOBART,2008,10,659,0,659
HOBART,2008,11,642,0,642
HOBART,2008,12,673,0,673
HOBART,2009,1,650,0,650
HOBART,2009,2,564,0,564
HOBART,2009,3,629,0,629
HOBART,2009,4,636,0,636
HOBART,2009,5,587,0,587
HOBART,2009,6,589,0,589
HOBART,2009,7,630,0,630
HOBART,2009,8,600,0,600
HOBART,2009,9,600,0,600
HOBART,2009,10,617,0,617
HOBART,2009,11,586,0,586
HOBART,2009,12,618,0,618
HOBART,2010,1,640,0,640
HOBART,2010,2,588,0,588
HOBART,2010,3,687,0,687
HOBART,2010,4,671,0,671
HOBART,2010,5,664,0,664
HOBART,2010,6,645,0,645
HOBART,2010,7,680,0,680
HOBART,2010,8,634,0,634
HOBART,2010,9,626,0,626
HOBART,2010,10,655,0,655
HOBART,2010,11,645,0,645
HOBART,2010,12,758,0,758
HOBART,2011,1,824,0,824
HOBART,2011,2,689,0,689
HOBART,2011,3,723,0,723
HOBART,2011,4,600,0,600
HOBART,2011,5,601,0,601
HOBART,2011,6,515,0,515
HOBART,2011,7,595,0,595
HOBART,2011,8,574,0,574
HOBART,2011,9,576,0,576
HOBART,2011,10,581,0,581
HOBART,2011,11,575,0,575
HOBART,2011,12,632,0,632
HOBART,2012,1,687,0,687
HOBART,2012,2,585,0,585
HOBART,2012,3,628,0,628
HOBART,2012,4,575,0,575
HOBART,2012,5,578,0,578
HOBART,2012,6,557,0,557
HOBART,2012,7,594,0,594
HOBART,2012,8,592,0,592
HOBART,2012,9,614,0,614
HOBART,2012,10,657,0,657
HOBART,2012,11,736,0,736
HOBART,2012,12,817,0,817
HOBART,2013,1,821,0,821
HOBART,2013,2,664,0,664
HOBART,2013,3,764,0,764
HOBART,2013,4,673,0,673
HOBART,2013,5,601,0,601
HOBART,2013,6,587,0,587
HOBART,2013,7,663,0,663
HOBART,2013,8,636,0,636
HOBART,2013,9,661,0,661
HOBART,2013,10,687,0,687
HOBART,2013,11,672,0,672
HOBART,2013,12,765,0,765
HOBART,2014,1,774,0,774
HOBART,2014,2,605,0,605
HOBART,2014,3,719,0,719
HOBART,2014,4,669,0,669
HOBART,2014,5,610,0,610
HOBART,2014,6,634,0,634
HOBART,2014,7,707,0,707
HOBART,2014,8,683,0,683
HOBART,2014,9,689,0,689
HOBART,2014,10,729,0,729
HOBART,2014,11,700,0,700
HOBART,2014,12,824,0,824
HOBART,2015,1,852,0,852
HOBART,2015,2,652,0,652
HOBART,2015,3,730,0,730
HOBART,2015,4,694,0,694
HOBART,2015,5,668,0,668
HOBART,2015,6,660,0,660
HOBART,2015,7,708,0,708
HOBART,2015,8,691,0,691
HOBART,2015,9,692,0,692
HOBART,2015,10,741,0,741
HOBART,2015,11,737,0,737
HOBART,2015,12,856,0,856
HOBART,2016,1,873,0,873
HOBART,2016,2,700,0,700
HOBART,2016,3,792,0,792
HOBART,2016,4,755,0,755
HOBART,2016,5,722,0,722
HOBART,2016,6,716,0,716
HOBART,2016,7,765,0,765
HOBART,2016,8,727,0,727
HOBART,2016,9,738,0,738
HOBART,2016,10,790,0,790
HOBART,2016,11,779,0,779
HOBART,2016,12,908,0,908
HOBART,2017,1,930,0,930
HOBART,2017,2,741,0,741
HOBART,2017,3,821,0,821
HOBART,2017,4,777,0,777
HOBART,2017,5,709,0,709
HOBART,2017,6,714,0,714
HOBART,2017,7,768,0,768
HOBART,2017,8,707,0,707
HOBART,2017,9,727,0,727
HOBART,2017,10,779,0,779
HOBART,2017,11,770,0,770
HOBART,2017,12,940,0,940
HOBART,2018,1,989,0,989
HOBART,2018,2,784,0,784
HOBART,2018,3,859,0,859
HOBART,2018,4,798,0,798
HOBART,2018,5,690,0,690
HOBART,2018,6,689,0,689
HOBART,2018,7,773,0,773
HOBART,2018,8,715,0,715
HOBART,2018,9,750,0,750
HOBART,2018,10,839,0,839
HOBART,2018,11,832,0,832
HOBART,2018,12,956,0,956
HOBART,2019,1,996,0,996
HOBART,2019,2,810,0,810
HOBART,2019,3,877,0,877
HOBART,2019,4,838,0,838
HOBART,2019,5,757,0,757
HOBART,2019,6,765,0,765
HOBART,2019,7,830,0,830
HOBART,2019,8,758,0,758
HOBART,2019,9,786,0,786
HOBART,2019,10,853,0,853
HOBART,2019,11,858,0,858
HOBART,2019,12,984,0,984
HOBART,2020,1,972,0,972
HOBART,2020,2,838,0,838
HOBART,2020,3,680,0,680
HOBART,2020,4,68,1,69
HOBART,2020,5,64,0,64
HOBART,2020,6,63,0,63
HOBART,2020,7,80,0,80
HOBART,2020,8,107,0,107
HOBART,2020,9,109,0,109
HOBART,2020,10,120,0,120
HOBART,2020,11,273,0,273
HOBART,2020,12,671,4,675
HOBART,2021,1,657,13,670
HOBART,2021,2,515,4,519
HOBART,2021,3,741,0,741
HOBART,2021,4,854,3,857
HOBART,2021,5,737,9,746
HOBART,2021,6,556,7,563
HOBART,2021,7,522,8,530
HOBART,2021,8,296,0,296
HOBART,2021,9,327,0,327
HOBART,2021,10,395,0,395
HOBART,2021,11,451,1,452
HOBART,2021,12,824,4,828
HOBART,2022,1,876,0,876
HOBART,2022,2,597,0,597
HOBART,2022,3,819,0,819
HOBART,2022,4,987,0,987
HOBART,2022,5,881,0,881
HOBART,2022,6,867,0,867
HOBART,2022,7,837,6,843
HOBART,2022,8,732,7,739
HOBART,2022,9,742,8,750
HOBART,2022,10,804,9,813
HOBART,2022,11,862,13,875
HOBART,2022,12,1005,15,1020
HOBART,2023,1,1007,13,1020
HOBART,2023,2,848,10,858
HOBART,2023,3,916,12,928
HOBART,2023,4,859,13,872
HOBART,2023,5,791,8,799
HOBART,2023,6,779,9,788
HOBART,2023,7,779,9,788
HOBART,2023,8,747,8,755
HOBART,2023,9,794,7,801
HOBART,2023,10,882,9,891
HOBART,2023,11,844,13,857
HOBART,2023,12,1021,11,1032
HOBART,2024,1,1090,11,1101
HOBART,2024,2,873,13,886
HOBART,2024,3,932,13,945
HOBART,2024,4,902,2,904
HOBART,2024,5,780,0,780
HOBART,2024,6,761,0,761
HOBART,2024,7,841,0,841
HOBART,2024,8,754,0,754
HOBART,2024,9,776,0,776
HOBART,2024,10,822,3,825
HOBART,2024,11,805,12,817
HOBART,2024,12,954,13,967
KARRATHA,1985,1,286,0,286
KARRATHA,1985,2,249,0,249
KARRATHA,1985,3,261,0,261
KARRATHA,1985,4,262,0,262
KARRATHA,1985,5,283,0,283
KARRATHA,1985,6,262,0,262
KARRATHA,1985,7,268,0,268
KARRATHA,1985,8,269,0,269
KARRATHA,1985,9,260,0,260
KARRATHA,1985,10,262,0,262
KARRATHA,1985,11,269,0,269
KARRATHA,1985,12,284,0,284
KARRATHA,1986,1,230,0,230
KARRATHA,1986,2,204,0,204
KARRATHA,1986,3,222,0,222
KARRATHA,1986,4,215,0,215
KARRATHA,1986,5,243,0,243
KARRATHA,1986,6,231,0,231
KARRATHA,1986,7,242,0,242
KARRATHA,1986,8,246,0,246
KARRATHA,1986,9,227,0,227
KARRATHA,1986,10,245,0,245
KARRATHA,1986,11,221,0,221
KARRATHA,1986,12,258,0,258
KARRATHA,1987,1,220,0,220
KARRATHA,1987,2,204,0,204
KARRATHA,1987,3,226,0,226
KARRATHA,1987,4,216,0,216
KARRATHA,1987,5,224,0,224
KARRATHA,1987,6,214,0,214
KARRATHA,1987,7,239,0,239
KARRATHA,1987,8,228,0,228
KARRATHA,1987,9,219,0,219
KARRATHA,1987,10,233,0,233
KARRATHA,1987,11,225,0,225
KARRATHA,1987,12,223,0,223
KARRATHA,1988,1,192,0,192
KARRATHA,1988,2,186,0,186
KARRATHA,1988,3,202,0,202
KARRATHA,1988,4,190,0,190
KARRATHA,1988,5,189,0,189
KARRATHA,1988,6,191,0,191
KARRATHA,1988,7,214,0,214
KARRATHA,1988,8,208,0,208
KARRATHA,1988,9,201,0,201
KARRATHA,1988,10,192,0,192
KARRATHA,1988,11,166,0,166
KARRATHA,1988,12,174,0,174
KARRATHA,1989,1,166,0,166
KARRATHA,1989,2,146,0,146
KARRATHA,1989,3,173,0,173
KARRATHA,1989,4,165,0,165
KARRATHA,1989,5,180,0,180
KARRATHA,1989,6,159,0,159
KARRATHA,1989,7,183,0,183
KARRATHA,1989,8,117,0,117
KARRATHA,1989,9,31,0,31
KARRATHA,1989,10,91,0,91
KARRATHA,1989,11,101,0,101
KARRATHA,1989,12,121,0,121
KARRATHA,1990,1,127,0,127
KARRATHA,1990,2,114,0,114
KARRATHA,1990,3,141,0,141
KARRATHA,1990,4,138,0,138
KARRATHA,1990,5,146,0,146
KARRATHA,1990,6,128,0,128
KARRATHA,1990,7,161,0,161
KARRATHA,1990,8,152,0,152
KARRATHA,1990,9,139,0,139
KARRATHA,1990,10,170,0,170
KARRATHA,1990,11,155,0,155
KARRATHA,1990,12,143,0,143
KARRATHA,1991,1,152,0,152
KARRATHA,1991,2,127,0,127
KARRATHA,1991,3,138,0,138
KARRATHA,1991,4,140,0,140
KARRATHA,1991,5,152,0,152
KARRATHA,1991,6,137,0,137
KARRATHA,1991,7,152,0,152
KARRATHA,1991,8,138,0,138
KARRATHA,1991,9,153,0,153
KARRATHA,1991,10,162,0,162
KARRATHA,1991,11,151,0,151
KARRATHA,1991,12,143,0,143
KARRATHA,1992,1,154,0,154
KARRATHA,1992,2,141,0,141
KARRATHA,1992,3,152,0,152
KARRATHA,1992,4,155,0,155
KARRATHA,1992,5,157,0,157
KARRATHA,1992,6,160,0,160
KARRATHA,1992,7,165,0,165
KARRATHA,1992,8,151,0,151
KARRATHA,1992,9,159,0,159
KARRATHA,1992,10,159,0,159
KARRATHA,1992,11,155,0,155
KARRATHA,1992,12,156,0,156
KARRATHA,1993,1,146,0,146
KARRATHA,1993,2,134,0,134
KARRATHA,1993,3,153,0,153
KARRATHA,1993,4,154,0,154
KARRATHA,1993,5,154,0,154
KARRATHA,1993,6,153,0,153
KARRATHA,1993,7,176,0,176
KARRATHA,1993,8,170,0,170
KARRATHA,1993,9,182,0,182
KARRATHA,1993,10,176,0,176
KARRATHA,1993,11,178,0,178
KARRATHA,1993,12,169,0,169
KARRATHA,1994,1,159,0,159
KARRATHA,1994,2,160,0,160
KARRATHA,1994,3,169,0,169
KARRATHA,1994,4,164,0,164
KARRATHA,1994,5,176,0,176
KARRATHA,1994,6,180,0,180
KARRATHA,1994,7,187,0,187
KARRATHA,1994,8,198,0,198
KARRATHA,1994,9,189,0,189
KARRATHA,1994,10,193,0,193
KARRATHA,1994,11,216,0,216
KARRATHA,1994,12,229,0,229
KARRATHA,1995,1,212,0,212
KARRATHA,1995,2,185,0,185
KARRATHA,1995,3,218,0,218
KARRATHA,1995,4,204,0,204
KARRATHA,1995,5,210,0,210
KARRATHA,1995,6,208,0,208
KARRATHA,1995,7,205,0,205
KARRATHA,1995,8,223,0,223
KARRATHA,1995,9,209,0,209
KARRATHA,1995,10,201,0,201
KARRATHA,1995,11,186,0,186
KARRATHA,1995,12,178,0,178
KARRATHA,1996,1,192,0,192
KARRATHA,1996,2,197,0,197
KARRATHA,1996,3,201,0,201
KARRATHA,1996,4,219,0,219
KARRATHA,1996,5,228,0,228
KARRATHA,1996,6,217,0,217
KARRATHA,1996,7,238,0,238
KARRATHA,1996,8,238,0,238
KARRATHA,1996,9,226,0,226
KARRATHA,1996,10,246,0,246
KARRATHA,1996,11,212,0,212
KARRATHA,1996,12,202,0,202
KARRATHA,1997,1,210,0,210
KARRATHA,1997,2,201,0,201
KARRATHA,1997,3,199,0,199
KARRATHA,1997,4,198,0,198
KARRATHA,1997,5,217,0,217
KARRATHA,1997,6,200,0,200
KARRATHA,1997,7,216,0,216
KARRATHA,1997,8,207,0,207
KARRATHA,1997,9,202,0,202
KARRATHA,1997,10,211,0,211
KARRATHA,1997,11,197,0,197
KARRATHA,1997,12,189,0,189
KARRATHA,1998,1,202,0,202
KARRATHA,1998,2,179,0,179
KARRATHA,1998,3,205,0,205
KARRATHA,1998,4,187,0,187
KARRATHA,1998,5,202,0,202
KARRATHA,1998,6,199,0,199
KARRATHA,1998,7,205,0,205
KARRATHA,1998,8,202,0,202
KARRATHA,1998,9,190,0,190
KARRATHA,1998,10,202,0,202
KARRATHA,1998,11,195,0,195
KARRATHA,1998,12,198,0,198
KARRATHA,1999,1,197,0,197
KARRATHA,1999,2,177,0,177
KARRATHA,1999,3,188,0,188
KARRATHA,1999,4,187,0,187
KARRATHA,1999,5,191,0,191
KARRATHA,1999,6,192,0,192
KARRATHA,1999,7,153,0,153
KARRATHA,1999,8,143,0,143
KARRATHA,1999,9,142,0,142
KARRATHA,1999,10,144,0,144
KARRATHA,1999,11,141,0,141
KARRATHA,1999,12,141,0,141
KARRATHA,2000,1,141,0,141
KARRATHA,2000,2,145,0,145
KARRATHA,2000,3,149,0,149
KARRATHA,2000,4,192,0,192
KARRATHA,2000,5,208,0,208
KARRATHA,2000,6,194,0,194
KARRATHA,2000,7,199,0,199
KARRATHA,2000,8,202,0,202
KARRATHA,2000,9,190,0,190
KARRATHA,2000,10,202,0,202
KARRATHA,2000,11,200,0,200
KARRATHA,2000,12,191,0,191
KARRATHA,2001,1,204,0,204
KARRATHA,2001,2,187,0,187
KARRATHA,2001,3,202,0,202
KARRATHA,2001,4,196,0,196
KARRATHA,2001,5,187,0,187
KARRATHA,2001,6,177,0,177
KARRATHA,2001,7,186,0,186
KARRATHA,2001,8,189,0,189
KARRATHA,2001,9,139,0,139
KARRATHA,2001,10,112,0,112
KARRATHA,2001,11,143,0,143
KARRATHA,2001,12,144,0,144
KARRATHA,2002,1,127,0,127
KARRATHA,2002,2,116,0,116
KARRATHA,2002,3,132,0,132
KARRATHA,2002,4,142,0,142
KARRATHA,2002,5,138,0,138
KARRATHA,2002,6,132,0,132
KARRATHA,2002,7,140,0,140
KARRATHA,2002,8,135,0,135
KARRATHA,2002,9,126,0,126
KARRATHA,2002,10,131,0,131
KARRATHA,2002,11,115,0,115
KARRATHA,2002,12,123,0,123
KARRATHA,2003,1,121,0,121
KARRATHA,2003,2,110,0,110
KARRATHA,2003,3,117,0,117
KARRATHA,2003,4,111,0,111
KARRATHA,2003,5,109,0,109
KARRATHA,2003,6,103,0,103
KARRATHA,2003,7,118,0,118
KARRATHA,2003,8,121,0,121
KARRATHA,2003,9,118,0,118
KARRATHA,2003,10,117,0,117
KARRATHA,2003,11,116,0,116
KARRATHA,2003,12,118,0,118
KARRATHA,2004,1,104,0,104
KARRATHA,2004,2,111,0,111
KARRATHA,2004,3,117,0,117
KARRATHA,2004,4,116,0,116
KARRATHA,2004,5,145,0,145
KARRATHA,2004,6,152,0,152
KARRATHA,2004,7,150,0,150
KARRATHA,2004,8,140,0,140
KARRATHA,2004,9,142,0,142
KARRATHA,2004,10,148,0,148
KARRATHA,2004,11,146,0,146
KARRATHA,2004,12,149,0,149
KARRATHA,2005,1,151,0,151
KARRATHA,2005,2,135,0,135
KARRATHA,2005,3,145,0,145
KARRATHA,2005,4,140,0,140
KARRATHA,2005,5,147,0,147
KARRATHA,2005,6,144,0,144
KARRATHA,2005,7,151,0,151
KARRATHA,2005,8,154,0,154
KARRATHA,2005,9,144,0,144
KARRATHA,2005,10,146,0,146
KARRATHA,2005,11,144,0,144
KARRATHA,2005,12,144,0,144
KARRATHA,2006,1,135,0,135
KARRATHA,2006,2,127,0,127
KARRATHA,2006,3,145,0,145
KARRATHA,2006,4,132,0,132
KARRATHA,2006,5,147,0,147
KARRATHA,2006,6,138,0,138
KARRATHA,2006,7,152,0,152
KARRATHA,2006,8,131,0,131
KARRATHA,2006,9,123,0,123
KARRATHA,2006,10,119,0,119
KARRATHA,2006,11,123,0,123
KARRATHA,2006,12,117,0,117
KARRATHA,2007,1,125,0,125
KARRATHA,2007,2,129,0,129
KARRATHA,2007,3,122,0,122
KARRATHA,2007,4,121,0,121
KARRATHA,2007,5,126,0,126
KARRATHA,2007,6,119,0,119
KARRATHA,2007,7,124,0,124
KARRATHA,2007,8,130,0,130
KARRATHA,2007,9,131,0,131
KARRATHA,2007,10,142,0,142
KARRATHA,2007,11,156,0,156
KARRATHA,2007,12,159,0,159
KARRATHA,2008,1,166,0,166
KARRATHA,2008,2,159,0,159
KARRATHA,2008,3,176,0,176
KARRATHA,2008,4,179,0,179
KARRATHA,2008,5,181,0,181
KARRATHA,2008,6,180,0,180
KARRATHA,2008,7,200,0,200
KARRATHA,2008,8,193,0,193
KARRATHA,2008,9,186,0,186
KARRATHA,2008,10,220,0,220
KARRATHA,2008,11,232,0,232
KARRATHA,2008,12,250,0,250
KARRATHA,2009,1,261,0,261
KARRATHA,2009,2,235,0,235
KARRATHA,2009,3,250,0,250
KARRATHA,2009,4,257,0,257
KARRATHA,2009,5,267,0,267
KARRATHA,2009,6,269,0,269
KARRATHA,2009,7,280,0,280
KARRATHA,2009,8,269,0,269
KARRATHA,2009,9,270,0,270
KARRATHA,2009,10,270,0,270
KARRATHA,2009,11,271,0,271
KARRATHA,2009,12,273,0,273
KARRATHA,2010,1,269,0,269
KARRATHA,2010,2,248,0,248
KARRATHA,2010,3,289,0,289
KARRATHA,2010,4,299,0,299
KARRATHA,2010,5,310,0,310
KARRATHA,2010,6,310,0,310
KARRATHA,2010,7,313,0,313
KARRATHA,2010,8,321,0,321
KARRATHA,2010,9,308,0,308
KARRATHA,2010,10,308,0,308
KARRATHA,2010,11,316,0,316
KARRATHA,2010,12,317,0,317
KARRATHA,2011,1,304,0,304
KARRATHA,2011,2,272,0,272
KARRATHA,2011,3,326,0,326
KARRATHA,2011,4,305,0,305
KARRATHA,2011,5,331,0,331
KARRATHA,2011,6,323,0,323
KARRATHA,2011,7,345,0,345
KARRATHA,2011,8,369,0,369
KARRATHA,2011,9,363,0,363
KARRATHA,2011,10,345,0,345
KARRATHA,2011,11,363,0,363
KARRATHA,2011,12,360,0,360
KARRATHA,2012,1,395,0,395
KARRATHA,2012,2,361,0,361
KARRATHA,2012,3,380,0,380
KARRATHA,2012,4,357,0,357
KARRATHA,2012,5,382,0,382
KARRATHA,2012,6,352,0,352
KARRATHA,2012,7,365,0,365
KARRATHA,2012,8,380,0,380
KARRATHA,2012,9,359,0,359
KARRATHA,2012,10,394,0,394
KARRATHA,2012,11,375,0,375
KARRATHA,2012,12,351,0,351
KARRATHA,2013,1,366,0,366
KARRATHA,2013,2,296,0,296
KARRATHA,2013,3,359,0,359
KARRATHA,2013,4,366,0,366
KARRATHA,2013,5,380,0,380
KARRATHA,2013,6,341,0,341
KARRATHA,2013,7,398,0,398
KARRATHA,2013,8,381,0,381
KARRATHA,2013,9,379,0,379
KARRATHA,2013,10,409,0,409
KARRATHA,2013,11,391,0,391
KARRATHA,2013,12,361,0,361
KARRATHA,2014,1,400,0,400
KARRATHA,2014,2,359,0,359
KARRATHA,2014,3,376,0,376
KARRATHA,2014,4,375,0,375
KARRATHA,2014,5,379,0,379
KARRATHA,2014,6,343,0,343
KARRATHA,2014,7,337,0,337
KARRATHA,2014,8,332,0,332
KARRATHA,2014,9,340,0,340
KARRATHA,2014,10,366,0,366
KARRATHA,2014,11,320,0,320
KARRATHA,2014,12,329,0,329
KARRATHA,2015,1,327,0,327
KARRATHA,2015,2,313,0,313
KARRATHA,2015,3,336,0,336
KARRATHA,2015,4,342,0,342
KARRATHA,2015,5,332,0,332
KARRATHA,2015,6,340,0,340
KARRATHA,2015,7,352,0,352
KARRATHA,2015,8,324,0,324
KARRATHA,2015,9,336,0,336
KARRATHA,2015,10,332,0,332
KARRATHA,2015,11,324,0,324
KARRATHA,2015,12,323,0,323
KARRATHA,2016,1,307,0,307
KARRATHA,2016,2,303,0,303
KARRATHA,2016,3,329,0,329
KARRATHA,2016,4,293,0,293
KARRATHA,2016,5,315,0,315
KARRATHA,2016,6,276,0,276
KARRATHA,2016,7,286,0,286
KARRATHA,2016,8,301,0,301
KARRATHA,2016,9,288,0,288
KARRATHA,2016,10,285,0,285
KARRATHA,2016,11,288,0,288
KARRATHA,2016,12,273,0,273
KARRATHA,2017,1,273,0,273
KARRATHA,2017,2,247,0,247
KARRATHA,2017,3,281,0,281
KARRATHA,2017,4,252,0,252
KARRATHA,2017,5,270,0,270
KARRATHA,2017,6,263,0,263
KARRATHA,2017,7,254,0,254
KARRATHA,2017,8,264,0,264
KARRATHA,2017,9,242,0,242
KARRATHA,2017,10,254,0,254
KARRATHA,2017,11,251,0,251
KARRATHA,2017,12,242,0,242
KARRATHA,2018,1,259,0,259
KARRATHA,2018,2,234,0,234
KARRATHA,2018,3,259,0,259
KARRATHA,2018,4,239,0,239
KARRATHA,2018,5,258,0,258
KARRATHA,2018,6,241,0,241
KARRATHA,2018,7,248,0,248
KARRATHA,2018,8,257,0,257
KARRATHA,2018,9,237,0,237
KARRATHA,2018,10,259,0,259
KARRATHA,2018,11,255,0,255
KARRATHA,2018,12,234,0,234
KARRATHA,2019,1,265,0,265
KARRATHA,2019,2,233,0,233
KARRATHA,2019,3,246,0,246
KARRATHA,2019,4,247,0,247
KARRATHA,2019,5,262,0,262
KARRATHA,2019,6,234,0,234
KARRATHA,2019,7,256,0,256
KARRATHA,2019,8,250,0,250
KARRATHA,2019,9,245,0,245
KARRATHA,2019,10,260,0,260
KARRATHA,2019,11,244,0,244
KARRATHA,2019,12,238,0,238
KARRATHA,2020,1,255,0,255
KARRATHA,2020,2,220,0,220
KARRATHA,2020,3,205,0,205
KARRATHA,2020,4,47,0,47
KARRATHA,2020,5,25,0,25
KARRATHA,2020,6,49,0,49
KARRATHA,2020,7,81,0,81
KARRATHA,2020,8,110,0,110
KARRATHA,2020,9,174,0,174
KARRATHA,2020,10,187,0,187
KARRATHA,2020,11,181,0,181
KARRATHA,2020,12,193,0,193
KARRATHA,2021,1,184,0,184
KARRATHA,2021,2,165,0,165
KARRATHA,2021,3,194,0,194
KARRATHA,2021,4,184,0,184
KARRATHA,2021,5,188,0,188
KARRATHA,2021,6,194,0,194
KARRATHA,2021,7,193,0,193
KARRATHA,2021,8,194,0,194
KARRATHA,2021,9,193,0,193
KARRATHA,2021,10,188,0,188
KARRATHA,2021,11,194,0,194
KARRATHA,2021,12,191,0,191
KARRATHA,2022,1,199,0,199
KARRATHA,2022,2,186,0,186
KARRATHA,2022,3,204,0,204
KARRATHA,2022,4,183,0,183
KARRATHA,2022,5,190,0,190
KARRATHA,2022,6,195,0,195
KARRATHA,2022,7,187,0,187
KARRATHA,2022,8,198,0,198
KARRATHA,2022,9,195,0,195
KARRATHA,2022,10,191,0,191
KARRATHA,2022,11,193,0,193
KARRATHA,2022,12,180,0,180
KARRATHA,2023,1,193,0,193
KARRATHA,2023,2,178,0,178
KARRATHA,2023,3,198,0,198
KARRATHA,2023,4,182,0,182
KARRATHA,2023,5,202,0,202
KARRATHA,2023,6,195,0,195
KARRATHA,2023,7,207,0,207
KARRATHA,2023,8,234,0,234
KARRATHA,2023,9,217,0,217
KARRATHA,2023,10,234,0,234
KARRATHA,2023,11,243,0,243
KARRATHA,2023,12,217,0,217
KARRATHA,2024,1,242,0,242
KARRATHA,2024,2,223,0,223
KARRATHA,2024,3,236,0,236
KARRATHA,2024,4,249,0,249
KARRATHA,2024,5,262,0,262
KARRATHA,2024,6,239,0,239
KARRATHA,2024,7,265,0,265
KARRATHA,2024,8,260,0,260
KARRATHA,2024,9,254,0,254
KARRATHA,2024,10,268,0,268
KARRATHA,2024,11,248,0,248
KARRATHA,2024,12,232,0,232
LAUNCESTON,1985,1,647,0,647
LAUNCESTON,1985,2,587,0,587
LAUNCESTON,1985,3,668,0,668
LAUNCESTON,1985,4,612,0,612
LAUNCESTON,1985,5,627,0,627
LAUNCESTON,1985,6,584,0,584
LAUNCESTON,1985,7,575,0,575
LAUNCESTON,1985,8,604,0,604
LAUNCESTON,1985,9,624,0,624
LAUNCESTON,1985,10,675,0,675
LAUNCESTON,1985,11,584,0,584
LAUNCESTON,1985,12,649,0,649
LAUNCESTON,1986,1,676,0,676
LAUNCESTON,1986,2,586,0,586
LAUNCESTON,1986,3,636,0,636
LAUNCESTON,1986,4,631,0,631
LAUNCESTON,1986,5,650,0,650
LAUNCESTON,1986,6,590,0,590
LAUNCESTON,1986,7,565,0,565
LAUNCESTON,1986,8,610,0,610
LAUNCESTON,1986,9,641,0,641
LAUNCESTON,1986,10,647,0,647
LAUNCESTON,1986,11,609,0,609
LAUNCESTON,1986,12,675,0,675
LAUNCESTON,1987,1,702,0,702
LAUNCESTON,1987,2,602,0,602
LAUNCESTON,1987,3,669,0,669
LAUNCESTON,1987,4,616,0,616
LAUNCESTON,1987,5,633,0,633
LAUNCESTON,1987,6,579,0,579
LAUNCESTON,1987,7,587,0,587
LAUNCESTON,1987,8,581,0,581
LAUNCESTON,1987,9,611,0,611
LAUNCESTON,1987,10,679,0,679
LAUNCESTON,1987,11,638,0,638
LAUNCESTON,1987,12,686,0,686
LAUNCESTON,1988,1,717,0,717
LAUNCESTON,1988,2,677,0,677
LAUNCESTON,1988,3,686,0,686
LAUNCESTON,1988,4,683,0,683
LAUNCESTON,1988,5,623,0,623
LAUNCESTON,1988,6,612,0,612
LAUNCESTON,1988,7,604,0,604
LAUNCESTON,1988,8,639,0,639
LAUNCESTON,1988,9,666,0,666
LAUNCESTON,1988,10,628,0,628
LAUNCESTON,1988,11,694,0,694
LAUNCESTON,1988,12,685,0,685
LAUNCESTON,1989,1,624,0,624
LAUNCESTON,1989,2,539,0,539
LAUNCESTON,1989,3,616,0,616
LAUNCESTON,1989,4,546,0,546
LAUNCESTON,1989,5,568,0,568
LAUNCESTON,1989,6,559,0,559
LAUNCESTON,1989,7,530,0,530
LAUNCESTON,1989,8,490,0,490
LAUNCESTON,1989,9,370,0,370
LAUNCESTON,1989,10,417,0,417
LAUNCESTON,1989,11,475,0,475
LAUNCESTON,1989,12,512,0,512
LAUNCESTON,1990,1,589,0,589
LAUNCESTON,1990,2,568,0,568
LAUNCESTON,1990,3,617,0,617
LAUNCESTON,1990,4,603,0,603
LAUNCESTON,1990,5,586,0,586
LAUNCESTON,1990,6,582,0,582
LAUNCESTON,1990,7,651,0,651
LAUNCESTON,1990,8,644,0,644
LAUNCESTON,1990,9,723,0,723
LAUNCESTON,1990,10,696,0,696
LAUNCESTON,1990,11,688,0,688
LAUNCESTON,1990,12,692,0,692
LAUNCESTON,1991,1,727,0,727
LAUNCESTON,1991,2,599,0,599
LAUNCESTON,1991,3,678,0,678
LAUNCESTON,1991,4,685,0,685
LAUNCESTON,1991,5,608,0,608
LAUNCESTON,1991,6,557,0,557
LAUNCESTON,1991,7,532,0,532
LAUNCESTON,1991,8,554,0,554
LAUNCESTON,1991,9,590,0,590
LAUNCESTON,1991,10,607,0,607
LAUNCESTON,1991,11,595,0,595
LAUNCESTON,1991,12,681,0,681
LAUNCESTON,1992,1,750,0,750
LAUNCESTON,1992,2,587,0,587
LAUNCESTON,1992,3,613,0,613
LAUNCESTON,1992,4,622,0,622
LAUNCESTON,1992,5,591,0,591
LAUNCESTON,1992,6,543,0,543
LAUNCESTON,1992,7,570,0,570
LAUNCESTON,1992,8,546,0,546
LAUNCESTON,1992,9,581,0,581
LAUNCESTON,1992,10,619,0,619
LAUNCESTON,1992,11,578,0,578
LAUNCESTON,1992,12,674,0,674
LAUNCESTON,1993,1,697,0,697
LAUNCESTON,1993,2,498,0,498
LAUNCESTON,1993,3,559,0,559
LAUNCESTON,1993,4,586,0,586
LAUNCESTON,1993,5,543,0,543
LAUNCESTON,1993,6,514,0,514
LAUNCESTON,1993,7,524,0,524
LAUNCESTON,1993,8,533,0,533
LAUNCESTON,1993,9,544,0,544
LAUNCESTON,1993,10,560,0,560
LAUNCESTON,1993,11,511,0,511
LAUNCESTON,1993,12,631,0,631
LAUNCESTON,1994,1,709,0,709
LAUNCESTON,1994,2,531,0,531
LAUNCESTON,1994,3,570,0,570
LAUNCESTON,1994,4,537,0,537
LAUNCESTON,1994,5,573,0,573
LAUNCESTON,1994,6,554,0,554
LAUNCESTON,1994,7,558,0,558
LAUNCESTON,1994,8,563,0,563
LAUNCESTON,1994,9,547,0,547
LAUNCESTON,1994,10,575,0,575
LAUNCESTON,1994,11,528,0,528
LAUNCESTON,1994,12,624,0,624
LAUNCESTON,1995,1,719,0,719
LAUNCESTON,1995,2,525,0,525
LAUNCESTON,1995,3,551,0,551
LAUNCESTON,1995,4,541,0,541
LAUNCESTON,1995,5,527,0,527
LAUNCESTON,1995,6,475,0,475
LAUNCESTON,1995,7,492,0,492
LAUNCESTON,1995,8,483,0,483
LAUNCESTON,1995,9,493,0,493
LAUNCESTON,1995,10,500,0,500
LAUNCESTON,1995,11,480,0,480
LAUNCESTON,1995,12,551,0,551
LAUNCESTON,1996,1,666,0,666
LAUNCESTON,1996,2,514,0,514
LAUNCESTON,1996,3,546,0,546
LAUNCESTON,1996,4,497,0,497
LAUNCESTON,1996,5,469,0,469
LAUNCESTON,1996,6,459,0,459
LAUNCESTON,1996,7,470,0,470
LAUNCESTON,1996,8,466,0,466
LAUNCESTON,1996,9,476,0,476
LAUNCESTON,1996,10,490,0,490
LAUNCESTON,1996,11,467,0,467
LAUNCESTON,1996,12,568,0,568
LAUNCESTON,1997,1,630,0,630
LAUNCESTON,1997,2,483,0,483
LAUNCESTON,1997,3,534,0,534
LAUNCESTON,1997,4,499,0,499
LAUNCESTON,1997,5,498,0,498
LAUNCESTON,1997,6,477,0,477
LAUNCESTON,1997,7,492,0,492
LAUNCESTON,1997,8,462,0,462
LAUNCESTON,1997,9,480,0,480
LAUNCESTON,1997,10,474,0,474
LAUNCESTON,1997,11,446,0,446
LAUNCESTON,1997,12,488,0,488
LAUNCESTON,1998,1,578,0,578
LAUNCESTON,1998,2,468,0,468
LAUNCESTON,1998,3,513,0,513
LAUNCESTON,1998,4,483,0,483
LAUNCESTON,1998,5,462,0,462
LAUNCESTON,1998,6,450,0,450
LAUNCESTON,1998,7,462,0,462
LAUNCESTON,1998,8,453,0,453
LAUNCESTON,1998,9,464,0,464
LAUNCESTON,1998,10,467,0,467
LAUNCESTON,1998,11,445,0,445
LAUNCESTON,1998,12,485,0,485
LAUNCESTON,1999,1,563,0,563
LAUNCESTON,1999,2,452,0,452
LAUNCESTON,1999,3,503,0,503
LAUNCESTON,1999,4,459,0,459
LAUNCESTON,1999,5,439,0,439
LAUNCESTON,1999,6,428,0,428
LAUNCESTON,1999,7,376,0,376
LAUNCESTON,1999,8,420,0,420
LAUNCESTON,1999,9,447,0,447
LAUNCESTON,1999,10,436,0,436
LAUNCESTON,1999,11,427,0,427
LAUNCESTON,1999,12,504,0,504
LAUNCESTON,2000,1,565,0,565
LAUNCESTON,2000,2,508,0,508
LAUNCESTON,2000,3,565,0,565
LAUNCESTON,2000,4,555,0,555
LAUNCESTON,2000,5,547,0,547
LAUNCESTON,2000,6,529,0,529
LAUNCESTON,2000,7,533,0,533
LAUNCESTON,2000,8,535,0,535
LAUNCESTON,2000,9,455,0,455
LAUNCESTON,2000,10,458,0,458
LAUNCESTON,2000,11,438,0,438
LAUNCESTON,2000,12,517,0,517
LAUNCESTON,2001,1,655,0,655
LAUNCESTON,2001,2,489,0,489
LAUNCESTON,2001,3,536,0,536
LAUNCESTON,2001,4,539,0,539
LAUNCESTON,2001,5,498,0,498
LAUNCESTON,2001,6,471,0,471
LAUNCESTON,2001,7,457,0,457
LAUNCESTON,2001,8,462,0,462
LAUNCESTON,2001,9,369,0,369
LAUNCESTON,2001,10,286,0,286
LAUNCESTON,2001,11,342,0,342
LAUNCESTON,2001,12,477,0,477
LAUNCESTON,2002,1,367,0,367
LAUNCESTON,2002,2,289,0,289
LAUNCESTON,2002,3,317,0,317
LAUNCESTON,2002,4,309,0,309
LAUNCESTON,2002,5,321,0,321
LAUNCESTON,2002,6,309,0,309
LAUNCESTON,2002,7,319,0,319
LAUNCESTON,2002,8,320,0,320
LAUNCESTON,2002,9,316,0,316
LAUNCESTON,2002,10,320,0,320
LAUNCESTON,2002,11,299,0,299
LAUNCESTON,2002,12,352,0,352
LAUNCESTON,2003,1,384,0,384
LAUNCESTON,2003,2,332,0,332
LAUNCESTON,2003,3,337,0,337
LAUNCESTON,2003,4,250,0,250
LAUNCESTON,2003,5,314,0,314
LAUNCESTON,2003,6,282,0,282
LAUNCESTON,2003,7,281,0,281
LAUNCESTON,2003,8,312,0,312
LAUNCESTON,2003,9,305,0,305
LAUNCESTON,2003,10,317,0,317
LAUNCESTON,2003,11,332,0,332
LAUNCESTON,2003,12,390,0,390
LAUNCESTON,2004,1,460,0,460
LAUNCESTON,2004,2,395,0,395
LAUNCESTON,2004,3,409,0,409
LAUNCESTON,2004,4,367,0,367
LAUNCESTON,2004,5,364,0,364
LAUNCESTON,2004,6,358,0,358
LAUNCESTON,2004,7,364,0,364
LAUNCESTON,2004,8,391,0,391
LAUNCESTON,2004,9,457,0,457
LAUNCESTON,2004,10,475,0,475
LAUNCESTON,2004,11,463,0,463
LAUNCESTON,2004,12,491,0,491
LAUNCESTON,2005,1,517,0,517
LAUNCESTON,2005,2,442,0,442
LAUNCESTON,2005,3,487,0,487
LAUNCESTON,2005,4,464,0,464
LAUNCESTON,2005,5,472,0,472
LAUNCESTON,2005,6,458,0,458
LAUNCESTON,2005,7,469,0,469
LAUNCESTON,2005,8,460,0,460
LAUNCESTON,2005,9,479,0,479
LAUNCESTON,2005,10,481,0,481
LAUNCESTON,2005,11,484,0,484
LAUNCESTON,2005,12,504,0,504
LAUNCESTON,2006,1,522,0,522
LAUNCESTON,2006,2,451,0,451
LAUNCESTON,2006,3,502,0,502
LAUNCESTON,2006,4,433,0,433
LAUNCESTON,2006,5,454,0,454
LAUNCESTON,2006,6,429,0,429
LAUNCESTON,2006,7,447,0,447
LAUNCESTON,2006,8,471,0,471
LAUNCESTON,2006,9,459,0,459
LAUNCESTON,2006,10,467,0,467
LAUNCESTON,2006,11,479,0,479
LAUNCESTON,2006,12,568,0,568
LAUNCESTON,2007,1,574,0,574
LAUNCESTON,2007,2,483,0,483
LAUNCESTON,2007,3,531,0,531
LAUNCESTON,2007,4,522,0,522
LAUNCESTON,2007,5,522,0,522
LAUNCESTON,2007,6,483,0,483
LAUNCESTON,2007,7,494,0,494
LAUNCESTON,2007,8,505,0,505
LAUNCESTON,2007,9,502,0,502
LAUNCESTON,2007,10,522,0,522
LAUNCESTON,2007,11,512,0,512
LAUNCESTON,2007,12,587,0,587
LAUNCESTON,2008,1,586,0,586
LAUNCESTON,2008,2,516,0,516
LAUNCESTON,2008,3,566,0,566
LAUNCESTON,2008,4,534,0,534
LAUNCESTON,2008,5,559,0,559
LAUNCESTON,2008,6,516,0,516
LAUNCESTON,2008,7,527,0,527
LAUNCESTON,2008,8,534,0,534
LAUNCESTON,2008,9,520,0,520
LAUNCESTON,2008,10,540,0,540
LAUNCESTON,2008,11,521,0,521
LAUNCESTON,2008,12,571,0,571
LAUNCESTON,2009,1,589,0,589
LAUNCESTON,2009,2,510,0,510
LAUNCESTON,2009,3,562,0,562
LAUNCESTON,2009,4,548,0,548
LAUNCESTON,2009,5,514,0,514
LAUNCESTON,2009,6,511,0,511
LAUNCESTON,2009,7,535,0,535
LAUNCESTON,2009,8,537,0,537
LAUNCESTON,2009,9,515,0,515
LAUNCESTON,2009,10,534,0,534
LAUNCESTON,2009,11,515,0,515
LAUNCESTON,2009,12,550,0,550
LAUNCESTON,2010,1,598,0,598
LAUNCESTON,2010,2,534,0,534
LAUNCESTON,2010,3,606,0,606
LAUNCESTON,2010,4,597,0,597
LAUNCESTON,2010,5,573,0,573
LAUNCESTON,2010,6,563,0,563
LAUNCESTON,2010,7,593,0,593
LAUNCESTON,2010,8,550,0,550
LAUNCESTON,2010,9,548,0,548
LAUNCESTON,2010,10,525,0,525
LAUNCESTON,2010,11,525,0,525
LAUNCESTON,2010,12,644,0,644
LAUNCESTON,2011,1,635,0,635
LAUNCESTON,2011,2,545,0,545
LAUNCESTON,2011,3,582,0,582
LAUNCESTON,2011,4,494,0,494
LAUNCESTON,2011,5,479,0,479
LAUNCESTON,2011,6,428,0,428
LAUNCESTON,2011,7,513,0,513
LAUNCESTON,2011,8,512,0,512
LAUNCESTON,2011,9,512,0,512
LAUNCESTON,2011,10,509,0,509
LAUNCESTON,2011,11,523,0,523
LAUNCESTON,2011,12,585,0,585
LAUNCESTON,2012,1,620,0,620
LAUNCESTON,2012,2,503,0,503
LAUNCESTON,2012,3,543,0,543
LAUNCESTON,2012,4,510,0,510
LAUNCESTON,2012,5,516,0,516
LAUNCESTON,2012,6,493,0,493
LAUNCESTON,2012,7,550,0,550
LAUNCESTON,2012,8,547,0,547
LAUNCESTON,2012,9,542,0,542
LAUNCESTON,2012,10,571,0,571
LAUNCESTON,2012,11,629,0,629
LAUNCESTON,2012,12,665,0,665
LAUNCESTON,2013,1,693,0,693
LAUNCESTON,2013,2,580,0,580
LAUNCESTON,2013,3,658,0,658
LAUNCESTON,2013,4,625,0,625
LAUNCESTON,2013,5,584,0,584
LAUNCESTON,2013,6,551,0,551
LAUNCESTON,2013,7,603,0,603
LAUNCESTON,2013,8,580,0,580
LAUNCESTON,2013,9,591,0,591
LAUNCESTON,2013,10,635,0,635
LAUNCESTON,2013,11,631,0,631
LAUNCESTON,2013,12,691,0,691
LAUNCESTON,2014,1,696,0,696
LAUNCESTON,2014,2,563,0,563
LAUNCESTON,2014,3,620,0,620
LAUNCESTON,2014,4,609,0,609
LAUNCESTON,2014,5,595,0,595
LAUNCESTON,2014,6,587,0,587
LAUNCESTON,2014,7,592,0,592
LAUNCESTON,2014,8,568,0,568
LAUNCESTON,2014,9,577,0,577
LAUNCESTON,2014,10,609,0,609
LAUNCESTON,2014,11,608,0,608
LAUNCESTON,2014,12,656,0,656
LAUNCESTON,2015,1,677,0,677
LAUNCESTON,2015,2,548,0,548
LAUNCESTON,2015,3,622,0,622
LAUNCESTON,2015,4,572,0,572
LAUNCESTON,2015,5,570,0,570
LAUNCESTON,2015,6,543,0,543
LAUNCESTON,2015,7,579,0,579
LAUNCESTON,2015,8,552,0,552
LAUNCESTON,2015,9,569,0,569
LAUNCESTON,2015,10,612,0,612
LAUNCESTON,2015,11,641,0,641
LAUNCESTON,2015,12,709,0,709
LAUNCESTON,2016,1,703,0,703
LAUNCESTON,2016,2,596,0,596
LAUNCESTON,2016,3,627,0,627
LAUNCESTON,2016,4,589,0,589
LAUNCESTON,2016,5,554,0,554
LAUNCESTON,2016,6,535,0,535
LAUNCESTON,2016,7,591,0,591
LAUNCESTON,2016,8,553,0,553
LAUNCESTON,2016,9,587,0,587
LAUNCESTON,2016,10,588,0,588
LAUNCESTON,2016,11,632,0,632
LAUNCESTON,2016,12,719,0,719
LAUNCESTON,2017,1,732,0,732
LAUNCESTON,2017,2,597,0,597
LAUNCESTON,2017,3,658,0,658
LAUNCESTON,2017,4,611,0,611
LAUNCESTON,2017,5,576,0,576
LAUNCESTON,2017,6,553,0,553
LAUNCESTON,2017,7,580,0,580
LAUNCESTON,2017,8,529,0,529
LAUNCESTON,2017,9,570,0,570
LAUNCESTON,2017,10,609,0,609
LAUNCESTON,2017,11,634,0,634
LAUNCESTON,2017,12,710,0,710
LAUNCESTON,2018,1,766,0,766
LAUNCESTON,2018,2,610,0,610
LAUNCESTON,2018,3,672,0,672
LAUNCESTON,2018,4,621,0,621
LAUNCESTON,2018,5,553,0,553
LAUNCESTON,2018,6,525,0,525
LAUNCESTON,2018,7,618,0,618
LAUNCESTON,2018,8,540,0,540
LAUNCESTON,2018,9,570,0,570
LAUNCESTON,2018,10,629,0,629
LAUNCESTON,2018,11,650,0,650
LAUNCESTON,2018,12,723,0,723
LAUNCESTON,2019,1,795,0,795
LAUNCESTON,2019,2,641,0,641
LAUNCESTON,2019,3,712,0,712
LAUNCESTON,2019,4,695,0,695
LAUNCESTON,2019,5,603,0,603
LAUNCESTON,2019,6,564,0,564
LAUNCESTON,2019,7,638,0,638
LAUNCESTON,2019,8,548,0,548
LAUNCESTON,2019,9,587,0,587
LAUNCESTON,2019,10,654,0,654
LAUNCESTON,2019,11,633,0,633
LAUNCESTON,2019,12,726,0,726
LAUNCESTON,2020,1,717,0,717
LAUNCESTON,2020,2,613,0,613
LAUNCESTON,2020,3,546,0,546
LAUNCESTON,2020,4,163,0,163
LAUNCESTON,2020,5,146,0,146
LAUNCESTON,2020,6,164,0,164
LAUNCESTON,2020,7,192,0,192
LAUNCESTON,2020,8,206,0,206
LAUNCESTON,2020,9,233,0,233
LAUNCESTON,2020,10,258,0,258
LAUNCESTON,2020,11,304,0,304
LAUNCESTON,2020,12,544,0,544
LAUNCESTON,2021,1,520,0,520
LAUNCESTON,2021,2,430,0,430
LAUNCESTON,2021,3,581,0,581
LAUNCESTON,2021,4,637,0,637
LAUNCESTON,2021,5,522,0,522
LAUNCESTON,2021,6,397,0,397
LAUNCESTON,2021,7,433,0,433
LAUNCESTON,2021,8,314,0,314
LAUNCESTON,2021,9,300,0,300
LAUNCESTON,2021,10,319,0,319
LAUNCESTON,2021,11,352,0,352
LAUNCESTON,2021,12,587,0,587
LAUNCESTON,2022,1,604,0,604
LAUNCESTON,2022,2,411,0,411
LAUNCESTON,2022,3,547,0,547
LAUNCESTON,2022,4,666,0,666
LAUNCESTON,2022,5,563,0,563
LAUNCESTON,2022,6,579,0,579
LAUNCESTON,2022,7,567,0,567
LAUNCESTON,2022,8,488,0,488
LAUNCESTON,2022,9,523,0,523
LAUNCESTON,2022,10,595,0,595
LAUNCESTON,2022,11,649,0,649
LAUNCESTON,2022,12,721,0,721
LAUNCESTON,2023,1,758,0,758
LAUNCESTON,2023,2,616,0,616
LAUNCESTON,2023,3,696,0,696
LAUNCESTON,2023,4,648,0,648
LAUNCESTON,2023,5,593,0,593
LAUNCESTON,2023,6,568,0,568
LAUNCESTON,2023,7,620,0,620
LAUNCESTON,2023,8,608,0,608
LAUNCESTON,2023,9,608,0,608
LAUNCESTON,2023,10,671,0,671
LAUNCESTON,2023,11,664,0,664
LAUNCESTON,2023,12,735,0,735
LAUNCESTON,2024,1,767,0,767
LAUNCESTON,2024,2,677,0,677
LAUNCESTON,2024,3,725,0,725
LAUNCESTON,2024,4,657,0,657
LAUNCESTON,2024,5,562,0,562
LAUNCESTON,2024,6,513,0,513
LAUNCESTON,2024,7,588,0,588
LAUNCESTON,2024,8,559,0,559
LAUNCESTON,2024,9,578,0,578
LAUNCESTON,2024,10,591,0,591
LAUNCESTON,2024,11,537,0,537
LAUNCESTON,2024,12,628,0,628
Mackay,1985,1,303,0,303
Mackay,1985,2,280,0,280
Mackay,1985,3,333,0,333
Mackay,1985,4,316,0,316
Mackay,1985,5,357,0,357
Mackay,1985,6,342,0,342
Mackay,1985,7,370,0,370
Mackay,1985,8,320,0,320
Mackay,1985,9,325,0,325
Mackay,1985,10,318,0,318
Mackay,1985,11,331,0,331
Mackay,1985,12,320,0,320
Mackay,1986,1,323,0,323
Mackay,1986,2,287,0,287
Mackay,1986,3,339,0,339
Mackay,1986,4,362,0,362
Mackay,1986,5,386,0,386
Mackay,1986,6,353,0,353
Mackay,1986,7,363,0,363
Mackay,1986,8,395,0,395
Mackay,1986,9,394,0,394
Mackay,1986,10,388,0,388
Mackay,1986,11,365,0,365
Mackay,1986,12,351,0,351
Mackay,1987,1,334,0,334
Mackay,1987,2,295,0,295
Mackay,1987,3,348,0,348
Mackay,1987,4,340,0,340
Mackay,1987,5,348,0,348
Mackay,1987,6,338,0,338
Mackay,1987,7,388,0,388
Mackay,1987,8,376,0,376
Mackay,1987,9,359,0,359
Mackay,1987,10,364,0,364
Mackay,1987,11,370,0,370
Mackay,1987,12,364,0,364
Mackay,1988,1,365,0,365
Mackay,1988,2,333,0,333
Mackay,1988,3,416,0,416
Mackay,1988,4,474,0,474
Mackay,1988,5,433,0,433
Mackay,1988,6,426,0,426
Mackay,1988,7,450,0,450
Mackay,1988,8,426,0,426
Mackay,1988,9,449,0,449
Mackay,1988,10,496,0,496
Mackay,1988,11,424,0,424
Mackay,1988,12,411,0,411
Mackay,1989,1,396,0,396
Mackay,1989,2,362,0,362
Mackay,1989,3,423,0,423
Mackay,1989,4,408,0,408
Mackay,1989,5,463,0,463
Mackay,1989,6,504,0,504
Mackay,1989,7,442,0,442
Mackay,1989,8,392,0,392
Mackay,1989,9,264,0,264
Mackay,1989,10,289,0,289
Mackay,1989,11,304,0,304
Mackay,1989,12,300,0,300
Mackay,1990,1,295,0,295
Mackay,1990,2,282,0,282
Mackay,1990,3,287,0,287
Mackay,1990,4,265,0,265
Mackay,1990,5,304,0,304
Mackay,1990,6,319,0,319
Mackay,1990,7,325,0,325
Mackay,1990,8,342,0,342
Mackay,1990,9,348,0,348
Mackay,1990,10,393,0,393
Mackay,1990,11,388,0,388
Mackay,1990,12,320,0,320
Mackay,1991,1,408,0,408
Mackay,1991,2,372,0,372
Mackay,1991,3,422,0,422
Mackay,1991,4,391,0,391
Mackay,1991,5,407,0,407
Mackay,1991,6,388,0,388
Mackay,1991,7,423,0,423
Mackay,1991,8,437,0,437
Mackay,1991,9,427,0,427
Mackay,1991,10,447,0,447
Mackay,1991,11,423,0,423
Mackay,1991,12,426,0,426
Mackay,1992,1,424,0,424
Mackay,1992,2,393,0,393
Mackay,1992,3,374,0,374
Mackay,1992,4,387,0,387
Mackay,1992,5,391,0,391
Mackay,1992,6,383,0,383
Mackay,1992,7,444,0,444
Mackay,1992,8,438,0,438
Mackay,1992,9,445,0,445
Mackay,1992,10,444,0,444
Mackay,1992,11,421,0,421
Mackay,1992,12,442,0,442
Mackay,1993,1,437,0,437
Mackay,1993,2,389,0,389
Mackay,1993,3,454,0,454
Mackay,1993,4,455,0,455
Mackay,1993,5,457,0,457
Mackay,1993,6,453,0,453
Mackay,1993,7,467,0,467
Mackay,1993,8,477,0,477
Mackay,1993,9,479,0,479
Mackay,1993,10,486,0,486
Mackay,1993,11,454,0,454
Mackay,1993,12,470,0,470
Mackay,1994,1,471,0,471
Mackay,1994,2,428,0,428
Mackay,1994,3,477,0,477
Mackay,1994,4,458,0,458
Mackay,1994,5,474,0,474
Mackay,1994,6,455,0,455
Mackay,1994,7,490,0,490
Mackay,1994,8,495,0,495
Mackay,1994,9,481,0,481
Mackay,1994,10,508,0,508
Mackay,1994,11,481,0,481
Mackay,1994,12,488,0,488
Mackay,1995,1,493,0,493
Mackay,1995,2,439,0,439
Mackay,1995,3,517,0,517
Mackay,1995,4,518,0,518
Mackay,1995,5,523,0,523
Mackay,1995,6,515,0,515
Mackay,1995,7,536,0,536
Mackay,1995,8,526,0,526
Mackay,1995,9,526,0,526
Mackay,1995,10,533,0,533
Mackay,1995,11,525,0,525
Mackay,1995,12,526,0,526
Mackay,1996,1,526,0,526
Mackay,1996,2,497,0,497
Mackay,1996,3,534,0,534
Mackay,1996,4,514,0,514
Mackay,1996,5,504,0,504
Mackay,1996,6,481,0,481
Mackay,1996,7,522,0,522
Mackay,1996,8,533,0,533
Mackay,1996,9,528,0,528
Mackay,1996,10,555,0,555
Mackay,1996,11,539,0,539
Mackay,1996,12,530,0,530
Mackay,1997,1,532,0,532
Mackay,1997,2,485,0,485
Mackay,1997,3,519,0,519
Mackay,1997,4,497,0,497
Mackay,1997,5,525,0,525
Mackay,1997,6,513,0,513
Mackay,1997,7,528,0,528
Mackay,1997,8,490,0,490
Mackay,1997,9,521,0,521
Mackay,1997,10,512,0,512
Mackay,1997,11,510,0,510
Mackay,1997,12,525,0,525
Mackay,1998,1,514,0,514
Mackay,1998,2,424,0,424
Mackay,1998,3,480,0,480
Mackay,1998,4,504,0,504
Mackay,1998,5,503,0,503
Mackay,1998,6,492,0,492
Mackay,1998,7,523,0,523
Mackay,1998,8,514,0,514
Mackay,1998,9,519,0,519
Mackay,1998,10,541,0,541
Mackay,1998,11,526,0,526
Mackay,1998,12,522,0,522
Mackay,1999,1,484,0,484
Mackay,1999,2,440,0,440
Mackay,1999,3,503,0,503
Mackay,1999,4,514,0,514
Mackay,1999,5,532,0,532
Mackay,1999,6,520,0,520
Mackay,1999,7,535,0,535
Mackay,1999,8,527,0,527
Mackay,1999,9,531,0,531
Mackay,1999,10,531,0,531
Mackay,1999,11,520,0,520
Mackay,1999,12,515,0,515
Mackay,2000,1,458,0,458
Mackay,2000,2,479,0,479
Mackay,2000,3,559,0,559
Mackay,2000,4,492,0,492
Mackay,2000,5,556,0,556
Mackay,2000,6,550,0,550
Mackay,2000,7,562,0,562
Mackay,2000,8,571,0,571
Mackay,2000,9,544,0,544
Mackay,2000,10,591,0,591
Mackay,2000,11,548,0,548
Mackay,2000,12,540,0,540
Mackay,2001,1,517,0,517
Mackay,2001,2,525,0,525
Mackay,2001,3,611,0,611
Mackay,2001,4,589,0,589
Mackay,2001,5,638,0,638
Mackay,2001,6,556,0,556
Mackay,2001,7,498,0,498
Mackay,2001,8,470,0,470
Mackay,2001,9,440,0,440
Mackay,2001,10,451,0,451
Mackay,2001,11,459,0,459
Mackay,2001,12,431,0,431
Mackay,2002,1,426,0,426
Mackay,2002,2,400,0,400
Mackay,2002,3,416,0,416
Mackay,2002,4,407,0,407
Mackay,2002,5,424,0,424
Mackay,2002,6,400,0,400
Mackay,2002,7,429,0,429
Mackay,2002,8,431,0,431
Mackay,2002,9,418,0,418
Mackay,2002,10,437,0,437
Mackay,2002,11,372,0,372
Mackay,2002,12,382,0,382
Mackay,2003,1,381,0,381
Mackay,2003,2,341,0,341
Mackay,2003,3,314,0,314
Mackay,2003,4,318,0,318
Mackay,2003,5,336,0,336
Mackay,2003,6,324,0,324
Mackay,2003,7,334,0,334
Mackay,2003,8,307,0,307
Mackay,2003,9,296,0,296
Mackay,2003,10,305,0,305
Mackay,2003,11,294,0,294
Mackay,2003,12,300,0,300
Mackay,2004,1,328,0,328
Mackay,2004,2,304,0,304
Mackay,2004,3,329,0,329
Mackay,2004,4,309,0,309
Mackay,2004,5,334,0,334
Mackay,2004,6,344,0,344
Mackay,2004,7,365,0,365
Mackay,2004,8,375,0,375
Mackay,2004,9,366,0,366
Mackay,2004,10,374,0,374
Mackay,2004,11,367,0,367
Mackay,2004,12,396,0,396
Mackay,2005,1,380,0,380
Mackay,2005,2,357,0,357
Mackay,2005,3,390,0,390
Mackay,2005,4,380,0,380
Mackay,2005,5,398,0,398
Mackay,2005,6,389,0,389
Mackay,2005,7,402,0,402
Mackay,2005,8,403,0,403
Mackay,2005,9,394,0,394
Mackay,2005,10,400,0,400
Mackay,2005,11,386,0,386
Mackay,2005,12,385,0,385
Mackay,2006,1,386,0,386
Mackay,2006,2,346,0,346
Mackay,2006,3,387,0,387
Mackay,2006,4,384,0,384
Mackay,2006,5,435,0,435
Mackay,2006,6,415,0,415
Mackay,2006,7,431,0,431
Mackay,2006,8,431,0,431
Mackay,2006,9,412,0,412
Mackay,2006,10,425,0,425
Mackay,2006,11,418,0,418
Mackay,2006,12,415,0,415
Mackay,2007,1,420,0,420
Mackay,2007,2,386,0,386
Mackay,2007,3,424,0,424
Mackay,2007,4,408,0,408
Mackay,2007,5,434,0,434
Mackay,2007,6,416,0,416
Mackay,2007,7,437,0,437
Mackay,2007,8,436,0,436
Mackay,2007,9,414,0,414
Mackay,2007,10,432,0,432
Mackay,2007,11,440,0,440
Mackay,2007,12,461,0,461
Mackay,2008,1,465,0,465
Mackay,2008,2,423,0,423
Mackay,2008,3,429,0,429
Mackay,2008,4,436,0,436
Mackay,2008,5,461,0,461
Mackay,2008,6,464,0,464
Mackay,2008,7,511,0,511
Mackay,2008,8,504,0,504
Mackay,2008,9,493,0,493
Mackay,2008,10,526,0,526
Mackay,2008,11,502,0,502
Mackay,2008,12,508,0,508
Mackay,2009,1,496,0,496
Mackay,2009,2,451,0,451
Mackay,2009,3,486,0,486
Mackay,2009,4,490,0,490
Mackay,2009,5,493,0,493
Mackay,2009,6,494,0,494
Mackay,2009,7,520,0,520
Mackay,2009,8,494,0,494
Mackay,2009,9,499,0,499
Mackay,2009,10,583,0,583
Mackay,2009,11,582,0,582
Mackay,2009,12,574,0,574
Mackay,2010,1,578,0,578
Mackay,2010,2,531,0,531
Mackay,2010,3,580,0,580
Mackay,2010,4,589,0,589
Mackay,2010,5,631,0,631
Mackay,2010,6,619,0,619
Mackay,2010,7,666,0,666
Mackay,2010,8,622,0,622
Mackay,2010,9,619,0,619
Mackay,2010,10,657,0,657
Mackay,2010,11,642,0,642
Mackay,2010,12,627,0,627
Mackay,2011,1,602,0,602
Mackay,2011,2,561,0,561
Mackay,2011,3,630,0,630
Mackay,2011,4,602,0,602
Mackay,2011,5,627,0,627
Mackay,2011,6,610,0,610
Mackay,2011,7,650,0,650
Mackay,2011,8,660,0,660
Mackay,2011,9,630,0,630
Mackay,2011,10,615,0,615
Mackay,2011,11,593,0,593
Mackay,2011,12,582,0,582
Mackay,2012,1,578,0,578
Mackay,2012,2,569,0,569
Mackay,2012,3,615,0,615
Mackay,2012,4,592,0,592
Mackay,2012,5,628,0,628
Mackay,2012,6,608,0,608
Mackay,2012,7,616,0,616
Mackay,2012,8,627,0,627
Mackay,2012,9,599,0,599
Mackay,2012,10,630,0,630
Mackay,2012,11,593,0,593
Mackay,2012,12,601,0,601
Mackay,2013,1,639,0,639
Mackay,2013,2,590,0,590
Mackay,2013,3,637,0,637
Mackay,2013,4,639,0,639
Mackay,2013,5,646,0,646
Mackay,2013,6,618,0,618
Mackay,2013,7,664,0,664
Mackay,2013,8,651,0,651
Mackay,2013,9,631,0,631
Mackay,2013,10,661,0,661
Mackay,2013,11,594,0,594
Mackay,2013,12,594,0,594
Mackay,2014,1,575,0,575
Mackay,2014,2,514,0,514
Mackay,2014,3,580,0,580
Mackay,2014,4,543,0,543
Mackay,2014,5,547,0,547
Mackay,2014,6,541,0,541
Mackay,2014,7,598,0,598
Mackay,2014,8,597,0,597
Mackay,2014,9,576,0,576
Mackay,2014,10,608,0,608
Mackay,2014,11,573,0,573
Mackay,2014,12,576,0,576
Mackay,2015,1,563,0,563
Mackay,2015,2,521,0,521
Mackay,2015,3,583,0,583
Mackay,2015,4,525,0,525
Mackay,2015,5,541,0,541
Mackay,2015,6,514,0,514
Mackay,2015,7,543,0,543
Mackay,2015,8,533,0,533
Mackay,2015,9,490,0,490
Mackay,2015,10,498,0,498
Mackay,2015,11,489,0,489
Mackay,2015,12,477,0,477
Mackay,2016,1,475,0,475
Mackay,2016,2,461,0,461
Mackay,2016,3,493,0,493
Mackay,2016,4,475,0,475
Mackay,2016,5,484,0,484
Mackay,2016,6,464,0,464
Mackay,2016,7,491,0,491
Mackay,2016,8,506,0,506
Mackay,2016,9,480,0,480
Mackay,2016,10,486,0,486
Mackay,2016,11,451,0,451
Mackay,2016,12,447,0,447
Mackay,2017,1,425,0,425
Mackay,2017,2,401,0,401
Mackay,2017,3,395,0,395
Mackay,2017,4,411,0,411
Mackay,2017,5,435,0,435
Mackay,2017,6,419,0,419
Mackay,2017,7,433,0,433
Mackay,2017,8,444,0,444
Mackay,2017,9,434,0,434
Mackay,2017,10,440,0,440
Mackay,2017,11,416,0,416
Mackay,2017,12,409,0,409
Mackay,2018,1,426,0,426
Mackay,2018,2,381,0,381
Mackay,2018,3,427,0,427
Mackay,2018,4,415,0,415
Mackay,2018,5,441,0,441
Mackay,2018,6,419,0,419
Mackay,2018,7,463,0,463
Mackay,2018,8,448,0,448
Mackay,2018,9,419,0,419
Mackay,2018,10,443,0,443
Mackay,2018,11,438,0,438
Mackay,2018,12,437,0,437
Mackay,2019,1,455,0,455
Mackay,2019,2,417,0,417
Mackay,2019,3,450,0,450
Mackay,2019,4,455,0,455
Mackay,2019,5,488,0,488
Mackay,2019,6,456,0,456
Mackay,2019,7,481,0,481
Mackay,2019,8,469,0,469
Mackay,2019,9,476,0,476
Mackay,2019,10,492,0,492
Mackay,2019,11,462,0,462
Mackay,2019,12,460,0,460
Mackay,2020,1,453,0,453
Mackay,2020,2,443,0,443
Mackay,2020,3,419,0,419
Mackay,2020,4,157,0,157
Mackay,2020,5,107,0,107
Mackay,2020,6,158,0,158
Mackay,2020,7,226,0,226
Mackay,2020,8,258,0,258
Mackay,2020,9,275,0,275
Mackay,2020,10,304,0,304
Mackay,2020,11,332,0,332
Mackay,2020,12,355,0,355
Mackay,2021,1,352,0,352
Mackay,2021,2,337,0,337
Mackay,2021,3,399,0,399
Mackay,2021,4,359,0,359
Mackay,2021,5,379,0,379
Mackay,2021,6,391,0,391
Mackay,2021,7,402,0,402
Mackay,2021,8,303,0,303
Mackay,2021,9,384,0,384
Mackay,2021,10,385,0,385
Mackay,2021,11,407,0,407
Mackay,2021,12,434,0,434
Mackay,2022,1,370,0,370
Mackay,2022,2,316,0,316
Mackay,2022,3,430,0,430
Mackay,2022,4,412,0,412
Mackay,2022,5,451,0,451
Mackay,2022,6,439,0,439
Mackay,2022,7,417,0,417
Mackay,2022,8,428,0,428
Mackay,2022,9,414,0,414
Mackay,2022,10,436,0,436
Mackay,2022,11,443,0,443
Mackay,2022,12,441,0,441
Mackay,2023,1,434,0,434
Mackay,2023,2,411,0,411
Mackay,2023,3,456,0,456
Mackay,2023,4,429,0,429
Mackay,2023,5,461,0,461
Mackay,2023,6,444,0,444
Mackay,2023,7,450,0,450
Mackay,2023,8,462,0,462
Mackay,2023,9,438,0,438
Mackay,2023,10,463,0,463
Mackay,2023,11,504,0,504
Mackay,2023,12,492,0,492
Mackay,2024,1,451,0,451
Mackay,2024,2,441,0,441
Mackay,2024,3,498,0,498
Mackay,2024,4,424,0,424
Mackay,2024,5,434,0,434
Mackay,2024,6,408,0,408
Mackay,2024,7,452,0,452
Mackay,2024,8,433,0,433
Mackay,2024,9,437,0,437
Mackay,2024,10,477,0,477
Mackay,2024,11,429,0,429
Mackay,2024,12,412,0,412
Melbourne,1985,1,2938,468,3406
Melbourne,1985,2,2649,433,3082
Melbourne,1985,3,3010,476,3486
Melbourne,1985,4,2891,459,3350
Melbourne,1985,5,3188,472,3660
Melbourne,1985,6,2849,456,3305
Melbourne,1985,7,2927,455,3382
Melbourne,1985,8,3192,472,3664
Melbourne,1985,9,3268,465,3733
Melbourne,1985,10,3293,473,3766
Melbourne,1985,11,3135,488,3623
Melbourne,1985,12,3192,505,3697
Melbourne,1986,1,3109,510,3619
Melbourne,1986,2,2809,434,3243
Melbourne,1986,3,3043,470,3513
Melbourne,1986,4,3115,505,3620
Melbourne,1986,5,3248,528,3776
Melbourne,1986,6,2987,537,3524
Melbourne,1986,7,2948,547,3495
Melbourne,1986,8,3189,566,3755
Melbourne,1986,9,3174,500,3674
Melbourne,1986,10,3113,565,3678
Melbourne,1986,11,3108,576,3684
Melbourne,1986,12,3227,591,3818
Melbourne,1987,1,3232,590,3822
Melbourne,1987,2,2887,540,3427
Melbourne,1987,3,3257,589,3846
Melbourne,1987,4,3207,542,3749
Melbourne,1987,5,3095,564,3659
Melbourne,1987,6,3013,541,3554
Melbourne,1987,7,3286,572,3858
Melbourne,1987,8,3181,582,3763
Melbourne,1987,9,3383,554,3937
Melbourne,1987,10,3428,542,3970
Melbourne,1987,11,3244,559,3803
Melbourne,1987,12,3415,597,4012
Melbourne,1988,1,3224,609,3833
Melbourne,1988,2,3038,549,3587
Melbourne,1988,3,3435,572,4007
Melbourne,1988,4,3200,558,3758
Melbourne,1988,5,3317,564,3881
Melbourne,1988,6,3233,542,3775
Melbourne,1988,7,3245,556,3801
Melbourne,1988,8,3444,572,4016
Melbourne,1988,9,3508,547,4055
Melbourne,1988,10,3455,610,4065
Melbourne,1988,11,3410,591,4001
Melbourne,1988,12,3324,632,3956
Melbourne,1989,1,3215,641,3856
Melbourne,1989,2,3088,576,3664
Melbourne,1989,3,3566,612,4178
Melbourne,1989,4,3271,587,3858
Melbourne,1989,5,3512,599,4111
Melbourne,1989,6,3461,573,4034
Melbourne,1989,7,3583,575,4158
Melbourne,1989,8,2615,597,3212
Melbourne,1989,9,1132,595,1727
Melbourne,1989,10,1651,622,2273
Melbourne,1989,11,2222,639,2861
Melbourne,1989,12,2495,671,3166
Melbourne,1990,1,2925,662,3587
Melbourne,1990,2,2794,608,3402
Melbourne,1990,3,3158,668,3826
Melbourne,1990,4,3126,647,3773
Melbourne,1990,5,3332,663,3995
Melbourne,1990,6,3165,650,3815
Melbourne,1990,7,3460,681,4141
Melbourne,1990,8,3399,685,4084
Melbourne,1990,9,3324,663,3987
Melbourne,1990,10,3610,684,4294
Melbourne,1990,11,3625,666,4291
Melbourne,1990,12,3788,698,4486
Melbourne,1991,1,3642,692,4334
Melbourne,1991,2,3396,631,4027
Melbourne,1991,3,3754,703,4457
Melbourne,1991,4,3582,608,4190
Melbourne,1991,5,3750,610,4360
Melbourne,1991,6,3675,605,4280
Melbourne,1991,7,4126,625,4751
Melbourne,1991,8,4048,613,4661
Melbourne,1991,9,3927,597,4524
Melbourne,1991,10,4116,626,4742
Melbourne,1991,11,4045,621,4666
Melbourne,1991,12,4121,648,4769
Melbourne,1992,1,3968,651,4619
Melbourne,1992,2,3606,616,4222
Melbourne,1992,3,3946,678,4624
Melbourne,1992,4,3927,621,4548
Melbourne,1992,5,3994,657,4651
Melbourne,1992,6,3889,622,4511
Melbourne,1992,7,4213,611,4824
Melbourne,1992,8,4129,662,4791
Melbourne,1992,9,4528,640,5168
Melbourne,1992,10,4638,683,5321
Melbourne,1992,11,4447,660,5107
Melbourne,1992,12,4518,714,5232
Melbourne,1993,1,4427,704,5131
Melbourne,1993,2,4128,656,4784
Melbourne,1993,3,4330,710,5040
Melbourne,1993,4,4225,667,4892
Melbourne,1993,5,4247,684,4931
Melbourne,1993,6,4100,660,4760
Melbourne,1993,7,4405,681,5086
Melbourne,1993,8,4278,669,4947
Melbourne,1993,9,4264,660,4924
Melbourne,1993,10,4309,687,4996
Melbourne,1993,11,4183,646,4829
Melbourne,1993,12,4273,668,4941
Melbourne,1994,1,4170,664,4834
Melbourne,1994,2,3925,583,4508
Melbourne,1994,3,4495,639,5134
Melbourne,1994,4,4314,586,4900
Melbourne,1994,5,4493,601,5094
Melbourne,1994,6,4399,598,4997
Melbourne,1994,7,4683,621,5304
Melbourne,1994,8,4654,608,5262
Melbourne,1994,9,4598,589,5187
Melbourne,1994,10,4678,607,5285
Melbourne,1994,11,4608,599,5207
Melbourne,1994,12,4768,631,5399
Melbourne,1995,1,4600,623,5223
Melbourne,1995,2,4369,575,4944
Melbourne,1995,3,4835,633,5468
Melbourne,1995,4,4717,615,5332
Melbourne,1995,5,4878,634,5512
Melbourne,1995,6,4745,611,5356
Melbourne,1995,7,4893,638,5531
Melbourne,1995,8,4825,639,5464
Melbourne,1995,9,4771,625,5396
Melbourne,1995,10,4991,645,5636
Melbourne,1995,11,4856,628,5484
Melbourne,1995,12,4842,654,5496
Melbourne,1996,1,4913,661,5574
Melbourne,1996,2,4728,627,5355
Melbourne,1996,3,5034,657,5691
Melbourne,1996,4,4759,644,5403
Melbourne,1996,5,4960,651,5611
Melbourne,1996,6,4770,638,5408
Melbourne,1996,7,5067,683,5750
Melbourne,1996,8,5067,687,5754
Melbourne,1996,9,5028,690,5718
Melbourne,1996,10,5150,715,5865
Melbourne,1996,11,4837,738,5575
Melbourne,1996,12,4903,767,5670
Melbourne,1997,1,4927,760,5687
Melbourne,1997,2,4584,689,5273
Melbourne,1997,3,5049,774,5823
Melbourne,1997,4,4976,713,5689
Melbourne,1997,5,4917,722,5639
Melbourne,1997,6,4813,707,5520
Melbourne,1997,7,5242,749,5991
Melbourne,1997,8,5093,726,5819
Melbourne,1997,9,5084,691,5775
Melbourne,1997,10,5257,728,5985
Melbourne,1997,11,4917,732,5649
Melbourne,1997,12,4913,762,5675
Melbourne,1998,1,4939,754,5693
Melbourne,1998,2,4614,683,5297
Melbourne,1998,3,5176,751,5927
Melbourne,1998,4,4940,727,5667
Melbourne,1998,5,5033,762,5795
Melbourne,1998,6,4933,730,5663
Melbourne,1998,7,5266,758,6024
Melbourne,1998,8,5145,753,5898
Melbourne,1998,9,5186,746,5932
Melbourne,1998,10,5308,777,6085
Melbourne,1998,11,5048,749,5797
Melbourne,1998,12,5101,762,5863
Melbourne,1999,1,4988,762,5750
Melbourne,1999,2,4707,699,5406
Melbourne,1999,3,5298,787,6085
Melbourne,1999,4,5123,781,5904
Melbourne,1999,5,5200,795,5995
Melbourne,1999,6,5070,780,5850
Melbourne,1999,7,5389,812,6201
Melbourne,1999,8,5361,806,6167
Melbourne,1999,9,5357,780,6137
Melbourne,1999,10,5463,818,6281
Melbourne,1999,11,5208,832,6040
Melbourne,1999,12,5339,878,6217
Melbourne,2000,1,5230,896,6126
Melbourne,2000,2,5093,852,5945
Melbourne,2000,3,5656,904,6560
Melbourne,2000,4,5434,884,6318
Melbourne,2000,5,5652,885,6537
Melbourne,2000,6,5774,856,6630
Melbourne,2000,7,6017,917,6934
Melbourne,2000,8,6151,910,7061
Melbourne,2000,9,6120,898,7018
Melbourne,2000,10,6369,920,7289
Melbourne,2000,11,6209,930,7139
Melbourne,2000,12,6283,1006,7289
Melbourne,2001,1,6369,1027,7396
Melbourne,2001,2,6076,923,6999
Melbourne,2001,3,6896,1018,7914
Melbourne,2001,4,6582,997,7579
Melbourne,2001,5,6565,981,7546
Melbourne,2001,6,6138,963,7101
Melbourne,2001,7,6469,992,7461
Melbourne,2001,8,6488,1000,7488
Melbourne,2001,9,4749,943,5692
Melbourne,2001,10,4769,982,5751
Melbourne,2001,11,5024,927,5951
Melbourne,2001,12,5295,1012,6307
Melbourne,2002,1,5168,1002,6170
Melbourne,2002,2,4800,891,5691
Melbourne,2002,3,4806,991,5797
Melbourne,2002,4,4788,843,5631
Melbourne,2002,5,5016,857,5873
Melbourne,2002,6,4889,820,5709
Melbourne,2002,7,5285,907,6192
Melbourne,2002,8,5227,899,6126
Melbourne,2002,9,5368,875,6243
Melbourne,2002,10,5620,897,6517
Melbourne,2002,11,5223,875,6098
Melbourne,2002,12,5331,925,6256
Melbourne,2003,1,5274,915,6189
Melbourne,2003,2,4812,825,5637
Melbourne,2003,3,5289,917,6206
Melbourne,2003,4,5099,854,5953
Melbourne,2003,5,5298,809,6107
Melbourne,2003,6,5060,768,5828
Melbourne,2003,7,5236,845,6081
Melbourne,2003,8,5167,883,6050
Melbourne,2003,9,5412,901,6313
Melbourne,2003,10,5534,940,6474
Melbourne,2003,11,5411,971,6382
Melbourne,2003,12,5622,1027,6649
Melbourne,2004,1,5714,1050,6764
Melbourne,2004,2,5445,969,6414
Melbourne,2004,3,5919,1050,6969
Melbourne,2004,4,5674,1058,6732
Melbourne,2004,5,5904,1083,6987
Melbourne,2004,6,5941,1054,6995
Melbourne,2004,7,6186,1148,7334
Melbourne,2004,8,6246,1178,7424
Melbourne,2004,9,6209,1166,7375
Melbourne,2004,10,6277,1206,7483
Melbourne,2004,11,6224,1159,7383
Melbourne,2004,12,6349,1225,7574
Melbourne,2005,1,6138,1218,7356
Melbourne,2005,2,5712,1087,6799
Melbourne,2005,3,6335,1164,7499
Melbourne,2005,4,6108,1104,7212
Melbourne,2005,5,6270,1125,7395
Melbourne,2005,6,6128,1084,7212
Melbourne,2005,7,6294,1140,7434
Melbourne,2005,8,6380,1108,7488
Melbourne,2005,9,6335,1083,7418
Melbourne,2005,10,6356,1107,7463
Melbourne,2005,11,6192,1061,7253
Melbourne,2005,12,6370,1105,7475
Melbourne,2006,1,6137,1101,7238
Melbourne,2006,2,5870,994,6864
Melbourne,2006,3,6561,1060,7621
Melbourne,2006,4,6081,953,7034
Melbourne,2006,5,6391,960,7351
Melbourne,2006,6,6170,940,7110
Melbourne,2006,7,6405,982,7387
Melbourne,2006,8,6423,983,7406
Melbourne,2006,9,6383,963,7346
Melbourne,2006,10,6597,969,7566
Melbourne,2006,11,6415,1003,7418
Melbourne,2006,12,6471,1056,7527
Melbourne,2007,1,6241,1056,7297
Melbourne,2007,2,5896,968,6864
Melbourne,2007,3,6575,1048,7623
Melbourne,2007,4,6173,967,7140
Melbourne,2007,5,6484,985,7469
Melbourne,2007,6,6204,958,7162
Melbourne,2007,7,6456,999,7455
Melbourne,2007,8,6566,997,7563
Melbourne,2007,9,6403,977,7380
Melbourne,2007,10,6683,1025,7708
Melbourne,2007,11,6592,1049,7641
Melbourne,2007,12,6807,1075,7882
Melbourne,2008,1,6862,1074,7936
Melbourne,2008,2,6677,999,7676
Melbourne,2008,3,7110,1063,8173
Melbourne,2008,4,6951,1046,7997
Melbourne,2008,5,7096,1081,8177
Melbourne,2008,6,6704,1043,7747
Melbourne,2008,7,6996,1094,8090
Melbourne,2008,8,6875,1068,7943
Melbourne,2008,9,6937,1046,7983
Melbourne,2008,10,7265,1096,8361
Melbourne,2008,11,6955,1096,8051
Melbourne,2008,12,6909,1215,8124
Melbourne,2009,1,6720,1220,7940
Melbourne,2009,2,6058,1072,7130
Melbourne,2009,3,6831,1196,8027
Melbourne,2009,4,6660,1160,7820
Melbourne,2009,5,6456,1147,7603
Melbourne,2009,6,6291,1178,7469
Melbourne,2009,7,6721,1255,7976
Melbourne,2009,8,6497,1248,7745
Melbourne,2009,9,6499,1201,7700
Melbourne,2009,10,6863,1247,8110
Melbourne,2009,11,6723,1238,7961
Melbourne,2009,12,6753,1343,8096
Melbourne,2010,1,6750,1364,8114
Melbourne,2010,2,6419,1236,7655
Melbourne,2010,3,7311,1336,8647
Melbourne,2010,4,7199,1233,8432
Melbourne,2010,5,7248,1275,8523
Melbourne,2010,6,7000,1275,8275
Melbourne,2010,7,7525,1359,8884
Melbourne,2010,8,7344,1350,8694
Melbourne,2010,9,7291,1330,8621
Melbourne,2010,10,7510,1371,8881
Melbourne,2010,11,7242,1331,8573
Melbourne,2010,12,7633,1480,9113
Melbourne,2011,1,7445,1511,8956
Melbourne,2011,2,6501,1321,7822
Melbourne,2011,3,7438,1408,8846
Melbourne,2011,4,7181,1378,8559
Melbourne,2011,5,7276,1383,8659
Melbourne,2011,6,6647,1273,7920
Melbourne,2011,7,7036,1435,8471
Melbourne,2011,8,7105,1410,8515
Melbourne,2011,9,7007,1368,8375
Melbourne,2011,10,7141,1412,8553
Melbourne,2011,11,7087,1424,8511
Melbourne,2011,12,7333,1547,8880
Melbourne,2012,1,7194,1579,8773
Melbourne,2012,2,6989,1382,8371
Melbourne,2012,3,7564,1471,9035
Melbourne,2012,4,7266,1447,8713
Melbourne,2012,5,7246,1408,8654
Melbourne,2012,6,6896,1400,8296
Melbourne,2012,7,7736,1501,9237
Melbourne,2012,8,7636,1498,9134
Melbourne,2012,9,7535,1456,8991
Melbourne,2012,10,7776,1511,9287
Melbourne,2012,11,7660,1458,9118
Melbourne,2012,12,7549,1580,9129
Melbourne,2013,1,7458,1593,9051
Melbourne,2013,2,6770,1347,8117
Melbourne,2013,3,7669,1528,9197
Melbourne,2013,4,7502,1495,8997
Melbourne,2013,5,7422,1493,8915
Melbourne,2013,6,7129,1467,8596
Melbourne,2013,7,7892,1616,9508
Melbourne,2013,8,7688,1604,9292
Melbourne,2013,9,7685,1575,9260
Melbourne,2013,10,7972,1655,9627
Melbourne,2013,11,7629,1580,9209
Melbourne,2013,12,7793,1769,9562
Melbourne,2014,1,7623,1787,9410
Melbourne,2014,2,6934,1503,8437
Melbourne,2014,3,7768,1659,9427
Melbourne,2014,4,7627,1649,9276
Melbourne,2014,5,7697,1629,9326
Melbourne,2014,6,7488,1634,9122
Melbourne,2014,7,7978,1775,9753
Melbourne,2014,8,7773,1719,9492
Melbourne,2014,9,7812,1673,9485
Melbourne,2014,10,8173,1705,9878
Melbourne,2014,11,7642,1640,9282
Melbourne,2014,12,7934,1859,9793
Melbourne,2015,1,7753,1894,9647
Melbourne,2015,2,7103,1603,8706
Melbourne,2015,3,8045,1749,9794
Melbourne,2015,4,7842,1724,9566
Melbourne,2015,5,7833,1648,9481
Melbourne,2015,6,7731,1659,9390
Melbourne,2015,7,8303,1810,10113
Melbourne,2015,8,8071,1762,9833
Melbourne,2015,9,8053,1729,9782
Melbourne,2015,10,8300,1813,10113
Melbourne,2015,11,7946,1749,9695
Melbourne,2015,12,8135,2010,10145
Melbourne,2016,1,7868,2049,9917
Melbourne,2016,2,7557,1784,9341
Melbourne,2016,3,8137,1876,10013
Melbourne,2016,4,7889,1792,9681
Melbourne,2016,5,7730,1768,9498
Melbourne,2016,6,7541,1754,9295
Melbourne,2016,7,8332,1908,10240
Melbourne,2016,8,8182,1825,10007
Melbourne,2016,9,8231,1779,10010
Melbourne,2016,10,8264,1864,10128
Melbourne,2016,11,7991,1820,9811
Melbourne,2016,12,8194,2105,10299
Melbourne,2017,1,7998,2130,10128
Melbourne,2017,2,7284,1790,9074
Melbourne,2017,3,8175,1884,10059
Melbourne,2017,4,7815,1883,9698
Melbourne,2017,5,7831,1784,9615
Melbourne,2017,6,7649,1826,9475
Melbourne,2017,7,8303,2042,10345
Melbourne,2017,8,8122,1914,10036
Melbourne,2017,9,8070,1932,10002
Melbourne,2017,10,8363,2017,10380
Melbourne,2017,11,8136,1977,10113
Melbourne,2017,12,8216,2260,10476
Melbourne,2018,1,8104,2306,10410
Melbourne,2018,2,7349,1975,9324
Melbourne,2018,3,8277,2125,10402
Melbourne,2018,4,7980,2082,10062
Melbourne,2018,5,7827,2007,9834
Melbourne,2018,6,7499,2076,9575
Melbourne,2018,7,8235,2276,10511
Melbourne,2018,8,7980,2183,10163
Melbourne,2018,9,7935,2149,10084
Melbourne,2018,10,8451,2216,10667
Melbourne,2018,11,7977,2191,10168
Melbourne,2018,12,8004,2351,10355
Melbourne,2019,1,8120,2374,10494
Melbourne,2019,2,7317,2062,9379
Melbourne,2019,3,8141,2175,10316
Melbourne,2019,4,8013,2132,10145
Melbourne,2019,5,7893,2030,9923
Melbourne,2019,6,7555,2076,9631
Melbourne,2019,7,8354,2242,10596
Melbourne,2019,8,7930,2137,10067
Melbourne,2019,9,7957,2071,10028
Melbourne,2019,10,8428,2135,10563
Melbourne,2019,11,7887,2158,10045
Melbourne,2019,12,8093,2398,10491
Melbourne,2020,1,7773,2454,10227
Melbourne,2020,2,7275,1904,9179
Melbourne,2020,3,6209,1464,7673
Melbourne,2020,4,827,290,1117
Melbourne,2020,5,736,378,1114
Melbourne,2020,6,993,332,1325
Melbourne,2020,7,913,359,1272
Melbourne,2020,8,559,369,928
Melbourne,2020,9,652,381,1033
Melbourne,2020,10,658,404,1062
Melbourne,2020,11,984,429,1413
Melbourne,2020,12,3592,464,4056
Melbourne,2021,1,3207,435,3642
Melbourne,2021,2,2609,363,2972
Melbourne,2021,3,4562,425,4987
Melbourne,2021,4,6282,505,6787
Melbourne,2021,5,6138,617,6755
Melbourne,2021,6,2895,513,3408
Melbourne,2021,7,2958,602,3560
Melbourne,2021,8,1195,499,1694
Melbourne,2021,9,999,507,1506
Melbourne,2021,10,994,538,1532
Melbourne,2021,11,2167,580,2747
Melbourne,2021,12,5415,712,6127
Melbourne,2022,1,5453,718,6171
Melbourne,2022,2,4532,694,5226
Melbourne,2022,3,6483,836,7319
Melbourne,2022,4,7727,964,8691
Melbourne,2022,5,7595,1061,8656
Melbourne,2022,6,7354,1172,8526
Melbourne,2022,7,7134,1393,8527
Melbourne,2022,8,6986,1376,8362
Melbourne,2022,9,7067,1378,8445
Melbourne,2022,10,7205,1456,8661
Melbourne,2022,11,7179,1616,8795
Melbourne,2022,12,7460,1935,9395
Melbourne,2023,1,7537,2016,9553
Melbourne,2023,2,6699,1746,8445
Melbourne,2023,3,7714,1931,9645
Melbourne,2023,4,7597,2035,9632
Melbourne,2023,5,7805,1963,9768
Melbourne,2023,6,7438,2028,9466
Melbourne,2023,7,7724,2228,9952
Melbourne,2023,8,7861,2152,10013
Melbourne,2023,9,7692,2164,9856
Melbourne,2023,10,7957,2194,10151
Melbourne,2023,11,7647,2178,9825
Melbourne,2023,12,7768,2534,10302
Melbourne,2024,1,8040,2606,10646
Melbourne,2024,2,7481,2260,9741
Melbourne,2024,3,8009,2343,10352
Melbourne,2024,4,7980,2211,10191
Melbourne,2024,5,7693,2138,9831
Melbourne,2024,6,7350,2166,9516
Melbourne,2024,7,7901,2358,10259
Melbourne,2024,8,7259,2306,9565
Melbourne,2024,9,7494,2245,9739
Melbourne,2024,10,7693,2289,9982
Melbourne,2024,11,7180,2305,9485
Melbourne,2024,12,7430,2746,10176
Newcastle,1985,1,413,0,413
Newcastle,1985,2,417,0,417
Newcastle,1985,3,451,0,451
Newcastle,1985,4,419,0,419
Newcastle,1985,5,458,0,458
Newcastle,1985,6,418,0,418
Newcastle,1985,7,415,0,415
Newcastle,1985,8,436,0,436
Newcastle,1985,9,444,0,444
Newcastle,1985,10,475,0,475
Newcastle,1985,11,450,0,450
Newcastle,1985,12,432,0,432
Newcastle,1986,1,380,0,380
Newcastle,1986,2,428,0,428
Newcastle,1986,3,457,0,457
Newcastle,1986,4,391,0,391
Newcastle,1986,5,431,0,431
Newcastle,1986,6,385,0,385
Newcastle,1986,7,399,0,399
Newcastle,1986,8,388,0,388
Newcastle,1986,9,396,0,396
Newcastle,1986,10,390,0,390
Newcastle,1986,11,386,0,386
Newcastle,1986,12,373,0,373
Newcastle,1987,1,327,0,327
Newcastle,1987,2,345,0,345
Newcastle,1987,3,357,0,357
Newcastle,1987,4,335,0,335
Newcastle,1987,5,348,0,348
Newcastle,1987,6,354,0,354
Newcastle,1987,7,366,0,366
Newcastle,1987,8,360,0,360
Newcastle,1987,9,345,0,345
Newcastle,1987,10,344,0,344
Newcastle,1987,11,360,0,360
Newcastle,1987,12,350,0,350
Newcastle,1988,1,295,0,295
Newcastle,1988,2,287,0,287
Newcastle,1988,3,315,0,315
Newcastle,1988,4,287,0,287
Newcastle,1988,5,309,0,309
Newcastle,1988,6,295,0,295
Newcastle,1988,7,314,0,314
Newcastle,1988,8,399,0,399
Newcastle,1988,9,389,0,389
Newcastle,1988,10,393,0,393
Newcastle,1988,11,389,0,389
Newcastle,1988,12,312,0,312
Newcastle,1989,1,258,0,258
Newcastle,1989,2,238,0,238
Newcastle,1989,3,254,0,254
Newcastle,1989,4,198,0,198
Newcastle,1989,5,209,0,209
Newcastle,1989,6,213,0,213
Newcastle,1989,7,74,0,74
Newcastle,1989,8,45,0,45
Newcastle,1989,9,215,0,215
Newcastle,1989,10,270,0,270
Newcastle,1989,11,285,0,285
Newcastle,1989,12,258,0,258
Newcastle,1990,1,256,0,256
Newcastle,1990,2,212,0,212
Newcastle,1990,3,277,0,277
Newcastle,1990,4,285,0,285
Newcastle,1990,5,420,0,420
Newcastle,1990,6,404,0,404
Newcastle,1990,7,314,0,314
Newcastle,1990,8,280,0,280
Newcastle,1990,9,326,0,326
Newcastle,1990,10,328,0,328
Newcastle,1990,11,293,0,293
Newcastle,1990,12,270,0,270
Newcastle,1991,1,443,0,443
Newcastle,1991,2,413,0,413
Newcastle,1991,3,462,0,462
Newcastle,1991,4,479,0,479
Newcastle,1991,5,459,0,459
Newcastle,1991,6,444,0,444
Newcastle,1991,7,462,0,462
Newcastle,1991,8,440,0,440
Newcastle,1991,9,443,0,443
Newcastle,1991,10,531,0,531
Newcastle,1991,11,435,0,435
Newcastle,1991,12,352,0,352
Newcastle,1992,1,309,0,309
Newcastle,1992,2,277,0,277
Newcastle,1992,3,331,0,331
Newcastle,1992,4,333,0,333
Newcastle,1992,5,435,0,435
Newcastle,1992,6,420,0,420
Newcastle,1992,7,442,0,442
Newcastle,1992,8,412,0,412
Newcastle,1992,9,412,0,412
Newcastle,1992,10,423,0,423
Newcastle,1992,11,423,0,423
Newcastle,1992,12,410,0,410
Newcastle,1993,1,373,0,373
Newcastle,1993,2,363,0,363
Newcastle,1993,3,371,0,371
Newcastle,1993,4,361,0,361
Newcastle,1993,5,352,0,352
Newcastle,1993,6,346,0,346
Newcastle,1993,7,364,0,364
Newcastle,1993,8,381,0,381
Newcastle,1993,9,387,0,387
Newcastle,1993,10,388,0,388
Newcastle,1993,11,424,0,424
Newcastle,1993,12,463,0,463
Newcastle,1994,1,471,0,471
Newcastle,1994,2,445,0,445
Newcastle,1994,3,494,0,494
Newcastle,1994,4,448,0,448
Newcastle,1994,5,463,0,463
Newcastle,1994,6,458,0,458
Newcastle,1994,7,466,0,466
Newcastle,1994,8,445,0,445
Newcastle,1994,9,434,0,434
Newcastle,1994,10,463,0,463
Newcastle,1994,11,443,0,443
Newcastle,1994,12,472,0,472
Newcastle,1995,1,481,0,481
Newcastle,1995,2,481,0,481
Newcastle,1995,3,538,0,538
Newcastle,1995,4,513,0,513
Newcastle,1995,5,526,0,526
Newcastle,1995,6,498,0,498
Newcastle,1995,7,448,0,448
Newcastle,1995,8,420,0,420
Newcastle,1995,9,399,0,399
Newcastle,1995,10,477,0,477
Newcastle,1995,11,515,0,515
Newcastle,1995,12,531,0,531
Newcastle,1996,1,520,0,520
Newcastle,1996,2,505,0,505
Newcastle,1996,3,515,0,515
Newcastle,1996,4,547,0,547
Newcastle,1996,5,560,0,560
Newcastle,1996,6,550,0,550
Newcastle,1996,7,522,0,522
Newcastle,1996,8,468,0,468
Newcastle,1996,9,463,0,463
Newcastle,1996,10,479,0,479
Newcastle,1996,11,485,0,485
Newcastle,1996,12,476,0,476
Newcastle,1997,1,350,0,350
Newcastle,1997,2,468,0,468
Newcastle,1997,3,531,0,531
Newcastle,1997,4,533,0,533
Newcastle,1997,5,598,0,598
Newcastle,1997,6,622,0,622
Newcastle,1997,7,830,0,830
Newcastle,1997,8,734,0,734
Newcastle,1997,9,732,0,732
Newcastle,1997,10,736,0,736
Newcastle,1997,11,677,0,677
Newcastle,1997,12,719,0,719
Newcastle,1998,1,673,0,673
Newcastle,1998,2,628,0,628
Newcastle,1998,3,697,0,697
Newcastle,1998,4,683,0,683
Newcastle,1998,5,684,0,684
Newcastle,1998,6,690,0,690
Newcastle,1998,7,756,0,756
Newcastle,1998,8,748,0,748
Newcastle,1998,9,749,0,749
Newcastle,1998,10,760,0,760
Newcastle,1998,11,686,0,686
Newcastle,1998,12,764,0,764
Newcastle,1999,1,721,0,721
Newcastle,1999,2,678,0,678
Newcastle,1999,3,763,0,763
Newcastle,1999,4,722,0,722
Newcastle,1999,5,724,0,724
Newcastle,1999,6,716,0,716
Newcastle,1999,7,742,0,742
Newcastle,1999,8,738,0,738
Newcastle,1999,9,731,0,731
Newcastle,1999,10,732,0,732
Newcastle,1999,11,667,0,667
Newcastle,1999,12,709,0,709
Newcastle,2000,1,655,0,655
Newcastle,2000,2,628,0,628
Newcastle,2000,3,709,0,709
Newcastle,2000,4,689,0,689
Newcastle,2000,5,692,0,692
Newcastle,2000,6,690,0,690
Newcastle,2000,7,701,0,701
Newcastle,2000,8,757,0,757
Newcastle,2000,9,690,0,690
Newcastle,2000,10,739,0,739
Newcastle,2000,11,722,0,722
Newcastle,2000,12,695,0,695
Newcastle,2001,1,691,0,691
Newcastle,2001,2,624,0,624
Newcastle,2001,3,743,0,743
Newcastle,2001,4,704,0,704
Newcastle,2001,5,662,0,662
Newcastle,2001,6,495,0,495
Newcastle,2001,7,515,0,515
Newcastle,2001,8,548,0,548
Newcastle,2001,9,532,0,532
Newcastle,2001,10,620,0,620
Newcastle,2001,11,552,0,552
Newcastle,2001,12,505,5,510
Newcastle,2002,1,518,9,527
Newcastle,2002,2,518,9,527
Newcastle,2002,3,557,8,565
Newcastle,2002,4,536,9,545
Newcastle,2002,5,559,7,566
Newcastle,2002,6,464,8,472
Newcastle,2002,7,456,9,465
Newcastle,2002,8,374,8,382
Newcastle,2002,9,387,1,388
Newcastle,2002,10,371,0,371
Newcastle,2002,11,355,0,355
Newcastle,2002,12,411,0,411
Newcastle,2003,1,425,0,425
Newcastle,2003,2,390,0,390
Newcastle,2003,3,426,0,426
Newcastle,2003,4,423,0,423
Newcastle,2003,5,476,0,476
Newcastle,2003,6,451,0,451
Newcastle,2003,7,490,0,490
Newcastle,2003,8,497,0,497
Newcastle,2003,9,479,0,479
Newcastle,2003,10,504,0,504
Newcastle,2003,11,500,0,500
Newcastle,2003,12,394,0,394
Newcastle,2004,1,395,0,395
Newcastle,2004,2,398,0,398
Newcastle,2004,3,424,0,424
Newcastle,2004,4,398,0,398
Newcastle,2004,5,438,0,438
Newcastle,2004,6,469,0,469
Newcastle,2004,7,471,0,471
Newcastle,2004,8,481,0,481
Newcastle,2004,9,527,0,527
Newcastle,2004,10,509,0,509
Newcastle,2004,11,545,0,545
Newcastle,2004,12,571,0,571
Newcastle,2005,1,501,0,501
Newcastle,2005,2,560,0,560
Newcastle,2005,3,620,0,620
Newcastle,2005,4,628,0,628
Newcastle,2005,5,697,0,697
Newcastle,2005,6,612,0,612
Newcastle,2005,7,625,0,625
Newcastle,2005,8,644,0,644
Newcastle,2005,9,680,0,680
Newcastle,2005,10,642,0,642
Newcastle,2005,11,636,0,636
Newcastle,2005,12,626,0,626
Newcastle,2006,1,530,0,530
Newcastle,2006,2,558,0,558
Newcastle,2006,3,634,0,634
Newcastle,2006,4,623,0,623
Newcastle,2006,5,699,0,699
Newcastle,2006,6,630,0,630
Newcastle,2006,7,724,0,724
Newcastle,2006,8,679,0,679
Newcastle,2006,9,687,0,687
Newcastle,2006,10,702,0,702
Newcastle,2006,11,727,0,727
Newcastle,2006,12,632,0,632
Newcastle,2007,1,663,0,663
Newcastle,2007,2,647,0,647
Newcastle,2007,3,674,0,674
Newcastle,2007,4,618,0,618
Newcastle,2007,5,700,0,700
Newcastle,2007,6,649,0,649
Newcastle,2007,7,663,0,663
Newcastle,2007,8,749,0,749
Newcastle,2007,9,666,0,666
Newcastle,2007,10,711,0,711
Newcastle,2007,11,661,0,661
Newcastle,2007,12,653,0,653
Newcastle,2008,1,609,0,609
Newcastle,2008,2,627,0,627
Newcastle,2008,3,595,0,595
Newcastle,2008,4,602,0,602
Newcastle,2008,5,590,0,590
Newcastle,2008,6,592,0,592
Newcastle,2008,7,632,0,632
Newcastle,2008,8,703,0,703
Newcastle,2008,9,655,0,655
Newcastle,2008,10,690,0,690
Newcastle,2008,11,612,0,612
Newcastle,2008,12,597,0,597
Newcastle,2009,1,559,0,559
Newcastle,2009,2,579,0,579
Newcastle,2009,3,638,0,638
Newcastle,2009,4,598,0,598
Newcastle,2009,5,601,0,601
Newcastle,2009,6,583,0,583
Newcastle,2009,7,631,0,631
Newcastle,2009,8,597,0,597
Newcastle,2009,9,592,0,592
Newcastle,2009,10,542,0,542
Newcastle,2009,11,559,0,559
Newcastle,2009,12,550,0,550
Newcastle,2010,1,475,0,475
Newcastle,2010,2,519,0,519
Newcastle,2010,3,610,0,610
Newcastle,2010,4,607,0,607
Newcastle,2010,5,603,0,603
Newcastle,2010,6,581,0,581
Newcastle,2010,7,634,0,634
Newcastle,2010,8,613,0,613
Newcastle,2010,9,613,0,613
Newcastle,2010,10,645,0,645
Newcastle,2010,11,632,0,632
Newcastle,2010,12,632,0,632
Newcastle,2011,1,550,0,550
Newcastle,2011,2,549,0,549
Newcastle,2011,3,639,0,639
Newcastle,2011,4,612,0,612
Newcastle,2011,5,608,0,608
Newcastle,2011,6,588,0,588
Newcastle,2011,7,662,0,662
Newcastle,2011,8,655,0,655
Newcastle,2011,9,641,0,641
Newcastle,2011,10,635,0,635
Newcastle,2011,11,717,0,717
Newcastle,2011,12,685,0,685
Newcastle,2012,1,644,0,644
Newcastle,2012,2,665,0,665
Newcastle,2012,3,735,0,735
Newcastle,2012,4,713,0,713
Newcastle,2012,5,746,0,746
Newcastle,2012,6,701,0,701
Newcastle,2012,7,745,0,745
Newcastle,2012,8,761,0,761
Newcastle,2012,9,720,0,720
Newcastle,2012,10,759,0,759
Newcastle,2012,11,760,0,760
Newcastle,2012,12,721,0,721
Newcastle,2013,1,659,0,659
Newcastle,2013,2,660,0,660
Newcastle,2013,3,741,0,741
Newcastle,2013,4,708,0,708
Newcastle,2013,5,708,0,708
Newcastle,2013,6,676,0,676
Newcastle,2013,7,729,0,729
Newcastle,2013,8,741,0,741
Newcastle,2013,9,731,0,731
Newcastle,2013,10,733,0,733
Newcastle,2013,11,693,0,693
Newcastle,2013,12,637,0,637
Newcastle,2014,1,553,0,553
Newcastle,2014,2,498,0,498
Newcastle,2014,3,561,0,561
Newcastle,2014,4,543,0,543
Newcastle,2014,5,532,0,532
Newcastle,2014,6,507,0,507
Newcastle,2014,7,564,0,564
Newcastle,2014,8,548,0,548
Newcastle,2014,9,534,0,534
Newcastle,2014,10,553,0,553
Newcastle,2014,11,532,0,532
Newcastle,2014,12,507,0,507
Newcastle,2015,1,475,0,475
Newcastle,2015,2,474,0,474
Newcastle,2015,3,539,0,539
Newcastle,2015,4,526,0,526
Newcastle,2015,5,544,0,544
Newcastle,2015,6,589,0,589
Newcastle,2015,7,678,0,678
Newcastle,2015,8,670,0,670
Newcastle,2015,9,662,0,662
Newcastle,2015,10,688,0,688
Newcastle,2015,11,644,0,644
Newcastle,2015,12,640,0,640
Newcastle,2016,1,554,0,554
Newcastle,2016,2,658,0,658
Newcastle,2016,3,724,0,724
Newcastle,2016,4,654,0,654
Newcastle,2016,5,718,0,718
Newcastle,2016,6,709,0,709
Newcastle,2016,7,764,0,764
Newcastle,2016,8,794,0,794
Newcastle,2016,9,777,0,777
Newcastle,2016,10,776,0,776
Newcastle,2016,11,760,0,760
Newcastle,2016,12,745,0,745
Newcastle,2017,1,685,0,685
Newcastle,2017,2,685,0,685
Newcastle,2017,3,793,0,793
Newcastle,2017,4,724,0,724
Newcastle,2017,5,775,0,775
Newcastle,2017,6,737,0,737
Newcastle,2017,7,764,0,764
Newcastle,2017,8,773,0,773
Newcastle,2017,9,706,0,706
Newcastle,2017,10,745,0,745
Newcastle,2017,11,732,0,732
Newcastle,2017,12,678,0,678
Newcastle,2018,1,558,0,558
Newcastle,2018,2,589,0,589
Newcastle,2018,3,599,0,599
Newcastle,2018,4,561,0,561
Newcastle,2018,5,601,0,601
Newcastle,2018,6,563,0,563
Newcastle,2018,7,591,0,591
Newcastle,2018,8,614,0,614
Newcastle,2018,9,578,0,578
Newcastle,2018,10,589,0,589
Newcastle,2018,11,614,4,618
Newcastle,2018,12,574,12,586
Newcastle,2019,1,530,13,543
Newcastle,2019,2,558,6,564
Newcastle,2019,3,606,0,606
Newcastle,2019,4,588,0,588
Newcastle,2019,5,621,0,621
Newcastle,2019,6,579,0,579
Newcastle,2019,7,635,0,635
Newcastle,2019,8,593,0,593
Newcastle,2019,9,605,0,605
Newcastle,2019,10,632,0,632
Newcastle,2019,11,609,4,613
Newcastle,2019,12,555,14,569
Newcastle,2020,1,521,13,534
Newcastle,2020,2,555,5,560
Newcastle,2020,3,453,0,453
Newcastle,2020,4,42,0,42
Newcastle,2020,5,43,0,43
Newcastle,2020,6,59,0,59
Newcastle,2020,7,130,0,130
Newcastle,2020,8,87,0,87
Newcastle,2020,9,68,0,68
Newcastle,2020,10,87,0,87
Newcastle,2020,11,218,0,218
Newcastle,2020,12,415,0,415
Newcastle,2021,1,313,0,313
Newcastle,2021,2,393,0,393
Newcastle,2021,3,478,0,478
Newcastle,2021,4,538,0,538
Newcastle,2021,5,552,0,552
Newcastle,2021,6,488,0,488
Newcastle,2021,7,335,0,335
Newcastle,2021,8,138,0,138
Newcastle,2021,9,102,0,102
Newcastle,2021,10,116,0,116
Newcastle,2021,11,210,0,210
Newcastle,2021,12,422,0,422
Newcastle,2022,1,406,0,406
Newcastle,2022,2,359,0,359
Newcastle,2022,3,500,0,500
Newcastle,2022,4,624,0,624
Newcastle,2022,5,602,0,602
Newcastle,2022,6,572,0,572
Newcastle,2022,7,557,0,557
Newcastle,2022,8,557,0,557
Newcastle,2022,9,583,0,583
Newcastle,2022,10,580,0,580
Newcastle,2022,11,606,0,606
Newcastle,2022,12,553,0,553
Newcastle,2023,1,532,0,532
Newcastle,2023,2,538,0,538
Newcastle,2023,3,603,0,603
Newcastle,2023,4,577,0,577
Newcastle,2023,5,620,0,620
Newcastle,2023,6,584,0,584
Newcastle,2023,7,593,0,593
Newcastle,2023,8,609,0,609
Newcastle,2023,9,599,0,599
Newcastle,2023,10,617,0,617
Newcastle,2023,11,573,0,573
Newcastle,2023,12,554,0,554
Newcastle,2024,1,519,0,519
Newcastle,2024,2,554,0,554
Newcastle,2024,3,575,0,575
Newcastle,2024,4,557,0,557
Newcastle,2024,5,552,0,552
Newcastle,2024,6,513,0,513
Newcastle,2024,7,569,0,569
Newcastle,2024,8,547,0,547
Newcastle,2024,9,536,0,536
Newcastle,2024,10,547,0,547
Newcastle,2024,11,513,0,513
Newcastle,2024,12,507,0,507
Perth,1985,1,1162,124,1286
Perth,1985,2,1008,113,1121
Perth,1985,3,1571,124,1695
Perth,1985,4,1508,118,1626
Perth,1985,5,1981,124,2105
Perth,1985,6,1887,119,2006
Perth,1985,7,1855,119,1974
Perth,1985,8,2042,124,2166
Perth,1985,9,1694,123,1817
Perth,1985,10,1712,124,1836
Perth,1985,11,1728,133,1861
Perth,1985,12,1999,128,2127
Perth,1986,1,2103,141,2244
Perth,1986,2,1619,118,1737
Perth,1986,3,1713,131,1844
Perth,1986,4,1636,128,1764
Perth,1986,5,1497,132,1629
Perth,1986,6,1414,123,1537
Perth,1986,7,1450,133,1583
Perth,1986,8,1405,134,1539
Perth,1986,9,1576,129,1705
Perth,1986,10,1671,155,1826
Perth,1986,11,1680,150,1830
Perth,1986,12,1834,164,1998
Perth,1987,1,1126,174,1300
Perth,1987,2,1031,147,1178
Perth,1987,3,1088,134,1222
Perth,1987,4,1207,129,1336
Perth,1987,5,1173,134,1307
Perth,1987,6,1109,127,1236
Perth,1987,7,1268,133,1401
Perth,1987,8,1236,133,1369
Perth,1987,9,1268,125,1393
Perth,1987,10,1267,142,1409
Perth,1987,11,1200,125,1325
Perth,1987,12,1255,149,1404
Perth,1988,1,1236,151,1387
Perth,1988,2,1117,132,1249
Perth,1988,3,1211,129,1340
Perth,1988,4,1115,120,1235
Perth,1988,5,1163,130,1293
Perth,1988,6,1148,131,1279
Perth,1988,7,1249,136,1385
Perth,1988,8,1228,126,1354
Perth,1988,9,1234,133,1367
Perth,1988,10,1223,136,1359
Perth,1988,11,1174,160,1334
Perth,1988,12,1170,184,1354
Perth,1989,1,1149,188,1337
Perth,1989,2,1016,162,1178
Perth,1989,3,1209,167,1376
Perth,1989,4,1100,169,1269
Perth,1989,5,1173,168,1341
Perth,1989,6,1020,168,1188
Perth,1989,7,1266,174,1440
Perth,1989,8,969,170,1139
Perth,1989,9,512,168,680
Perth,1989,10,648,182,830
Perth,1989,11,759,188,947
Perth,1989,12,969,211,1180
Perth,1990,1,996,217,1213
Perth,1990,2,1021,182,1203
Perth,1990,3,1173,197,1370
Perth,1990,4,1124,194,1318
Perth,1990,5,1203,197,1400
Perth,1990,6,1164,195,1359
Perth,1990,7,1219,201,1420
Perth,1990,8,1245,198,1443
Perth,1990,9,1158,193,1351
Perth,1990,10,1316,209,1525
Perth,1990,11,1298,212,1510
Perth,1990,12,1321,230,1551
Perth,1991,1,1295,231,1526
Perth,1991,2,1192,205,1397
Perth,1991,3,1346,212,1558
Perth,1991,4,1291,219,1510
Perth,1991,5,1338,228,1566
Perth,1991,6,1258,223,1481
Perth,1991,7,1469,225,1694
Perth,1991,8,1436,226,1662
Perth,1991,9,1482,221,1703
Perth,1991,10,1543,229,1772
Perth,1991,11,1459,225,1684
Perth,1991,12,1498,230,1728
Perth,1992,1,1462,235,1697
Perth,1992,2,1318,226,1544
Perth,1992,3,1389,240,1629
Perth,1992,4,1364,231,1595
Perth,1992,5,1343,230,1573
Perth,1992,6,1311,234,1545
Perth,1992,7,1451,247,1698
Perth,1992,8,1352,253,1605
Perth,1992,9,1373,242,1615
Perth,1992,10,1423,261,1684
Perth,1992,11,1366,269,1635
Perth,1992,12,1383,285,1668
Perth,1993,1,1330,293,1623
Perth,1993,2,1197,261,1458
Perth,1993,3,1364,279,1643
Perth,1993,4,1357,289,1646
Perth,1993,5,1469,304,1773
Perth,1993,6,1438,294,1732
Perth,1993,7,1551,309,1860
Perth,1993,8,1520,304,1824
Perth,1993,9,1553,303,1856
Perth,1993,10,1586,325,1911
Perth,1993,11,1558,288,1846
Perth,1993,12,1592,312,1904
Perth,1994,1,1577,317,1894
Perth,1994,2,1426,283,1709
Perth,1994,3,1642,315,1957
Perth,1994,4,1556,296,1852
Perth,1994,5,1625,306,1931
Perth,1994,6,1594,294,1888
Perth,1994,7,1689,314,2003
Perth,1994,8,1680,299,1979
Perth,1994,9,1668,298,1966
Perth,1994,10,1721,315,2036
Perth,1994,11,1715,311,2026
Perth,1994,12,1806,333,2139
Perth,1995,1,1782,332,2114
Perth,1995,2,1619,299,1918
Perth,1995,3,1882,337,2219
Perth,1995,4,1830,330,2160
Perth,1995,5,1913,329,2242
Perth,1995,6,1851,353,2204
Perth,1995,7,1932,348,2280
Perth,1995,8,1882,345,2227
Perth,1995,9,1839,347,2186
Perth,1995,10,1921,352,2273
Perth,1995,11,1915,343,2258
Perth,1995,12,1853,380,2233
Perth,1996,1,1887,379,2266
Perth,1996,2,1769,362,2131
Perth,1996,3,1904,374,2278
Perth,1996,4,1891,365,2256
Perth,1996,5,1966,369,2335
Perth,1996,6,1926,363,2289
Perth,1996,7,2119,374,2493
Perth,1996,8,2092,379,2471
Perth,1996,9,2016,370,2386
Perth,1996,10,2110,371,2481
Perth,1996,11,2028,365,2393
Perth,1996,12,2004,387,2391
Perth,1997,1,2014,391,2405
Perth,1997,2,1870,336,2206
Perth,1997,3,2016,369,2385
Perth,1997,4,1966,352,2318
Perth,1997,5,2046,365,2411
Perth,1997,6,1970,351,2321
Perth,1997,7,2077,375,2452
Perth,1997,8,2082,376,2458
Perth,1997,9,2030,362,2392
Perth,1997,10,2073,363,2436
Perth,1997,11,1936,349,2285
Perth,1997,12,1952,370,2322
Perth,1998,1,1933,381,2314
Perth,1998,2,1773,336,2109
Perth,1998,3,1968,362,2330
Perth,1998,4,1911,378,2289
Perth,1998,5,1933,396,2329
Perth,1998,6,1877,378,2255
Perth,1998,7,1979,402,2381
Perth,1998,8,1903,404,2307
Perth,1998,9,1867,390,2257
Perth,1998,10,1900,397,2297
Perth,1998,11,1817,374,2191
Perth,1998,12,1837,386,2223
Perth,1999,1,1793,402,2195
Perth,1999,2,1664,358,2022
Perth,1999,3,1869,388,2257
Perth,1999,4,1804,397,2201
Perth,1999,5,1878,405,2283
Perth,1999,6,1834,378,2212
Perth,1999,7,1955,416,2371
Perth,1999,8,1960,419,2379
Perth,1999,9,1937,405,2342
Perth,1999,10,1952,421,2373
Perth,1999,11,1931,399,2330
Perth,1999,12,1926,416,2342
Perth,2000,1,1877,431,2308
Perth,2000,2,1766,394,2160
Perth,2000,3,1899,410,2309
Perth,2000,4,1859,414,2273
Perth,2000,5,2003,402,2405
Perth,2000,6,1922,403,2325
Perth,2000,7,1966,433,2399
Perth,2000,8,1999,426,2425
Perth,2000,9,1968,417,2385
Perth,2000,10,2004,427,2431
Perth,2000,11,1936,432,2368
Perth,2000,12,1905,463,2368
Perth,2001,1,1926,427,2353
Perth,2001,2,1740,350,2090
Perth,2001,3,1969,402,2371
Perth,2001,4,1899,389,2288
Perth,2001,5,1956,392,2348
Perth,2001,6,1880,388,2268
Perth,2001,7,1960,383,2343
Perth,2001,8,1973,382,2355
Perth,2001,9,1331,364,1695
Perth,2001,10,1288,360,1648
Perth,2001,11,1424,354,1778
Perth,2001,12,1535,373,1908
Perth,2002,1,1598,355,1953
Perth,2002,2,1478,316,1794
Perth,2002,3,1379,346,1725
Perth,2002,4,1419,333,1752
Perth,2002,5,1465,347,1812
Perth,2002,6,1418,338,1756
Perth,2002,7,1571,347,1918
Perth,2002,8,1575,365,1940
Perth,2002,9,1558,353,1911
Perth,2002,10,1638,365,2003
Perth,2002,11,1634,341,1975
Perth,2002,12,1684,359,2043
Perth,2003,1,1718,356,2074
Perth,2003,2,1572,328,1900
Perth,2003,3,1727,366,2093
Perth,2003,4,1677,356,2033
Perth,2003,5,1732,350,2082
Perth,2003,6,1638,341,1979
Perth,2003,7,1726,374,2100
Perth,2003,8,1634,379,2013
Perth,2003,9,1694,374,2068
Perth,2003,10,1808,395,2203
Perth,2003,11,1705,394,2099
Perth,2003,12,1745,411,2156
Perth,2004,1,1748,409,2157
Perth,2004,2,1594,367,1961
Perth,2004,3,1822,384,2206
Perth,2004,4,1813,378,2191
Perth,2004,5,1894,385,2279
Perth,2004,6,1844,380,2224
Perth,2004,7,1995,411,2406
Perth,2004,8,1966,392,2358
Perth,2004,9,1931,371,2302
Perth,2004,10,1986,411,2397
Perth,2004,11,1895,425,2320
Perth,2004,12,1930,474,2404
Perth,2005,1,1931,470,2401
Perth,2005,2,1708,427,2135
Perth,2005,3,1902,468,2370
Perth,2005,4,1887,457,2344
Perth,2005,5,1948,459,2407
Perth,2005,6,1908,470,2378
Perth,2005,7,1973,488,2461
Perth,2005,8,2034,477,2511
Perth,2005,9,2000,432,2432
Perth,2005,10,1987,438,2425
Perth,2005,11,1991,392,2383
Perth,2005,12,2008,428,2436
Perth,2006,1,1968,429,2397
Perth,2006,2,1851,374,2225
Perth,2006,3,2085,420,2505
Perth,2006,4,1945,412,2357
Perth,2006,5,2051,421,2472
Perth,2006,6,1980,408,2388
Perth,2006,7,2032,429,2461
Perth,2006,8,2098,424,2522
Perth,2006,9,2091,443,2534
Perth,2006,10,2164,453,2617
Perth,2006,11,2104,444,2548
Perth,2006,12,2097,494,2591
Perth,2007,1,2084,492,2576
Perth,2007,2,1916,441,2357
Perth,2007,3,2171,490,2661
Perth,2007,4,2118,481,2599
Perth,2007,5,2208,499,2707
Perth,2007,6,2161,491,2652
Perth,2007,7,2279,516,2795
Perth,2007,8,2323,505,2828
Perth,2007,9,2230,496,2726
Perth,2007,10,2359,511,2870
Perth,2007,11,2312,514,2826
Perth,2007,12,2341,560,2901
Perth,2008,1,2374,557,2931
Perth,2008,2,2250,506,2756
Perth,2008,3,2414,532,2946
Perth,2008,4,2394,509,2903
Perth,2008,5,2470,519,2989
Perth,2008,6,2460,547,3007
Perth,2008,7,2634,567,3201
Perth,2008,8,2577,557,3134
Perth,2008,9,2608,568,3176
Perth,2008,10,2792,587,3379
Perth,2008,11,2718,590,3308
Perth,2008,12,2755,667,3422
Perth,2009,1,2696,696,3392
Perth,2009,2,2459,563,3022
Perth,2009,3,2731,625,3356
Perth,2009,4,2649,617,3266
Perth,2009,5,2726,607,3333
Perth,2009,6,2681,609,3290
Perth,2009,7,2781,662,3443
Perth,2009,8,2697,676,3373
Perth,2009,9,2691,691,3382
Perth,2009,10,2741,716,3457
Perth,2009,11,2615,717,3332
Perth,2009,12,2675,756,3431
Perth,2010,1,2704,764,3468
Perth,2010,2,2479,665,3144
Perth,2010,3,2864,723,3587
Perth,2010,4,2778,720,3498
Perth,2010,5,2826,732,3558
Perth,2010,6,2761,744,3505
Perth,2010,7,2904,790,3694
Perth,2010,8,2919,746,3665
Perth,2010,9,2878,728,3606
Perth,2010,10,2919,755,3674
Perth,2010,11,2861,739,3600
Perth,2010,12,2920,817,3737
Perth,2011,1,2821,854,3675
Perth,2011,2,2589,700,3289
Perth,2011,3,2973,767,3740
Perth,2011,4,2964,802,3766
Perth,2011,5,3070,793,3863
Perth,2011,6,2837,777,3614
Perth,2011,7,3063,835,3898
Perth,2011,8,3120,821,3941
Perth,2011,9,3026,787,3813
Perth,2011,10,2992,798,3790
Perth,2011,11,2980,768,3748
Perth,2011,12,3054,856,3910
Perth,2012,1,3172,887,4059
Perth,2012,2,2992,764,3756
Perth,2012,3,3235,791,4026
Perth,2012,4,3178,805,3983
Perth,2012,5,3257,790,4047
Perth,2012,6,3149,776,3925
Perth,2012,7,3437,863,4300
Perth,2012,8,3425,849,4274
Perth,2012,9,3285,825,4110
Perth,2012,10,3478,840,4318
Perth,2012,11,3275,827,4102
Perth,2012,12,3235,940,4175
Perth,2013,1,3227,931,4158
Perth,2013,2,2844,817,3661
Perth,2013,3,3192,891,4083
Perth,2013,4,3289,867,4156
Perth,2013,5,3345,847,4192
Perth,2013,6,3108,881,3989
Perth,2013,7,3444,1016,4460
Perth,2013,8,3329,990,4319
Perth,2013,9,3285,956,4241
Perth,2013,10,3393,999,4392
Perth,2013,11,3174,951,4125
Perth,2013,12,3184,1104,4288
Perth,2014,1,3265,1159,4424
Perth,2014,2,2933,943,3876
Perth,2014,3,3215,1018,4233
Perth,2014,4,3241,1037,4278
Perth,2014,5,3216,921,4137
Perth,2014,6,3051,893,3944
Perth,2014,7,3230,1031,4261
Perth,2014,8,3067,968,4035
Perth,2014,9,3156,963,4119
Perth,2014,10,3273,993,4266
Perth,2014,11,3010,898,3908
Perth,2014,12,3156,1022,4178
Perth,2015,1,3050,1060,4110
Perth,2015,2,2810,856,3666
Perth,2015,3,3123,870,3993
Perth,2015,4,3107,911,4018
Perth,2015,5,3064,887,3951
Perth,2015,6,3040,881,3921
Perth,2015,7,3256,918,4174
Perth,2015,8,3079,870,3949
Perth,2015,9,3076,870,3946
Perth,2015,10,3172,900,4072
Perth,2015,11,2979,813,3792
Perth,2015,12,3067,1003,4070
Perth,2016,1,2909,1050,3959
Perth,2016,2,2849,897,3746
Perth,2016,3,3115,946,4061
Perth,2016,4,2991,949,3940
Perth,2016,5,2937,905,3842
Perth,2016,6,2893,907,3800
Perth,2016,7,3010,969,3979
Perth,2016,8,3108,940,4048
Perth,2016,9,3093,938,4031
Perth,2016,10,3102,966,4068
Perth,2016,11,2992,911,3903
Perth,2016,12,2984,990,3974
Perth,2017,1,2909,974,3883
Perth,2017,2,2690,843,3533
Perth,2017,3,3043,918,3961
Perth,2017,4,2829,906,3735
Perth,2017,5,2934,880,3814
Perth,2017,6,2860,888,3748
Perth,2017,7,2961,979,3940
Perth,2017,8,3023,943,3966
Perth,2017,9,2931,940,3871
Perth,2017,10,3034,977,4011
Perth,2017,11,2927,899,3826
Perth,2017,12,2932,995,3927
Perth,2018,1,2949,1016,3965
Perth,2018,2,2647,833,3480
Perth,2018,3,2941,921,3862
Perth,2018,4,2853,960,3813
Perth,2018,5,2966,913,3879
Perth,2018,6,2812,946,3758
Perth,2018,7,3021,1012,4033
Perth,2018,8,2992,972,3964
Perth,2018,9,2893,944,3837
Perth,2018,10,3096,952,4048
Perth,2018,11,2952,910,3862
Perth,2018,12,2949,1003,3952
Perth,2019,1,2990,989,3979
Perth,2019,2,2704,848,3552
Perth,2019,3,2941,921,3862
Perth,2019,4,2979,861,3840
Perth,2019,5,3056,860,3916
Perth,2019,6,2865,842,3707
Perth,2019,7,3113,907,4020
Perth,2019,8,2961,877,3838
Perth,2019,9,2921,875,3796
Perth,2019,10,3066,915,3981
Perth,2019,11,2830,916,3746
Perth,2019,12,2906,1033,3939
Perth,2020,1,2915,1044,3959
Perth,2020,2,2706,875,3581
Perth,2020,3,2551,600,3151
Perth,2020,4,556,91,647
Perth,2020,5,392,104,496
Perth,2020,6,526,97,623
Perth,2020,7,818,107,925
Perth,2020,8,879,120,999
Perth,2020,9,1151,140,1291
Perth,2020,10,1319,141,1460
Perth,2020,11,1488,118,1606
Perth,2020,12,1927,139,2066
Perth,2021,1,1695,115,1810
Perth,2021,2,1498,105,1603
Perth,2021,3,2145,128,2273
Perth,2021,4,2282,131,2413
Perth,2021,5,2473,168,2641
Perth,2021,6,2251,170,2421
Perth,2021,7,1919,194,2113
Perth,2021,8,1830,177,2007
Perth,2021,9,1944,179,2123
Perth,2021,10,1925,178,2103
Perth,2021,11,2000,173,2173
Perth,2021,12,1827,177,2004
Perth,2022,1,1397,165,1562
Perth,2022,2,1513,168,1681
Perth,2022,3,2061,225,2286
Perth,2022,4,2358,274,2632
Perth,2022,5,2627,331,2958
Perth,2022,6,2661,418,3079
Perth,2022,7,2662,537,3199
Perth,2022,8,2739,517,3256
Perth,2022,9,2688,538,3226
Perth,2022,10,2695,576,3271
Perth,2022,11,2691,633,3324
Perth,2022,12,2788,703,3491
Perth,2023,1,2855,736,3591
Perth,2023,2,2538,648,3186
Perth,2023,3,2898,700,3598
Perth,2023,4,2778,706,3484
Perth,2023,5,2939,713,3652
Perth,2023,6,2833,742,3575
Perth,2023,7,2871,817,3688
Perth,2023,8,3018,837,3855
Perth,2023,9,2937,831,3768
Perth,2023,10,3071,843,3914
Perth,2023,11,3043,832,3875
Perth,2023,12,3004,997,4001
Perth,2024,1,3130,1038,4168
Perth,2024,2,2749,931,3680
Perth,2024,3,2996,958,3954
Perth,2024,4,3195,990,4185
Perth,2024,5,3219,1001,4220
Perth,2024,6,2977,1037,4014
Perth,2024,7,3329,1108,4437
Perth,2024,8,3218,1076,4294
Perth,2024,9,3158,1106,4264
Perth,2024,10,3290,1106,4396
Perth,2024,11,3100,1019,4119
Perth,2024,12,3187,1185,4372
Proserpine,2009,1,62,0,62
Proserpine,2009,2,53,0,53
Proserpine,2009,3,62,0,62
Proserpine,2009,4,60,0,60
Proserpine,2009,5,62,0,62
Proserpine,2009,6,60,0,60
Proserpine,2009,7,62,0,62
Proserpine,2009,8,62,0,62
Proserpine,2009,9,60,0,60
Proserpine,2009,10,62,0,62
Proserpine,2009,11,60,0,60
Proserpine,2009,12,62,0,62
Proserpine,2010,1,61,0,61
Proserpine,2010,2,56,0,56
Proserpine,2010,3,59,0,59
Proserpine,2010,4,60,0,60
Proserpine,2010,5,62,0,62
Proserpine,2010,6,60,0,60
Proserpine,2010,7,62,0,62
Proserpine,2010,8,62,0,62
Proserpine,2010,9,58,0,58
Proserpine,2010,10,62,0,62
Proserpine,2010,11,60,0,60
Proserpine,2010,12,62,0,62
Proserpine,2011,1,61,0,61
Proserpine,2011,2,53,0,53
Proserpine,2011,3,57,0,57
Proserpine,2011,4,60,0,60
Proserpine,2011,5,57,0,57
Proserpine,2011,6,56,0,56
Proserpine,2011,7,62,0,62
Proserpine,2011,8,65,0,65
Proserpine,2011,9,60,0,60
Proserpine,2011,10,62,0,62
Proserpine,2011,11,60,0,60
Proserpine,2011,12,62,0,62
Proserpine,2012,1,61,0,61
Proserpine,2012,2,61,0,61
Proserpine,2012,3,82,0,82
Proserpine,2012,4,79,0,79
Proserpine,2012,5,75,0,75
Proserpine,2012,6,77,0,77
Proserpine,2012,7,85,0,85
Proserpine,2012,8,85,0,85
Proserpine,2012,9,80,0,80
Proserpine,2012,10,85,0,85
Proserpine,2012,11,82,0,82
Proserpine,2012,12,83,0,83
Proserpine,2013,1,84,0,84
Proserpine,2013,2,72,0,72
Proserpine,2013,3,81,0,81
Proserpine,2013,4,80,0,80
Proserpine,2013,5,76,0,76
Proserpine,2013,6,70,0,70
Proserpine,2013,7,85,0,85
Proserpine,2013,8,84,0,84
Proserpine,2013,9,81,0,81
Proserpine,2013,10,83,0,83
Proserpine,2013,11,76,0,76
Proserpine,2013,12,83,0,83
Proserpine,2014,1,78,0,78
Proserpine,2014,2,71,0,71
Proserpine,2014,3,79,0,79
Proserpine,2014,4,94,0,94
Proserpine,2014,5,94,0,94
Proserpine,2014,6,89,0,89
Proserpine,2014,7,97,0,97
Proserpine,2014,8,97,0,97
Proserpine,2014,9,94,0,94
Proserpine,2014,10,98,0,98
Proserpine,2014,11,93,0,93
Proserpine,2014,12,99,0,99
Proserpine,2015,1,98,0,98
Proserpine,2015,2,84,0,84
Proserpine,2015,3,93,0,93
Proserpine,2015,4,96,0,96
Proserpine,2015,5,92,0,92
Proserpine,2015,6,94,0,94
Proserpine,2015,7,116,0,116
Proserpine,2015,8,114,0,114
Proserpine,2015,9,112,0,112
Proserpine,2015,10,115,0,115
Proserpine,2015,11,112,0,112
Proserpine,2015,12,117,0,117
Proserpine,2016,1,115,0,115
Proserpine,2016,2,104,0,104
Proserpine,2016,3,107,0,107
Proserpine,2016,4,89,0,89
Proserpine,2016,5,84,0,84
Proserpine,2016,6,83,0,83
Proserpine,2016,7,93,0,93
Proserpine,2016,8,93,0,93
Proserpine,2016,9,93,0,93
Proserpine,2016,10,98,0,98
Proserpine,2016,11,89,0,89
Proserpine,2016,12,113,0,113
Proserpine,2017,1,106,0,106
Proserpine,2017,2,78,0,78
Proserpine,2017,3,78,0,78
Proserpine,2017,4,134,0,134
Proserpine,2017,5,124,0,124
Proserpine,2017,6,127,0,127
Proserpine,2017,7,140,0,140
Proserpine,2017,8,136,0,136
Proserpine,2017,9,140,0,140
Proserpine,2017,10,142,0,142
Proserpine,2017,11,140,0,140
Proserpine,2017,12,149,0,149
Proserpine,2018,1,152,0,152
Proserpine,2018,2,123,0,123
Proserpine,2018,3,123,0,123
Proserpine,2018,4,123,0,123
Proserpine,2018,5,105,0,105
Proserpine,2018,6,109,0,109
Proserpine,2018,7,129,0,129
Proserpine,2018,8,118,0,118
Proserpine,2018,9,127,0,127
Proserpine,2018,10,141,0,141
Proserpine,2018,11,122,0,122
Proserpine,2018,12,135,0,135
Proserpine,2019,1,137,0,137
Proserpine,2019,2,104,0,104
Proserpine,2019,3,119,0,119
Proserpine,2019,4,132,0,132
Proserpine,2019,5,117,0,117
Proserpine,2019,6,106,0,106
Proserpine,2019,7,130,0,130
Proserpine,2019,8,120,0,120
Proserpine,2019,9,126,0,126
Proserpine,2019,10,129,0,129
Proserpine,2019,11,119,0,119
Proserpine,2019,12,131,0,131
Proserpine,2020,1,137,0,137
Proserpine,2020,2,91,0,91
Proserpine,2020,3,85,0,85
Proserpine,2020,4,0,0,0
Proserpine,2020,5,0,0,0
Proserpine,2020,6,12,0,12
Proserpine,2020,7,75,0,75
Proserpine,2020,8,63,0,63
Proserpine,2020,9,69,0,69
Proserpine,2020,10,81,0,81
Proserpine,2020,11,73,0,73
Proserpine,2020,12,119,0,119
Proserpine,2021,1,114,0,114
Proserpine,2021,2,81,0,81
Proserpine,2021,3,103,0,103
Proserpine,2021,4,118,0,118
Proserpine,2021,5,87,0,87
Proserpine,2021,6,89,0,89
Proserpine,2021,7,108,0,108
Proserpine,2021,8,80,0,80
Proserpine,2021,9,129,0,129
Proserpine,2021,10,178,0,178
Proserpine,2021,11,179,0,179
Proserpine,2021,12,209,0,209
Proserpine,2022,1,204,0,204
Proserpine,2022,2,125,0,125
Proserpine,2022,3,152,0,152
Proserpine,2022,4,183,0,183
Proserpine,2022,5,137,0,137
Proserpine,2022,6,137,0,137
Proserpine,2022,7,151,0,151
Proserpine,2022,8,140,0,140
Proserpine,2022,9,153,0,153
Proserpine,2022,10,154,0,154
Proserpine,2022,11,138,0,138
Proserpine,2022,12,166,0,166
Proserpine,2023,1,153,0,153
Proserpine,2023,2,128,0,128
Proserpine,2023,3,157,0,157
Proserpine,2023,4,210,0,210
Proserpine,2023,5,172,0,172
Proserpine,2023,6,175,0,175
Proserpine,2023,7,188,0,188
Proserpine,2023,8,169,0,169
Proserpine,2023,9,165,0,165
Proserpine,2023,10,177,0,177
Proserpine,2023,11,156,0,156
Proserpine,2023,12,199,0,199
Proserpine,2024,1,196,0,196
Proserpine,2024,2,140,0,140
Proserpine,2024,3,159,0,159
Proserpine,2024,4,175,0,175
Proserpine,2024,5,130,0,130
Proserpine,2024,6,134,0,134
Proserpine,2024,7,153,0,153
Proserpine,2024,8,148,0,148
Proserpine,2024,9,165,0,165
Proserpine,2024,10,170,0,170
Proserpine,2024,11,161,0,161
Proserpine,2024,12,179,0,179
Rockhampton,1985,1,478,0,478
Rockhampton,1985,2,423,0,423
Rockhampton,1985,3,467,0,467
Rockhampton,1985,4,432,0,432
Rockhampton,1985,5,484,0,484
Rockhampton,1985,6,430,0,430
Rockhampton,1985,7,424,0,424
Rockhampton,1985,8,417,0,417
Rockhampton,1985,9,422,0,422
Rockhampton,1985,10,481,0,481
Rockhampton,1985,11,431,0,431
Rockhampton,1985,12,436,0,436
Rockhampton,1986,1,446,0,446
Rockhampton,1986,2,365,0,365
Rockhampton,1986,3,414,0,414
Rockhampton,1986,4,406,0,406
Rockhampton,1986,5,500,0,500
Rockhampton,1986,6,445,0,445
Rockhampton,1986,7,465,0,465
Rockhampton,1986,8,483,0,483
Rockhampton,1986,9,538,0,538
Rockhampton,1986,10,526,0,526
Rockhampton,1986,11,497,0,497
Rockhampton,1986,12,498,0,498
Rockhampton,1987,1,455,0,455
Rockhampton,1987,2,416,0,416
Rockhampton,1987,3,464,0,464
Rockhampton,1987,4,480,0,480
Rockhampton,1987,5,438,0,438
Rockhampton,1987,6,425,0,425
Rockhampton,1987,7,511,0,511
Rockhampton,1987,8,472,0,472
Rockhampton,1987,9,457,0,457
Rockhampton,1987,10,450,0,450
Rockhampton,1987,11,481,0,481
Rockhampton,1987,12,457,0,457
Rockhampton,1988,1,462,0,462
Rockhampton,1988,2,418,0,418
Rockhampton,1988,3,446,0,446
Rockhampton,1988,4,514,0,514
Rockhampton,1988,5,469,0,469
Rockhampton,1988,6,480,0,480
Rockhampton,1988,7,483,0,483
Rockhampton,1988,8,457,0,457
Rockhampton,1988,9,498,0,498
Rockhampton,1988,10,503,0,503
Rockhampton,1988,11,467,0,467
Rockhampton,1988,12,478,0,478
Rockhampton,1989,1,457,0,457
Rockhampton,1989,2,392,0,392
Rockhampton,1989,3,472,0,472
Rockhampton,1989,4,470,0,470
Rockhampton,1989,5,529,0,529
Rockhampton,1989,6,482,0,482
Rockhampton,1989,7,488,0,488
Rockhampton,1989,8,439,0,439
Rockhampton,1989,9,319,0,319
Rockhampton,1989,10,370,0,370
Rockhampton,1989,11,336,0,336
Rockhampton,1989,12,348,0,348
Rockhampton,1990,1,370,0,370
Rockhampton,1990,2,371,0,371
Rockhampton,1990,3,406,0,406
Rockhampton,1990,4,378,0,378
Rockhampton,1990,5,349,0,349
Rockhampton,1990,6,348,0,348
Rockhampton,1990,7,365,0,365
Rockhampton,1990,8,363,0,363
Rockhampton,1990,9,397,0,397
Rockhampton,1990,10,431,0,431
Rockhampton,1990,11,424,0,424
Rockhampton,1990,12,428,0,428
Rockhampton,1991,1,338,0,338
Rockhampton,1991,2,441,0,441
Rockhampton,1991,3,496,0,496
Rockhampton,1991,4,479,0,479
Rockhampton,1991,5,492,0,492
Rockhampton,1991,6,466,0,466
Rockhampton,1991,7,508,0,508
Rockhampton,1991,8,535,0,535
Rockhampton,1991,9,521,0,521
Rockhampton,1991,10,552,0,552
Rockhampton,1991,11,512,0,512
Rockhampton,1991,12,529,0,529
Rockhampton,1992,1,542,0,542
Rockhampton,1992,2,500,0,500
Rockhampton,1992,3,465,0,465
Rockhampton,1992,4,481,0,481
Rockhampton,1992,5,478,0,478
Rockhampton,1992,6,478,0,478
Rockhampton,1992,7,524,0,524
Rockhampton,1992,8,504,0,504
Rockhampton,1992,9,520,0,520
Rockhampton,1992,10,526,0,526
Rockhampton,1992,11,472,0,472
Rockhampton,1992,12,509,0,509
Rockhampton,1993,1,535,0,535
Rockhampton,1993,2,463,0,463
Rockhampton,1993,3,489,0,489
Rockhampton,1993,4,490,0,490
Rockhampton,1993,5,490,0,490
Rockhampton,1993,6,483,0,483
Rockhampton,1993,7,500,0,500
Rockhampton,1993,8,510,0,510
Rockhampton,1993,9,520,0,520
Rockhampton,1993,10,548,0,548
Rockhampton,1993,11,527,0,527
Rockhampton,1993,12,535,0,535
Rockhampton,1994,1,483,0,483
Rockhampton,1994,2,437,0,437
Rockhampton,1994,3,470,0,470
Rockhampton,1994,4,460,0,460
Rockhampton,1994,5,485,0,485
Rockhampton,1994,6,470,0,470
Rockhampton,1994,7,547,0,547
Rockhampton,1994,8,549,0,549
Rockhampton,1994,9,554,0,554
Rockhampton,1994,10,580,0,580
Rockhampton,1994,11,570,0,570
Rockhampton,1994,12,564,0,564
Rockhampton,1995,1,582,0,582
Rockhampton,1995,2,514,0,514
Rockhampton,1995,3,594,0,594
Rockhampton,1995,4,582,0,582
Rockhampton,1995,5,574,0,574
Rockhampton,1995,6,571,0,571
Rockhampton,1995,7,580,0,580
Rockhampton,1995,8,586,0,586
Rockhampton,1995,9,588,0,588
Rockhampton,1995,10,594,0,594
Rockhampton,1995,11,581,0,581
Rockhampton,1995,12,577,0,577
Rockhampton,1996,1,598,0,598
Rockhampton,1996,2,555,0,555
Rockhampton,1996,3,581,0,581
Rockhampton,1996,4,574,0,574
Rockhampton,1996,5,575,0,575
Rockhampton,1996,6,569,0,569
Rockhampton,1996,7,584,0,584
Rockhampton,1996,8,548,0,548
Rockhampton,1996,9,545,0,545
Rockhampton,1996,10,586,0,586
Rockhampton,1996,11,561,0,561
Rockhampton,1996,12,573,0,573
Rockhampton,1997,1,583,0,583
Rockhampton,1997,2,517,0,517
Rockhampton,1997,3,551,0,551
Rockhampton,1997,4,531,0,531
Rockhampton,1997,5,553,0,553
Rockhampton,1997,6,537,0,537
Rockhampton,1997,7,558,0,558
Rockhampton,1997,8,533,0,533
Rockhampton,1997,9,551,0,551
Rockhampton,1997,10,566,0,566
Rockhampton,1997,11,556,0,556
Rockhampton,1997,12,597,0,597
Rockhampton,1998,1,582,0,582
Rockhampton,1998,2,474,0,474
Rockhampton,1998,3,533,0,533
Rockhampton,1998,4,554,0,554
Rockhampton,1998,5,549,0,549
Rockhampton,1998,6,519,0,519
Rockhampton,1998,7,490,0,490
Rockhampton,1998,8,479,0,479
Rockhampton,1998,9,468,0,468
Rockhampton,1998,10,485,0,485
Rockhampton,1998,11,458,0,458
Rockhampton,1998,12,466,0,466
Rockhampton,1999,1,408,0,408
Rockhampton,1999,2,369,0,369
Rockhampton,1999,3,421,0,421
Rockhampton,1999,4,453,0,453
Rockhampton,1999,5,463,0,463
Rockhampton,1999,6,450,0,450
Rockhampton,1999,7,486,0,486
Rockhampton,1999,8,475,0,475
Rockhampton,1999,9,467,0,467
Rockhampton,1999,10,473,0,473
Rockhampton,1999,11,463,0,463
Rockhampton,1999,12,456,0,456
Rockhampton,2000,1,401,0,401
Rockhampton,2000,2,429,0,429
Rockhampton,2000,3,484,0,484
Rockhampton,2000,4,410,0,410
Rockhampton,2000,5,454,0,454
Rockhampton,2000,6,436,0,436
Rockhampton,2000,7,443,0,443
Rockhampton,2000,8,463,0,463
Rockhampton,2000,9,443,0,443
Rockhampton,2000,10,457,0,457
Rockhampton,2000,11,419,0,419
Rockhampton,2000,12,419,0,419
Rockhampton,2001,1,419,0,419
Rockhampton,2001,2,405,0,405
Rockhampton,2001,3,451,0,451
Rockhampton,2001,4,429,0,429
Rockhampton,2001,5,466,0,466
Rockhampton,2001,6,419,0,419
Rockhampton,2001,7,380,0,380
Rockhampton,2001,8,385,0,385
Rockhampton,2001,9,306,0,306
Rockhampton,2001,10,287,0,287
Rockhampton,2001,11,294,0,294
Rockhampton,2001,12,283,0,283
Rockhampton,2002,1,274,0,274
Rockhampton,2002,2,252,0,252
Rockhampton,2002,3,270,0,270
Rockhampton,2002,4,271,0,271
Rockhampton,2002,5,276,0,276
Rockhampton,2002,6,267,0,267
Rockhampton,2002,7,268,0,268
Rockhampton,2002,8,283,0,283
Rockhampton,2002,9,312,0,312
Rockhampton,2002,10,324,0,324
Rockhampton,2002,11,275,0,275
Rockhampton,2002,12,313,0,313
Rockhampton,2003,1,315,0,315
Rockhampton,2003,2,284,0,284
Rockhampton,2003,3,276,0,276
Rockhampton,2003,4,303,0,303
Rockhampton,2003,5,314,0,314
Rockhampton,2003,6,299,0,299
Rockhampton,2003,7,311,0,311
Rockhampton,2003,8,308,0,308
Rockhampton,2003,9,300,0,300
Rockhampton,2003,10,309,0,309
Rockhampton,2003,11,300,0,300
Rockhampton,2003,12,297,0,297
Rockhampton,2004,1,338,0,338
Rockhampton,2004,2,339,0,339
Rockhampton,2004,3,366,0,366
Rockhampton,2004,4,339,0,339
Rockhampton,2004,5,388,0,388
Rockhampton,2004,6,380,0,380
Rockhampton,2004,7,395,0,395
Rockhampton,2004,8,396,0,396
Rockhampton,2004,9,390,0,390
Rockhampton,2004,10,398,0,398
Rockhampton,2004,11,407,0,407
Rockhampton,2004,12,479,0,479
Rockhampton,2005,1,462,0,462
Rockhampton,2005,2,439,0,439
Rockhampton,2005,3,476,0,476
Rockhampton,2005,4,459,0,459
Rockhampton,2005,5,479,0,479
Rockhampton,2005,6,529,0,529
Rockhampton,2005,7,537,0,537
Rockhampton,2005,8,550,0,550
Rockhampton,2005,9,526,0,526
Rockhampton,2005,10,538,0,538
Rockhampton,2005,11,517,0,517
Rockhampton,2005,12,500,0,500
Rockhampton,2006,1,460,0,460
Rockhampton,2006,2,457,0,457
Rockhampton,2006,3,516,0,516
Rockhampton,2006,4,476,0,476
Rockhampton,2006,5,543,0,543
Rockhampton,2006,6,501,0,501
Rockhampton,2006,7,504,0,504
Rockhampton,2006,8,511,0,511
Rockhampton,2006,9,489,0,489
Rockhampton,2006,10,507,0,507
Rockhampton,2006,11,493,0,493
Rockhampton,2006,12,453,0,453
Rockhampton,2007,1,435,0,435
Rockhampton,2007,2,446,0,446
Rockhampton,2007,3,507,0,507
Rockhampton,2007,4,475,0,475
Rockhampton,2007,5,512,0,512
Rockhampton,2007,6,486,0,486
Rockhampton,2007,7,499,0,499
Rockhampton,2007,8,494,0,494
Rockhampton,2007,9,467,0,467
Rockhampton,2007,10,493,0,493
Rockhampton,2007,11,480,0,480
Rockhampton,2007,12,483,0,483
Rockhampton,2008,1,467,0,467
Rockhampton,2008,2,430,0,430
Rockhampton,2008,3,442,0,442
Rockhampton,2008,4,447,0,447
Rockhampton,2008,5,482,0,482
Rockhampton,2008,6,472,0,472
Rockhampton,2008,7,511,0,511
Rockhampton,2008,8,512,0,512
Rockhampton,2008,9,491,0,491
Rockhampton,2008,10,541,0,541
Rockhampton,2008,11,534,0,534
Rockhampton,2008,12,518,0,518
Rockhampton,2009,1,479,0,479
Rockhampton,2009,2,444,0,444
Rockhampton,2009,3,524,0,524
Rockhampton,2009,4,547,0,547
Rockhampton,2009,5,571,0,571
Rockhampton,2009,6,534,0,534
Rockhampton,2009,7,571,0,571
Rockhampton,2009,8,539,0,539
Rockhampton,2009,9,518,0,518
Rockhampton,2009,10,552,0,552
Rockhampton,2009,11,536,0,536
Rockhampton,2009,12,540,0,540
Rockhampton,2010,1,536,0,536
Rockhampton,2010,2,557,0,557
Rockhampton,2010,3,611,0,611
Rockhampton,2010,4,618,0,618
Rockhampton,2010,5,619,0,619
Rockhampton,2010,6,606,0,606
Rockhampton,2010,7,628,0,628
Rockhampton,2010,8,618,0,618
Rockhampton,2010,9,617,0,617
Rockhampton,2010,10,639,0,639
Rockhampton,2010,11,629,0,629
Rockhampton,2010,12,617,0,617
Rockhampton,2011,1,158,0,158
Rockhampton,2011,2,505,0,505
Rockhampton,2011,3,593,0,593
Rockhampton,2011,4,564,0,564
Rockhampton,2011,5,596,0,596
Rockhampton,2011,6,574,0,574
Rockhampton,2011,7,580,0,580
Rockhampton,2011,8,586,0,586
Rockhampton,2011,9,567,0,567
Rockhampton,2011,10,521,0,521
Rockhampton,2011,11,516,0,516
Rockhampton,2011,12,510,0,510
Rockhampton,2012,1,489,0,489
Rockhampton,2012,2,507,0,507
Rockhampton,2012,3,561,0,561
Rockhampton,2012,4,502,0,502
Rockhampton,2012,5,571,0,571
Rockhampton,2012,6,533,0,533
Rockhampton,2012,7,589,0,589
Rockhampton,2012,8,606,0,606
Rockhampton,2012,9,578,0,578
Rockhampton,2012,10,597,0,597
Rockhampton,2012,11,604,0,604
Rockhampton,2012,12,584,0,584
Rockhampton,2013,1,570,0,570
Rockhampton,2013,2,535,0,535
Rockhampton,2013,3,598,0,598
Rockhampton,2013,4,583,0,583
Rockhampton,2013,5,582,0,582
Rockhampton,2013,6,537,0,537
Rockhampton,2013,7,599,0,599
Rockhampton,2013,8,574,0,574
Rockhampton,2013,9,564,0,564
Rockhampton,2013,10,596,0,596
Rockhampton,2013,11,531,0,531
Rockhampton,2013,12,516,0,516
Rockhampton,2014,1,491,0,491
Rockhampton,2014,2,466,0,466
Rockhampton,2014,3,522,0,522
Rockhampton,2014,4,502,0,502
Rockhampton,2014,5,534,0,534
Rockhampton,2014,6,507,0,507
Rockhampton,2014,7,538,0,538
Rockhampton,2014,8,530,0,530
Rockhampton,2014,9,514,0,514
Rockhampton,2014,10,535,0,535
Rockhampton,2014,11,498,0,498
Rockhampton,2014,12,514,0,514
Rockhampton,2015,1,509,0,509
Rockhampton,2015,2,428,0,428
Rockhampton,2015,3,517,0,517
Rockhampton,2015,4,441,0,441
Rockhampton,2015,5,463,0,463
Rockhampton,2015,6,436,0,436
Rockhampton,2015,7,468,0,468
Rockhampton,2015,8,460,0,460
Rockhampton,2015,9,439,0,439
Rockhampton,2015,10,454,0,454
Rockhampton,2015,11,432,0,432
Rockhampton,2015,12,420,0,420
Rockhampton,2016,1,381,0,381
Rockhampton,2016,2,421,0,421
Rockhampton,2016,3,446,0,446
Rockhampton,2016,4,424,0,424
Rockhampton,2016,5,444,0,444
Rockhampton,2016,6,437,0,437
Rockhampton,2016,7,442,0,442
Rockhampton,2016,8,436,0,436
Rockhampton,2016,9,429,0,429
Rockhampton,2016,10,419,0,419
Rockhampton,2016,11,436,0,436
Rockhampton,2016,12,447,0,447
Rockhampton,2017,1,394,0,394
Rockhampton,2017,2,411,0,411
Rockhampton,2017,3,427,0,427
Rockhampton,2017,4,248,0,248
Rockhampton,2017,5,407,0,407
Rockhampton,2017,6,404,0,404
Rockhampton,2017,7,417,0,417
Rockhampton,2017,8,434,0,434
Rockhampton,2017,9,412,0,412
Rockhampton,2017,10,424,0,424
Rockhampton,2017,11,429,0,429
Rockhampton,2017,12,402,0,402
Rockhampton,2018,1,396,0,396
Rockhampton,2018,2,362,0,362
Rockhampton,2018,3,412,0,412
Rockhampton,2018,4,404,0,404
Rockhampton,2018,5,456,0,456
Rockhampton,2018,6,370,0,370
Rockhampton,2018,7,403,0,403
Rockhampton,2018,8,407,0,407
Rockhampton,2018,9,390,0,390
Rockhampton,2018,10,413,0,413
Rockhampton,2018,11,388,0,388
Rockhampton,2018,12,377,0,377
Rockhampton,2019,1,386,0,386
Rockhampton,2019,2,364,0,364
Rockhampton,2019,3,394,0,394
Rockhampton,2019,4,380,0,380
Rockhampton,2019,5,407,0,407
Rockhampton,2019,6,385,0,385
Rockhampton,2019,7,408,0,408
Rockhampton,2019,8,390,0,390
Rockhampton,2019,9,382,0,382
Rockhampton,2019,10,408,0,408
Rockhampton,2019,11,382,0,382
Rockhampton,2019,12,372,0,372
Rockhampton,2020,1,379,0,379
Rockhampton,2020,2,367,0,367
Rockhampton,2020,3,332,0,332
Rockhampton,2020,4,88,0,88
Rockhampton,2020,5,68,0,68
Rockhampton,2020,6,105,0,105
Rockhampton,2020,7,170,0,170
Rockhampton,2020,8,198,0,198
Rockhampton,2020,9,215,0,215
Rockhampton,2020,10,239,0,239
Rockhampton,2020,11,280,0,280
Rockhampton,2020,12,294,0,294
Rockhampton,2021,1,279,0,279
Rockhampton,2021,2,258,0,258
Rockhampton,2021,3,317,0,317
Rockhampton,2021,4,313,0,313
Rockhampton,2021,5,325,0,325
Rockhampton,2021,6,338,0,338
Rockhampton,2021,7,345,0,345
Rockhampton,2021,8,236,0,236
Rockhampton,2021,9,284,0,284
Rockhampton,2021,10,327,0,327
Rockhampton,2021,11,349,0,349
Rockhampton,2021,12,350,0,350
Rockhampton,2022,1,284,0,284
Rockhampton,2022,2,246,0,246
Rockhampton,2022,3,315,0,315
Rockhampton,2022,4,289,0,289
Rockhampton,2022,5,338,0,338
Rockhampton,2022,6,349,0,349
Rockhampton,2022,7,342,0,342
Rockhampton,2022,8,336,0,336
Rockhampton,2022,9,301,0,301
Rockhampton,2022,10,318,0,318
Rockhampton,2022,11,361,0,361
Rockhampton,2022,12,377,0,377
Rockhampton,2023,1,376,0,376
Rockhampton,2023,2,347,0,347
Rockhampton,2023,3,420,0,420
Rockhampton,2023,4,400,0,400
Rockhampton,2023,5,456,0,456
Rockhampton,2023,6,438,0,438
Rockhampton,2023,7,437,0,437
Rockhampton,2023,8,448,0,448
Rockhampton,2023,9,424,0,424
Rockhampton,2023,10,441,0,441
Rockhampton,2023,11,438,0,438
Rockhampton,2023,12,408,0,408
Rockhampton,2024,1,372,0,372
Rockhampton,2024,2,391,0,391
Rockhampton,2024,3,422,0,422
Rockhampton,2024,4,435,0,435
Rockhampton,2024,5,439,0,439
Rockhampton,2024,6,388,0,388
Rockhampton,2024,7,425,0,425
Rockhampton,2024,8,417,0,417
Rockhampton,2024,9,403,0,403
Rockhampton,2024,10,417,0,417
Rockhampton,2024,11,392,0,392
Rockhampton,2024,12,372,0,372
Sunshine Coast,1985,1,199,0,199
Sunshine Coast,1985,2,144,0,144
Sunshine Coast,1985,3,174,0,174
Sunshine Coast,1985,4,187,0,187
Sunshine Coast,1985,5,205,0,205
Sunshine Coast,1985,6,179,0,179
Sunshine Coast,1985,7,159,0,159
Sunshine Coast,1985,8,198,0,198
Sunshine Coast,1985,9,169,0,169
Sunshine Coast,1985,10,140,0,140
Sunshine Coast,1985,11,155,0,155
Sunshine Coast,1985,12,174,0,174
Sunshine Coast,1986,1,231,0,231
Sunshine Coast,1986,2,163,0,163
Sunshine Coast,1986,3,134,0,134
Sunshine Coast,1986,4,147,0,147
Sunshine Coast,1986,5,181,0,181
Sunshine Coast,1986,6,157,0,157
Sunshine Coast,1986,7,158,0,158
Sunshine Coast,1986,8,165,0,165
Sunshine Coast,1986,9,206,0,206
Sunshine Coast,1986,10,178,0,178
Sunshine Coast,1986,11,168,0,168
Sunshine Coast,1986,12,201,0,201
Sunshine Coast,1987,1,166,0,166
Sunshine Coast,1987,2,124,0,124
Sunshine Coast,1987,3,116,0,116
Sunshine Coast,1987,4,171,0,171
Sunshine Coast,1987,5,136,0,136
Sunshine Coast,1987,6,163,0,163
Sunshine Coast,1987,7,209,0,209
Sunshine Coast,1987,8,208,0,208
Sunshine Coast,1987,9,223,0,223
Sunshine Coast,1987,10,267,0,267
Sunshine Coast,1987,11,247,0,247
Sunshine Coast,1987,12,289,0,289
Sunshine Coast,1988,1,295,0,295
Sunshine Coast,1988,2,241,0,241
Sunshine Coast,1988,3,224,0,224
Sunshine Coast,1988,4,219,0,219
Sunshine Coast,1988,5,228,0,228
Sunshine Coast,1988,6,264,0,264
Sunshine Coast,1988,7,246,0,246
Sunshine Coast,1988,8,252,0,252
Sunshine Coast,1988,9,260,0,260
Sunshine Coast,1988,10,251,0,251
Sunshine Coast,1988,11,181,0,181
Sunshine Coast,1988,12,235,0,235
Sunshine Coast,1989,1,258,0,258
Sunshine Coast,1989,2,182,0,182
Sunshine Coast,1989,3,196,0,196
Sunshine Coast,1989,4,171,0,171
Sunshine Coast,1989,5,194,0,194
Sunshine Coast,1989,6,169,0,169
Sunshine Coast,1989,7,202,0,202
Sunshine Coast,1989,8,134,0,134
Sunshine Coast,1989,9,25,0,25
Sunshine Coast,1989,10,66,0,66
Sunshine Coast,1989,11,68,0,68
Sunshine Coast,1989,12,121,0,121
Sunshine Coast,1990,1,177,0,177
Sunshine Coast,1990,2,152,0,152
Sunshine Coast,1990,3,130,0,130
Sunshine Coast,1990,4,179,0,179
Sunshine Coast,1990,5,157,0,157
Sunshine Coast,1990,6,158,0,158
Sunshine Coast,1990,7,187,0,187
Sunshine Coast,1990,8,218,0,218
Sunshine Coast,1990,9,197,0,197
Sunshine Coast,1990,10,214,0,214
Sunshine Coast,1990,11,186,0,186
Sunshine Coast,1990,12,213,0,213
Sunshine Coast,1991,1,150,0,150
Sunshine Coast,1991,2,140,0,140
Sunshine Coast,1991,3,160,0,160
Sunshine Coast,1991,4,158,0,158
Sunshine Coast,1991,5,165,0,165
Sunshine Coast,1991,6,153,0,153
Sunshine Coast,1991,7,152,0,152
Sunshine Coast,1991,8,72,0,72
Sunshine Coast,1991,9,78,0,78
Sunshine Coast,1991,10,79,0,79
Sunshine Coast,1991,11,79,0,79
Sunshine Coast,1991,12,91,0,91
Sunshine Coast,1992,1,92,0,92
Sunshine Coast,1992,2,74,0,74
Sunshine Coast,1992,3,91,0,91
Sunshine Coast,1992,4,120,0,120
Sunshine Coast,1992,5,115,0,115
Sunshine Coast,1992,6,104,0,104
Sunshine Coast,1992,7,117,0,117
Sunshine Coast,1992,8,112,0,112
Sunshine Coast,1992,9,122,0,122
Sunshine Coast,1992,10,119,0,119
Sunshine Coast,1992,11,128,0,128
Sunshine Coast,1992,12,148,0,148
Sunshine Coast,1993,1,183,0,183
Sunshine Coast,1993,2,107,0,107
Sunshine Coast,1993,3,116,0,116
Sunshine Coast,1993,4,155,0,155
Sunshine Coast,1993,5,158,0,158
Sunshine Coast,1993,6,166,0,166
Sunshine Coast,1993,7,212,0,212
Sunshine Coast,1993,8,187,0,187
Sunshine Coast,1993,9,235,0,235
Sunshine Coast,1993,10,245,0,245
Sunshine Coast,1993,11,191,0,191
Sunshine Coast,1993,12,222,0,222
Sunshine Coast,1994,1,201,0,201
Sunshine Coast,1994,2,167,0,167
Sunshine Coast,1994,3,182,0,182
Sunshine Coast,1994,4,199,0,199
Sunshine Coast,1994,5,226,0,226
Sunshine Coast,1994,6,192,0,192
Sunshine Coast,1994,7,232,0,232
Sunshine Coast,1994,8,245,0,245
Sunshine Coast,1994,9,279,0,279
Sunshine Coast,1994,10,279,0,279
Sunshine Coast,1994,11,237,0,237
Sunshine Coast,1994,12,270,0,270
Sunshine Coast,1995,1,306,0,306
Sunshine Coast,1995,2,225,0,225
Sunshine Coast,1995,3,276,0,276
Sunshine Coast,1995,4,317,0,317
Sunshine Coast,1995,5,273,0,273
Sunshine Coast,1995,6,271,0,271
Sunshine Coast,1995,7,330,0,330
Sunshine Coast,1995,8,317,0,317
Sunshine Coast,1995,9,332,0,332
Sunshine Coast,1995,10,341,0,341
Sunshine Coast,1995,11,309,0,309
Sunshine Coast,1995,12,379,0,379
Sunshine Coast,1996,1,438,0,438
Sunshine Coast,1996,2,343,0,343
Sunshine Coast,1996,3,388,0,388
Sunshine Coast,1996,4,411,0,411
Sunshine Coast,1996,5,291,0,291
Sunshine Coast,1996,6,275,0,275
Sunshine Coast,1996,7,348,0,348
Sunshine Coast,1996,8,345,0,345
Sunshine Coast,1996,9,386,0,386
Sunshine Coast,1996,10,412,0,412
Sunshine Coast,1996,11,343,0,343
Sunshine Coast,1996,12,331,0,331
Sunshine Coast,1997,1,298,0,298
Sunshine Coast,1997,2,206,0,206
Sunshine Coast,1997,3,280,0,280
Sunshine Coast,1997,4,245,0,245
Sunshine Coast,1997,5,212,0,212
Sunshine Coast,1997,6,226,0,226
Sunshine Coast,1997,7,241,0,241
Sunshine Coast,1997,8,238,0,238
Sunshine Coast,1997,9,282,0,282
Sunshine Coast,1997,10,295,0,295
Sunshine Coast,1997,11,265,0,265
Sunshine Coast,1997,12,296,0,296
Sunshine Coast,1998,1,287,0,287
Sunshine Coast,1998,2,205,0,205
Sunshine Coast,1998,3,233,0,233
Sunshine Coast,1998,4,253,0,253
Sunshine Coast,1998,5,239,0,239
Sunshine Coast,1998,6,230,0,230
Sunshine Coast,1998,7,245,0,245
Sunshine Coast,1998,8,258,0,258
Sunshine Coast,1998,9,288,0,288
Sunshine Coast,1998,10,307,0,307
Sunshine Coast,1998,11,379,0,379
Sunshine Coast,1998,12,383,0,383
Sunshine Coast,1999,1,401,0,401
Sunshine Coast,1999,2,301,0,301
Sunshine Coast,1999,3,360,0,360
Sunshine Coast,1999,4,375,0,375
Sunshine Coast,1999,5,356,0,356
Sunshine Coast,1999,6,344,0,344
Sunshine Coast,1999,7,377,0,377
Sunshine Coast,1999,8,367,0,367
Sunshine Coast,1999,9,397,0,397
Sunshine Coast,1999,10,457,0,457
Sunshine Coast,1999,11,390,0,390
Sunshine Coast,1999,12,430,0,430
Sunshine Coast,2000,1,443,0,443
Sunshine Coast,2000,2,321,0,321
Sunshine Coast,2000,3,370,0,370
Sunshine Coast,2000,4,417,0,417
Sunshine Coast,2000,5,390,0,390
Sunshine Coast,2000,6,457,0,457
Sunshine Coast,2000,7,418,0,418
Sunshine Coast,2000,8,446,0,446
Sunshine Coast,2000,9,443,0,443
Sunshine Coast,2000,10,447,0,447
Sunshine Coast,2000,11,429,0,429
Sunshine Coast,2000,12,413,0,413
Sunshine Coast,2001,1,406,0,406
Sunshine Coast,2001,2,327,0,327
Sunshine Coast,2001,3,358,0,358
Sunshine Coast,2001,4,361,0,361
Sunshine Coast,2001,5,319,0,319
Sunshine Coast,2001,6,314,0,314
Sunshine Coast,2001,7,356,0,356
Sunshine Coast,2001,8,350,0,350
Sunshine Coast,2001,9,239,0,239
Sunshine Coast,2001,10,185,0,185
Sunshine Coast,2001,11,203,0,203
Sunshine Coast,2001,12,195,0,195
Sunshine Coast,2002,1,215,0,215
Sunshine Coast,2002,2,146,0,146
Sunshine Coast,2002,3,196,0,196
Sunshine Coast,2002,4,190,0,190
Sunshine Coast,2002,5,152,0,152
Sunshine Coast,2002,6,158,0,158
Sunshine Coast,2002,7,180,0,180
Sunshine Coast,2002,8,175,0,175
Sunshine Coast,2002,9,186,0,186
Sunshine Coast,2002,10,204,0,204
Sunshine Coast,2002,11,210,0,210
Sunshine Coast,2002,12,233,0,233
Sunshine Coast,2003,1,261,0,261
Sunshine Coast,2003,2,171,0,171
Sunshine Coast,2003,3,209,0,209
Sunshine Coast,2003,4,203,0,203
Sunshine Coast,2003,5,201,0,201
Sunshine Coast,2003,6,207,0,207
Sunshine Coast,2003,7,223,0,223
Sunshine Coast,2003,8,230,0,230
Sunshine Coast,2003,9,231,0,231
Sunshine Coast,2003,10,248,0,248
Sunshine Coast,2003,11,231,0,231
Sunshine Coast,2003,12,274,0,274
Sunshine Coast,2004,1,276,0,276
Sunshine Coast,2004,2,224,0,224
Sunshine Coast,2004,3,234,0,234
Sunshine Coast,2004,4,232,0,232
Sunshine Coast,2004,5,245,0,245
Sunshine Coast,2004,6,240,0,240
Sunshine Coast,2004,7,269,0,269
Sunshine Coast,2004,8,282,0,282
Sunshine Coast,2004,9,282,0,282
Sunshine Coast,2004,10,357,0,357
Sunshine Coast,2004,11,342,0,342
Sunshine Coast,2004,12,402,0,402
Sunshine Coast,2005,1,392,0,392
Sunshine Coast,2005,2,317,0,317
Sunshine Coast,2005,3,351,0,351
Sunshine Coast,2005,4,329,0,329
Sunshine Coast,2005,5,327,0,327
Sunshine Coast,2005,6,308,0,308
Sunshine Coast,2005,7,338,0,338
Sunshine Coast,2005,8,251,0,251
Sunshine Coast,2005,9,252,0,252
Sunshine Coast,2005,10,261,0,261
Sunshine Coast,2005,11,230,0,230
Sunshine Coast,2005,12,268,0,268
Sunshine Coast,2006,1,280,0,280
Sunshine Coast,2006,2,207,0,207
Sunshine Coast,2006,3,239,0,239
Sunshine Coast,2006,4,259,0,259
Sunshine Coast,2006,5,237,0,237
Sunshine Coast,2006,6,245,0,245
Sunshine Coast,2006,7,265,0,265
Sunshine Coast,2006,8,251,0,251
Sunshine Coast,2006,9,259,0,259
Sunshine Coast,2006,10,266,0,266
Sunshine Coast,2006,11,257,0,257
Sunshine Coast,2006,12,278,0,278
Sunshine Coast,2007,1,277,0,277
Sunshine Coast,2007,2,239,0,239
Sunshine Coast,2007,3,263,0,263
Sunshine Coast,2007,4,258,0,258
Sunshine Coast,2007,5,245,0,245
Sunshine Coast,2007,6,230,0,230
Sunshine Coast,2007,7,234,0,234
Sunshine Coast,2007,8,219,0,219
Sunshine Coast,2007,9,228,0,228
Sunshine Coast,2007,10,266,0,266
Sunshine Coast,2007,11,261,0,261
Sunshine Coast,2007,12,295,0,295
Sunshine Coast,2008,1,289,0,289
Sunshine Coast,2008,2,253,0,253
Sunshine Coast,2008,3,295,0,295
Sunshine Coast,2008,4,291,0,291
Sunshine Coast,2008,5,296,0,296
Sunshine Coast,2008,6,305,0,305
Sunshine Coast,2008,7,315,0,315
Sunshine Coast,2008,8,260,0,260
Sunshine Coast,2008,9,255,0,255
Sunshine Coast,2008,10,264,0,264
Sunshine Coast,2008,11,276,0,276
Sunshine Coast,2008,12,288,0,288
Sunshine Coast,2009,1,310,0,310
Sunshine Coast,2009,2,210,0,210
Sunshine Coast,2009,3,228,0,228
Sunshine Coast,2009,4,265,0,265
Sunshine Coast,2009,5,242,0,242
Sunshine Coast,2009,6,224,0,224
Sunshine Coast,2009,7,243,0,243
Sunshine Coast,2009,8,237,0,237
Sunshine Coast,2009,9,234,0,234
Sunshine Coast,2009,10,251,0,251
Sunshine Coast,2009,11,239,0,239
Sunshine Coast,2009,12,244,0,244
Sunshine Coast,2010,1,253,0,253
Sunshine Coast,2010,2,198,0,198
Sunshine Coast,2010,3,223,0,223
Sunshine Coast,2010,4,287,0,287
Sunshine Coast,2010,5,276,0,276
Sunshine Coast,2010,6,265,0,265
Sunshine Coast,2010,7,311,0,311
Sunshine Coast,2010,8,268,0,268
Sunshine Coast,2010,9,286,0,286
Sunshine Coast,2010,10,312,0,312
Sunshine Coast,2010,11,293,0,293
Sunshine Coast,2010,12,323,0,323
Sunshine Coast,2011,1,353,0,353
Sunshine Coast,2011,2,256,0,256
Sunshine Coast,2011,3,280,0,280
Sunshine Coast,2011,4,309,0,309
Sunshine Coast,2011,5,261,0,261
Sunshine Coast,2011,6,237,0,237
Sunshine Coast,2011,7,259,0,259
Sunshine Coast,2011,8,218,0,218
Sunshine Coast,2011,9,239,0,239
Sunshine Coast,2011,10,233,0,233
Sunshine Coast,2011,11,209,0,209
Sunshine Coast,2011,12,256,0,256
Sunshine Coast,2012,1,274,0,274
Sunshine Coast,2012,2,189,0,189
Sunshine Coast,2012,3,203,0,203
Sunshine Coast,2012,4,234,0,234
Sunshine Coast,2012,5,202,0,202
Sunshine Coast,2012,6,204,0,204
Sunshine Coast,2012,7,242,10,252
Sunshine Coast,2012,8,196,8,204
Sunshine Coast,2012,9,242,6,248
Sunshine Coast,2012,10,229,0,229
Sunshine Coast,2012,11,228,0,228
Sunshine Coast,2012,12,252,0,252
Sunshine Coast,2013,1,244,0,244
Sunshine Coast,2013,2,175,0,175
Sunshine Coast,2013,3,212,0,212
Sunshine Coast,2013,4,257,0,257
Sunshine Coast,2013,5,216,0,216
Sunshine Coast,2013,6,239,4,243
Sunshine Coast,2013,7,263,9,272
Sunshine Coast,2013,8,246,8,254
Sunshine Coast,2013,9,269,9,278
Sunshine Coast,2013,10,272,4,276
Sunshine Coast,2013,11,255,0,255
Sunshine Coast,2013,12,294,0,294
Sunshine Coast,2014,1,289,0,289
Sunshine Coast,2014,2,217,0,217
Sunshine Coast,2014,3,253,0,253
Sunshine Coast,2014,4,272,0,272
Sunshine Coast,2014,5,219,0,219
Sunshine Coast,2014,6,226,2,228
Sunshine Coast,2014,7,251,11,262
Sunshine Coast,2014,8,218,10,228
Sunshine Coast,2014,9,248,10,258
Sunshine Coast,2014,10,258,9,267
Sunshine Coast,2014,11,237,0,237
Sunshine Coast,2014,12,258,0,258
Sunshine Coast,2015,1,271,0,271
Sunshine Coast,2015,2,180,0,180
Sunshine Coast,2015,3,209,0,209
Sunshine Coast,2015,4,255,0,255
Sunshine Coast,2015,5,207,0,207
Sunshine Coast,2015,6,220,2,222
Sunshine Coast,2015,7,260,13,273
Sunshine Coast,2015,8,244,13,257
Sunshine Coast,2015,9,280,13,293
Sunshine Coast,2015,10,283,9,292
Sunshine Coast,2015,11,258,0,258
Sunshine Coast,2015,12,296,7,303
Sunshine Coast,2016,1,318,10,328
Sunshine Coast,2016,2,224,8,232
Sunshine Coast,2016,3,265,0,265
Sunshine Coast,2016,4,290,0,290
Sunshine Coast,2016,5,242,0,242
Sunshine Coast,2016,6,249,0,249
Sunshine Coast,2016,7,312,17,329
Sunshine Coast,2016,8,268,13,281
Sunshine Coast,2016,9,307,14,321
Sunshine Coast,2016,10,330,13,343
Sunshine Coast,2016,11,324,0,324
Sunshine Coast,2016,12,355,0,355
Sunshine Coast,2017,1,362,0,362
Sunshine Coast,2017,2,259,0,259
Sunshine Coast,2017,3,291,0,291
Sunshine Coast,2017,4,366,0,366
Sunshine Coast,2017,5,278,0,278
Sunshine Coast,2017,6,280,0,280
Sunshine Coast,2017,7,345,14,359
Sunshine Coast,2017,8,305,13,318
Sunshine Coast,2017,9,340,14,354
Sunshine Coast,2017,10,370,14,384
Sunshine Coast,2017,11,350,0,350
Sunshine Coast,2017,12,413,0,413
Sunshine Coast,2018,1,424,0,424
Sunshine Coast,2018,2,296,0,296
Sunshine Coast,2018,3,335,0,335
Sunshine Coast,2018,4,372,0,372
Sunshine Coast,2018,5,299,0,299
Sunshine Coast,2018,6,304,0,304
Sunshine Coast,2018,7,370,15,385
Sunshine Coast,2018,8,344,18,362
Sunshine Coast,2018,9,361,15,376
Sunshine Coast,2018,10,383,13,396
Sunshine Coast,2018,11,356,0,356
Sunshine Coast,2018,12,404,0,404
Sunshine Coast,2019,1,397,0,397
Sunshine Coast,2019,2,286,0,286
Sunshine Coast,2019,3,332,0,332
Sunshine Coast,2019,4,418,0,418
Sunshine Coast,2019,5,336,0,336
Sunshine Coast,2019,6,332,0,332
Sunshine Coast,2019,7,391,15,406
Sunshine Coast,2019,8,352,17,369
Sunshine Coast,2019,9,386,18,404
Sunshine Coast,2019,10,397,12,409
Sunshine Coast,2019,11,372,0,372
Sunshine Coast,2019,12,400,0,400
Sunshine Coast,2020,1,339,0,339
Sunshine Coast,2020,2,296,0,296
Sunshine Coast,2020,3,264,0,264
Sunshine Coast,2020,4,0,0,0
Sunshine Coast,2020,5,0,0,0
Sunshine Coast,2020,6,0,0,0
Sunshine Coast,2020,7,42,0,42
Sunshine Coast,2020,8,24,0,24
Sunshine Coast,2020,9,29,0,29
Sunshine Coast,2020,10,39,0,39
Sunshine Coast,2020,11,57,0,57
Sunshine Coast,2020,12,222,0,222
Sunshine Coast,2021,1,267,0,267
Sunshine Coast,2021,2,219,0,219
Sunshine Coast,2021,3,392,0,392
Sunshine Coast,2021,4,506,0,506
Sunshine Coast,2021,5,437,0,437
Sunshine Coast,2021,6,350,0,350
Sunshine Coast,2021,7,239,5,244
Sunshine Coast,2021,8,92,0,92
Sunshine Coast,2021,9,84,0,84
Sunshine Coast,2021,10,83,0,83
Sunshine Coast,2021,11,68,0,68
Sunshine Coast,2021,12,367,0,367
Sunshine Coast,2022,1,522,0,522
Sunshine Coast,2022,2,314,0,314
Sunshine Coast,2022,3,470,0,470
Sunshine Coast,2022,4,637,0,637
Sunshine Coast,2022,5,552,0,552
Sunshine Coast,2022,6,485,0,485
Sunshine Coast,2022,7,459,6,465
Sunshine Coast,2022,8,414,9,423
Sunshine Coast,2022,9,455,8,463
Sunshine Coast,2022,10,474,5,479
Sunshine Coast,2022,11,459,0,459
Sunshine Coast,2022,12,524,0,524
Sunshine Coast,2023,1,557,0,557
Sunshine Coast,2023,2,409,0,409
Sunshine Coast,2023,3,508,0,508
Sunshine Coast,2023,4,565,0,565
Sunshine Coast,2023,5,548,0,548
Sunshine Coast,2023,6,548,3,551
Sunshine Coast,2023,7,587,13,600
Sunshine Coast,2023,8,521,12,533
Sunshine Coast,2023,9,536,13,549
Sunshine Coast,2023,10,584,7,591
Sunshine Coast,2023,11,556,0,556
Sunshine Coast,2023,12,630,0,630
Sunshine Coast,2024,1,677,0,677
Sunshine Coast,2024,2,520,0,520
Sunshine Coast,2024,3,556,0,556
Sunshine Coast,2024,4,573,0,573
Sunshine Coast,2024,5,387,0,387
Sunshine Coast,2024,6,373,3,376
Sunshine Coast,2024,7,424,13,437
Sunshine Coast,2024,8,391,11,402
Sunshine Coast,2024,9,411,12,423
Sunshine Coast,2024,10,424,8,432
Sunshine Coast,2024,11,441,0,441
Sunshine Coast,2024,12,514,9,523
Sydney,1985,1,4653,827,5480
Sydney,1985,2,4274,766,5040
Sydney,1985,3,4864,828,5692
Sydney,1985,4,4658,796,5454
Sydney,1985,5,5078,840,5918
Sydney,1985,6,4574,819,5393
Sydney,1985,7,4220,763,4983
Sydney,1985,8,4973,871,5844
Sydney,1985,9,5035,837,5872
Sydney,1985,10,5273,857,6130
Sydney,1985,11,4953,858,5811
Sydney,1985,12,4986,913,5899
Sydney,1986,1,4842,921,5763
Sydney,1986,2,4426,800,5226
Sydney,1986,3,4849,912,5761
Sydney,1986,4,4945,885,5830
Sydney,1986,5,5203,924,6127
Sydney,1986,6,4749,896,5645
Sydney,1986,7,4960,913,5873
Sydney,1986,8,5190,941,6131
Sydney,1986,9,5111,851,5962
Sydney,1986,10,5334,958,6292
Sydney,1986,11,5007,985,5992
Sydney,1986,12,5140,1021,6161
Sydney,1987,1,4907,1045,5952
Sydney,1987,2,4587,933,5520
Sydney,1987,3,5046,1021,6067
Sydney,1987,4,5114,972,6086
Sydney,1987,5,4903,1028,5931
Sydney,1987,6,4965,981,5946
Sydney,1987,7,5443,1036,6479
Sydney,1987,8,5258,1051,6309
Sydney,1987,9,5290,1027,6317
Sydney,1987,10,5432,1097,6529
Sydney,1987,11,5250,1078,6328
Sydney,1987,12,5315,1135,6450
Sydney,1988,1,5057,1160,6217
Sydney,1988,2,4985,1034,6019
Sydney,1988,3,5464,1096,6560
Sydney,1988,4,5154,1103,6257
Sydney,1988,5,5395,1144,6539
Sydney,1988,6,5355,1104,6459
Sydney,1988,7,5996,1172,7168
Sydney,1988,8,5902,1165,7067
Sydney,1988,9,5870,1127,6997
Sydney,1988,10,5856,1199,7055
Sydney,1988,11,5562,1242,6804
Sydney,1988,12,5542,1335,6877
Sydney,1989,1,5305,1351,6656
Sydney,1989,2,5062,1203,6265
Sydney,1989,3,5746,1268,7014
Sydney,1989,4,5179,1258,6437
Sydney,1989,5,5489,1250,6739
Sydney,1989,6,5416,1192,6608
Sydney,1989,7,5213,1266,6479
Sydney,1989,8,3559,1290,4849
Sydney,1989,9,2543,1280,3823
Sydney,1989,10,3644,1321,4965
Sydney,1989,11,3861,1324,5185
Sydney,1989,12,4205,1367,5572
Sydney,1990,1,4494,1390,5884
Sydney,1990,2,4549,1264,5813
Sydney,1990,3,5071,1381,6452
Sydney,1990,4,5340,1295,6635
Sydney,1990,5,5514,1358,6872
Sydney,1990,6,5350,1302,6652
Sydney,1990,7,5901,1347,7248
Sydney,1990,8,5530,1370,6900
Sydney,1990,9,5355,1299,6654
Sydney,1990,10,5900,1378,7278
Sydney,1990,11,5591,1324,6915
Sydney,1990,12,5623,1378,7001
Sydney,1991,1,5264,1417,6681
Sydney,1991,2,5009,1255,6264
Sydney,1991,3,5604,1384,6988
Sydney,1991,4,5667,1238,6905
Sydney,1991,5,5827,1275,7102
Sydney,1991,6,5670,1259,6929
Sydney,1991,7,6204,1335,7539
Sydney,1991,8,6033,1339,7372
Sydney,1991,9,6088,1297,7385
Sydney,1991,10,6427,1330,7757
Sydney,1991,11,6286,1360,7646
Sydney,1991,12,6421,1424,7845
Sydney,1992,1,5945,1444,7389
Sydney,1992,2,5763,1343,7106
Sydney,1992,3,6308,1395,7703
Sydney,1992,4,6598,1395,7993
Sydney,1992,5,6389,1458,7847
Sydney,1992,6,6313,1396,7709
Sydney,1992,7,6819,1450,8269
Sydney,1992,8,6573,1451,8024
Sydney,1992,9,7058,1421,8479
Sydney,1992,10,7407,1487,8894
Sydney,1992,11,6918,1508,8426
Sydney,1992,12,7065,1600,8665
Sydney,1993,1,6767,1575,8342
Sydney,1993,2,6535,1448,7983
Sydney,1993,3,7113,1563,8676
Sydney,1993,4,7037,1494,8531
Sydney,1993,5,6921,1538,8459
Sydney,1993,6,6925,1465,8390
Sydney,1993,7,7176,1532,8708
Sydney,1993,8,7075,1520,8595
Sydney,1993,9,7009,1478,8487
Sydney,1993,10,7458,1535,8993
Sydney,1993,11,7054,1411,8465
Sydney,1993,12,7073,1499,8572
Sydney,1994,1,6653,1507,8160
Sydney,1994,2,6587,1348,7935
Sydney,1994,3,7443,1463,8906
Sydney,1994,4,7267,1428,8695
Sydney,1994,5,7386,1478,8864
Sydney,1994,6,7494,1417,8911
Sydney,1994,7,7796,1515,9311
Sydney,1994,8,7758,1479,9237
Sydney,1994,9,7690,1474,9164
Sydney,1994,10,7799,1544,9343
Sydney,1994,11,7351,1560,8911
Sydney,1994,12,7642,1614,9256
Sydney,1995,1,7133,1641,8774
Sydney,1995,2,7113,1484,8597
Sydney,1995,3,7829,1614,9443
Sydney,1995,4,7892,1581,9473
Sydney,1995,5,7994,1626,9620
Sydney,1995,6,7959,1571,9530
Sydney,1995,7,8110,1655,9765
Sydney,1995,8,8215,1639,9854
Sydney,1995,9,8029,1587,9616
Sydney,1995,10,8278,1647,9925
Sydney,1995,11,8158,1667,9825
Sydney,1995,12,7933,1773,9706
Sydney,1996,1,7823,1784,9607
Sydney,1996,2,7765,1686,9451
Sydney,1996,3,8378,1773,10151
Sydney,1996,4,8126,1729,9855
Sydney,1996,5,8539,1761,10300
Sydney,1996,6,8050,1718,9768
Sydney,1996,7,8706,1797,10503
Sydney,1996,8,8612,1779,10391
Sydney,1996,9,8421,1715,10136
Sydney,1996,10,8732,1764,10496
Sydney,1996,11,8492,1740,10232
Sydney,1996,12,8346,1823,10169
Sydney,1997,1,7966,1834,9800
Sydney,1997,2,7878,1647,9525
Sydney,1997,3,8651,1783,10434
Sydney,1997,4,8329,1771,10100
Sydney,1997,5,8374,1828,10202
Sydney,1997,6,8075,1769,9844
Sydney,1997,7,8835,1866,10701
Sydney,1997,8,8741,1874,10615
Sydney,1997,9,8530,1784,10314
Sydney,1997,10,8848,1871,10719
Sydney,1997,11,8389,1907,10296
Sydney,1997,12,8248,1968,10216
Sydney,1998,1,7971,1970,9941
Sydney,1998,2,7849,1760,9609
Sydney,1998,3,8668,1925,10593
Sydney,1998,4,8423,1918,10341
Sydney,1998,5,8717,1976,10693
Sydney,1998,6,8411,1847,10258
Sydney,1998,7,9003,1961,10964
Sydney,1998,8,8837,1970,10807
Sydney,1998,9,8755,1881,10636
Sydney,1998,10,8901,1981,10882
Sydney,1998,11,8562,1844,10406
Sydney,1998,12,8420,1943,10363
Sydney,1999,1,7850,1977,9827
Sydney,1999,2,7807,1768,9575
Sydney,1999,3,8654,1933,10587
Sydney,1999,4,8286,1835,10121
Sydney,1999,5,8480,1862,10342
Sydney,1999,6,8257,1786,10043
Sydney,1999,7,8905,1954,10859
Sydney,1999,8,8966,1950,10916
Sydney,1999,9,8752,1877,10629
Sydney,1999,10,8903,1921,10824
Sydney,1999,11,8635,1911,10546
Sydney,1999,12,8686,2003,10689
Sydney,2000,1,8110,2047,10157
Sydney,2000,2,8064,1895,9959
Sydney,2000,3,8718,2028,10746
Sydney,2000,4,8283,2035,10318
Sydney,2000,5,8875,2034,10909
Sydney,2000,6,9184,1985,11169
Sydney,2000,7,9566,2141,11707
Sydney,2000,8,9753,2100,11853
Sydney,2000,9,9743,2100,11843
Sydney,2000,10,10127,2143,12270
Sydney,2000,11,9746,2031,11777
Sydney,2000,12,9672,2152,11824
Sydney,2001,1,9430,2115,11545
Sydney,2001,2,9128,1889,11017
Sydney,2001,3,10486,2095,12581
Sydney,2001,4,9843,2025,11868
Sydney,2001,5,9904,2072,11976
Sydney,2001,6,9171,1992,11163
Sydney,2001,7,9703,2046,11749
Sydney,2001,8,9839,2013,11852
Sydney,2001,9,7361,1926,9287
Sydney,2001,10,7430,1934,9364
Sydney,2001,11,7469,1828,9297
Sydney,2001,12,7300,1999,9299
Sydney,2002,1,7090,1956,9046
Sydney,2002,2,6782,1761,8543
Sydney,2002,3,6930,1925,8855
Sydney,2002,4,6832,1872,8704
Sydney,2002,5,7101,1908,9009
Sydney,2002,6,6918,1848,8766
Sydney,2002,7,7699,1972,9671
Sydney,2002,8,7571,1951,9522
Sydney,2002,9,7623,1853,9476
Sydney,2002,10,7966,1928,9894
Sydney,2002,11,7578,1968,9546
Sydney,2002,12,7554,2119,9673
Sydney,2003,1,7113,2113,9226
Sydney,2003,2,6830,1904,8734
Sydney,2003,3,7677,2061,9738
Sydney,2003,4,7152,1925,9077
Sydney,2003,5,7382,1840,9222
Sydney,2003,6,7248,1815,9063
Sydney,2003,7,7622,2028,9650
Sydney,2003,8,7556,2099,9655
Sydney,2003,9,7854,2097,9951
Sydney,2003,10,8201,2179,10380
Sydney,2003,11,7904,2166,10070
Sydney,2003,12,7737,2267,10004
Sydney,2004,1,7457,2281,9738
Sydney,2004,2,7572,2134,9706
Sydney,2004,3,8320,2318,10638
Sydney,2004,4,7825,2273,10098
Sydney,2004,5,8152,2358,10510
Sydney,2004,6,8218,2288,10506
Sydney,2004,7,8485,2408,10893
Sydney,2004,8,8643,2373,11016
Sydney,2004,9,8579,2336,10915
Sydney,2004,10,8665,2378,11043
Sydney,2004,11,8397,2357,10754
Sydney,2004,12,8437,2527,10964
Sydney,2005,1,7766,2589,10355
Sydney,2005,2,7662,2282,9944
Sydney,2005,3,8464,2461,10925
Sydney,2005,4,8110,2415,10525
Sydney,2005,5,8456,2427,10883
Sydney,2005,6,8239,2360,10599
Sydney,2005,7,8518,2502,11020
Sydney,2005,8,8652,2434,11086
Sydney,2005,9,8509,2406,10915
Sydney,2005,10,8579,2476,11055
Sydney,2005,11,8348,2391,10739
Sydney,2005,12,8256,2553,10809
Sydney,2006,1,7697,2603,10300
Sydney,2006,2,7768,2297,10065
Sydney,2006,3,8718,2502,11220
Sydney,2006,4,8169,2391,10560
Sydney,2006,5,8711,2406,11117
Sydney,2006,6,8271,2326,10597
Sydney,2006,7,8594,2469,11063
Sydney,2006,8,8768,2405,11173
Sydney,2006,9,8659,2360,11019
Sydney,2006,10,8829,2437,11266
Sydney,2006,11,8740,2390,11130
Sydney,2006,12,8454,2505,10959
Sydney,2007,1,8145,2515,10660
Sydney,2007,2,8016,2285,10301
Sydney,2007,3,9036,2459,11495
Sydney,2007,4,8448,2357,10805
Sydney,2007,5,8960,2374,11334
Sydney,2007,6,8561,2356,10917
Sydney,2007,7,8921,2479,11400
Sydney,2007,8,9236,2460,11696
Sydney,2007,9,8687,2410,11097
Sydney,2007,10,9132,2487,11619
Sydney,2007,11,8889,2453,11342
Sydney,2007,12,8804,2579,11383
Sydney,2008,1,8656,2616,11272
Sydney,2008,2,8838,2419,11257
Sydney,2008,3,9332,2561,11893
Sydney,2008,4,9182,2469,11651
Sydney,2008,5,9404,2510,11914
Sydney,2008,6,8955,2408,11363
Sydney,2008,7,9448,2577,12025
Sydney,2008,8,9288,2504,11792
Sydney,2008,9,9160,2399,11559
Sydney,2008,10,9562,2531,12093
Sydney,2008,11,9024,2488,11512
Sydney,2008,12,8867,2590,11457
Sydney,2009,1,8302,2596,10898
Sydney,2009,2,7982,2257,10239
Sydney,2009,3,8900,2470,11370
Sydney,2009,4,8542,2408,10950
Sydney,2009,5,8606,2414,11020
Sydney,2009,6,8305,2338,10643
Sydney,2009,7,8986,2549,11535
Sydney,2009,8,8783,2541,11324
Sydney,2009,9,8763,2460,11223
Sydney,2009,10,9346,2575,11921
Sydney,2009,11,9066,2487,11553
Sydney,2009,12,8889,2737,11626
Sydney,2010,1,8539,2776,11315
Sydney,2010,2,8447,2442,10889
Sydney,2010,3,9619,2641,12260
Sydney,2010,4,9477,2518,11995
Sydney,2010,5,9696,2529,12225
Sydney,2010,6,9278,2488,11766
Sydney,2010,7,9895,2668,12563
Sydney,2010,8,9641,2615,12256
Sydney,2010,9,9469,2521,11990
Sydney,2010,10,9837,2618,12455
Sydney,2010,11,9592,2582,12174
Sydney,2010,12,9713,2763,12476
Sydney,2011,1,9012,2824,11836
Sydney,2011,2,8648,2497,11145
Sydney,2011,3,9882,2722,12604
Sydney,2011,4,9377,2671,12048
Sydney,2011,5,9654,2659,12313
Sydney,2011,6,8917,2475,11392
Sydney,2011,7,9550,2791,12341
Sydney,2011,8,9639,2746,12385
Sydney,2011,9,9394,2677,12071
Sydney,2011,10,9381,2821,12202
Sydney,2011,11,9455,2700,12155
Sydney,2011,12,9365,2859,12224
Sydney,2012,1,8812,2914,11726
Sydney,2012,2,9133,2628,11761
Sydney,2012,3,9781,2732,12513
Sydney,2012,4,9525,2706,12231
Sydney,2012,5,9634,2676,12310
Sydney,2012,6,9121,2685,11806
Sydney,2012,7,10178,2896,13074
Sydney,2012,8,10371,2832,13203
Sydney,2012,9,10103,2803,12906
Sydney,2012,10,10372,2865,13237
Sydney,2012,11,10018,2760,12778
Sydney,2012,12,9760,2959,12719
Sydney,2013,1,9225,2972,12197
Sydney,2013,2,8923,2574,11497
Sydney,2013,3,10008,2865,12873
Sydney,2013,4,10080,2810,12890
Sydney,2013,5,10059,2757,12816
Sydney,2013,6,9588,2714,12302
Sydney,2013,7,10383,2971,13354
Sydney,2013,8,10140,2860,13000
Sydney,2013,9,10200,2868,13068
Sydney,2013,10,10476,2981,13457
Sydney,2013,11,9871,2896,12767
Sydney,2013,12,9892,3088,12980
Sydney,2014,1,9305,3101,12406
Sydney,2014,2,8808,2668,11476
Sydney,2014,3,9958,2961,12919
Sydney,2014,4,9847,2893,12740
Sydney,2014,5,10014,2784,12798
Sydney,2014,6,9571,2775,12346
Sydney,2014,7,10229,2967,13196
Sydney,2014,8,9988,2901,12889
Sydney,2014,9,10073,2836,12909
Sydney,2014,10,10405,2934,13339
Sydney,2014,11,9697,2784,12481
Sydney,2014,12,9910,3090,13000
Sydney,2015,1,9429,3128,12557
Sydney,2015,2,9059,2624,11683
Sydney,2015,3,10324,2845,13169
Sydney,2015,4,9934,2784,12718
Sydney,2015,5,10110,2717,12827
Sydney,2015,6,10009,2699,12708
Sydney,2015,7,10650,2929,13579
Sydney,2015,8,10432,2798,13230
Sydney,2015,9,10450,2735,13185
Sydney,2015,10,10644,2872,13516
Sydney,2015,11,10239,2809,13048
Sydney,2015,12,10242,3245,13487
Sydney,2016,1,9598,3326,12924
Sydney,2016,2,9853,2889,12742
Sydney,2016,3,10576,3090,13666
Sydney,2016,4,10180,3006,13186
Sydney,2016,5,10152,2952,13104
Sydney,2016,6,9748,2932,12680
Sydney,2016,7,10620,3246,13866
Sydney,2016,8,10646,3115,13761
Sydney,2016,9,10491,3021,13512
Sydney,2016,10,10566,3151,13717
Sydney,2016,11,10350,3051,13401
Sydney,2016,12,10234,3380,13614
Sydney,2017,1,9647,3485,13132
Sydney,2017,2,9508,2958,12466
Sydney,2017,3,10528,3211,13739
Sydney,2017,4,9955,3158,13113
Sydney,2017,5,10239,3069,13308
Sydney,2017,6,9783,3105,12888
Sydney,2017,7,10554,3652,14206
Sydney,2017,8,10421,3229,13650
Sydney,2017,9,10023,3145,13168
Sydney,2017,10,10488,3255,13743
Sydney,2017,11,10258,3161,13419
Sydney,2017,12,9922,3507,13429
Sydney,2018,1,9505,3582,13087
Sydney,2018,2,9319,3108,12427
Sydney,2018,3,10362,3381,13743
Sydney,2018,4,9933,3323,13256
Sydney,2018,5,10061,3265,13326
Sydney,2018,6,9567,3207,12774
Sydney,2018,7,10397,3539,13936
Sydney,2018,8,10264,3381,13645
Sydney,2018,9,9955,3265,13220
Sydney,2018,10,10683,3448,14131
Sydney,2018,11,10088,3382,13470
Sydney,2018,12,9699,3699,13398
Sydney,2019,1,9482,3764,13246
Sydney,2019,2,9342,3191,12533
Sydney,2019,3,10343,3430,13773
Sydney,2019,4,10104,3379,13483
Sydney,2019,5,10339,3298,13637
Sydney,2019,6,9698,3260,12958
Sydney,2019,7,10690,3493,14183
Sydney,2019,8,10150,3354,13504
Sydney,2019,9,10253,3267,13520
Sydney,2019,10,10830,3450,14280
Sydney,2019,11,10118,3345,13463
Sydney,2019,12,9908,3705,13613
Sydney,2020,1,9372,3771,13143
Sydney,2020,2,9298,2983,12281
Sydney,2020,3,8011,2336,10347
Sydney,2020,4,981,778,1759
Sydney,2020,5,870,907,1777
Sydney,2020,6,1243,901,2144
Sydney,2020,7,1990,911,2901
Sydney,2020,8,1322,1003,2325
Sydney,2020,9,1347,968,2315
Sydney,2020,10,1772,1096,2868
Sydney,2020,11,2433,1146,3579
Sydney,2020,12,4334,1178,5512
Sydney,2021,1,2150,1096,3246
Sydney,2021,2,3644,936,4580
Sydney,2021,3,6359,1068,7427
Sydney,2021,4,7581,1114,8695
Sydney,2021,5,7692,1311,9003
Sydney,2021,6,5998,1210,7208
Sydney,2021,7,1879,1094,2973
Sydney,2021,8,1204,1094,2298
Sydney,2021,9,1166,1054,2220
Sydney,2021,10,1228,1106,2334
Sydney,2021,11,3255,1223,4478
Sydney,2021,12,6488,1407,7895
Sydney,2022,1,5964,1470,7434
Sydney,2022,2,5541,1366,6907
Sydney,2022,3,7736,1626,9362
Sydney,2022,4,9316,1761,11077
Sydney,2022,5,9630,1832,11462
Sydney,2022,6,9027,1924,10951
Sydney,2022,7,9236,2283,11519
Sydney,2022,8,9187,2275,11462
Sydney,2022,9,8719,2230,10949
Sydney,2022,10,8988,2405,11393
Sydney,2022,11,9086,2593,11679
Sydney,2022,12,9125,2879,12004
Sydney,2023,1,8787,3001,11788
Sydney,2023,2,8544,2643,11187
Sydney,2023,3,9778,2913,12691
Sydney,2023,4,9106,2940,12046
Sydney,2023,5,9468,2938,12406
Sydney,2023,6,9103,3001,12104
Sydney,2023,7,9492,3264,12756
Sydney,2023,8,9571,3219,12790
Sydney,2023,9,9323,3150,12473
Sydney,2023,10,9469,3202,12671
Sydney,2023,11,9100,3256,12356
Sydney,2023,12,8971,3726,12697
Sydney,2024,1,8887,3762,12649
Sydney,2024,2,8615,3248,11863
Sydney,2024,3,9322,3380,12702
Sydney,2024,4,9304,3251,12555
Sydney,2024,5,9425,3202,12627
Sydney,2024,6,8803,3158,11961
Sydney,2024,7,9625,3379,13004
Sydney,2024,8,9000,3284,12284
Sydney,2024,9,8971,3204,12175
Sydney,2024,10,9425,3329,12754
Sydney,2024,11,8781,3315,12096
Sydney,2024,12,8745,3684,12429
Townsville,1985,1,689,10,699
Townsville,1985,2,625,8,633
Townsville,1985,3,715,8,723
Townsville,1985,4,688,9,697
Townsville,1985,5,799,9,808
Townsville,1985,6,735,8,743
Townsville,1985,7,791,10,801
Townsville,1985,8,778,8,786
Townsville,1985,9,772,8,780
Townsville,1985,10,737,10,747
Townsville,1985,11,741,8,749
Townsville,1985,12,740,9,749
Townsville,1986,1,717,9,726
Townsville,1986,2,570,8,578
Townsville,1986,3,679,8,687
Townsville,1986,4,641,13,654
Townsville,1986,5,752,15,767
Townsville,1986,6,694,16,710
Townsville,1986,7,730,14,744
Townsville,1986,8,748,14,762
Townsville,1986,9,714,15,729
Townsville,1986,10,753,13,766
Townsville,1986,11,720,14,734
Townsville,1986,12,734,13,747
Townsville,1987,1,715,16,731
Townsville,1987,2,628,12,640
Townsville,1987,3,700,12,712
Townsville,1987,4,694,10,704
Townsville,1987,5,748,12,760
Townsville,1987,6,671,8,679
Townsville,1987,7,721,9,730
Townsville,1987,8,704,9,713
Townsville,1987,9,688,12,700
Townsville,1987,10,715,14,729
Townsville,1987,11,634,13,647
Townsville,1987,12,639,12,651
Townsville,1988,1,625,20,645
Townsville,1988,2,565,13,578
Townsville,1988,3,657,12,669
Townsville,1988,4,672,15,687
Townsville,1988,5,721,14,735
Townsville,1988,6,699,12,711
Townsville,1988,7,725,14,739
Townsville,1988,8,716,15,731
Townsville,1988,9,724,14,738
Townsville,1988,10,754,15,769
Townsville,1988,11,688,18,706
Townsville,1988,12,693,24,717
Townsville,1989,1,671,22,693
Townsville,1989,2,638,21,659
Townsville,1989,3,691,24,715
Townsville,1989,4,713,22,735
Townsville,1989,5,805,22,827
Townsville,1989,6,707,24,731
Townsville,1989,7,718,23,741
Townsville,1989,8,550,20,570
Townsville,1989,9,318,24,342
Townsville,1989,10,357,20,377
Townsville,1989,11,304,17,321
Townsville,1989,12,311,15,326
Townsville,1990,1,343,12,355
Townsville,1990,2,357,12,369
Townsville,1990,3,431,15,446
Townsville,1990,4,458,13,471
Townsville,1990,5,489,13,502
Townsville,1990,6,533,14,547
Townsville,1990,7,533,14,547
Townsville,1990,8,548,13,561
Townsville,1990,9,519,15,534
Townsville,1990,10,535,13,548
Townsville,1990,11,482,13,495
Townsville,1990,12,424,14,438
Townsville,1991,1,640,18,658
Townsville,1991,2,575,12,587
Townsville,1991,3,645,14,659
Townsville,1991,4,609,0,609
Townsville,1991,5,617,0,617
Townsville,1991,6,606,0,606
Townsville,1991,7,629,0,629
Townsville,1991,8,651,0,651
Townsville,1991,9,603,0,603
Townsville,1991,10,628,0,628
Townsville,1991,11,616,0,616
Townsville,1991,12,608,0,608
Townsville,1992,1,595,0,595
Townsville,1992,2,571,0,571
Townsville,1992,3,555,0,555
Townsville,1992,4,560,0,560
Townsville,1992,5,571,0,571
Townsville,1992,6,559,0,559
Townsville,1992,7,597,0,597
Townsville,1992,8,587,0,587
Townsville,1992,9,606,0,606
Townsville,1992,10,650,0,650
Townsville,1992,11,621,8,629
Townsville,1992,12,626,10,636
Townsville,1993,1,604,8,612
Townsville,1993,2,564,8,572
Townsville,1993,3,594,8,602
Townsville,1993,4,577,9,586
Townsville,1993,5,560,8,568
Townsville,1993,6,556,9,565
Townsville,1993,7,589,11,600
Townsville,1993,8,592,10,602
Townsville,1993,9,634,8,642
Townsville,1993,10,631,9,640
Townsville,1993,11,625,8,633
Townsville,1993,12,619,8,627
Townsville,1994,1,632,10,642
Townsville,1994,2,577,8,585
Townsville,1994,3,657,9,666
Townsville,1994,4,631,5,636
Townsville,1994,5,654,4,658
Townsville,1994,6,641,4,645
Townsville,1994,7,647,5,652
Townsville,1994,8,649,4,653
Townsville,1994,9,674,4,678
Townsville,1994,10,702,5,707
Townsville,1994,11,672,0,672
Townsville,1994,12,666,0,666
Townsville,1995,1,652,0,652
Townsville,1995,2,591,0,591
Townsville,1995,3,681,0,681
Townsville,1995,4,660,0,660
Townsville,1995,5,679,0,679
Townsville,1995,6,678,0,678
Townsville,1995,7,740,0,740
Townsville,1995,8,746,0,746
Townsville,1995,9,722,0,722
Townsville,1995,10,741,0,741
Townsville,1995,11,697,0,697
Townsville,1995,12,696,0,696
Townsville,1996,1,716,0,716
Townsville,1996,2,649,0,649
Townsville,1996,3,709,0,709
Townsville,1996,4,712,0,712
Townsville,1996,5,732,0,732
Townsville,1996,6,693,0,693
Townsville,1996,7,761,0,761
Townsville,1996,8,727,0,727
Townsville,1996,9,742,0,742
Townsville,1996,10,799,0,799
Townsville,1996,11,796,0,796
Townsville,1996,12,778,0,778
Townsville,1997,1,758,0,758
Townsville,1997,2,684,0,684
Townsville,1997,3,731,0,731
Townsville,1997,4,739,0,739
Townsville,1997,5,754,1,755
Townsville,1997,6,738,14,752
Townsville,1997,7,792,12,804
Townsville,1997,8,771,15,786
Townsville,1997,9,756,0,756
Townsville,1997,10,781,7,788
Townsville,1997,11,734,0,734
Townsville,1997,12,730,0,730
Townsville,1998,1,691,0,691
Townsville,1998,2,614,0,614
Townsville,1998,3,689,0,689
Townsville,1998,4,682,0,682
Townsville,1998,5,707,0,707
Townsville,1998,6,697,0,697
Townsville,1998,7,782,0,782
Townsville,1998,8,796,0,796
Townsville,1998,9,758,0,758
Townsville,1998,10,780,6,786
Townsville,1998,11,747,7,754
Townsville,1998,12,751,9,760
Townsville,1999,1,700,5,705
Townsville,1999,2,643,6,649
Townsville,1999,3,740,0,740
Townsville,1999,4,741,0,741
Townsville,1999,5,748,0,748
Townsville,1999,6,755,0,755
Townsville,1999,7,777,0,777
Townsville,1999,8,753,0,753
Townsville,1999,9,740,0,740
Townsville,1999,10,743,0,743
Townsville,1999,11,714,0,714
Townsville,1999,12,709,0,709
Townsville,2000,1,686,0,686
Townsville,2000,2,724,0,724
Townsville,2000,3,817,0,817
Townsville,2000,4,723,0,723
Townsville,2000,5,805,0,805
Townsville,2000,6,786,0,786
Townsville,2000,7,796,0,796
Townsville,2000,8,814,0,814
Townsville,2000,9,788,0,788
Townsville,2000,10,843,0,843
Townsville,2000,11,821,0,821
Townsville,2000,12,763,0,763
Townsville,2001,1,712,0,712
Townsville,2001,2,733,0,733
Townsville,2001,3,830,0,830
Townsville,2001,4,816,0,816
Townsville,2001,5,861,0,861
Townsville,2001,6,721,0,721
Townsville,2001,7,548,0,548
Townsville,2001,8,556,0,556
Townsville,2001,9,490,0,490
Townsville,2001,10,515,1,516
Townsville,2001,11,551,8,559
Townsville,2001,12,542,7,549
Townsville,2002,1,517,0,517
Townsville,2002,2,486,0,486
Townsville,2002,3,520,0,520
Townsville,2002,4,514,0,514
Townsville,2002,5,534,0,534
Townsville,2002,6,497,0,497
Townsville,2002,7,565,0,565
Townsville,2002,8,643,0,643
Townsville,2002,9,619,0,619
Townsville,2002,10,640,0,640
Townsville,2002,11,613,0,613
Townsville,2002,12,597,0,597
Townsville,2003,1,640,0,640
Townsville,2003,2,605,0,605
Townsville,2003,3,663,0,663
Townsville,2003,4,639,0,639
Townsville,2003,5,690,0,690
Townsville,2003,6,654,0,654
Townsville,2003,7,692,0,692
Townsville,2003,8,712,0,712
Townsville,2003,9,705,0,705
Townsville,2003,10,747,0,747
Townsville,2003,11,715,0,715
Townsville,2003,12,722,0,722
Townsville,2004,1,717,0,717
Townsville,2004,2,680,0,680
Townsville,2004,3,745,0,745
Townsville,2004,4,734,0,734
Townsville,2004,5,769,0,769
Townsville,2004,6,759,0,759
Townsville,2004,7,805,0,805
Townsville,2004,8,790,0,790
Townsville,2004,9,790,0,790
Townsville,2004,10,787,0,787
Townsville,2004,11,762,0,762
Townsville,2004,12,752,0,752
Townsville,2005,1,783,0,783
Townsville,2005,2,795,0,795
Townsville,2005,3,921,0,921
Townsville,2005,4,1010,0,1010
Townsville,2005,5,947,0,947
Townsville,2005,6,941,0,941
Townsville,2005,7,953,0,953
Townsville,2005,8,974,0,974
Townsville,2005,9,917,0,917
Townsville,2005,10,940,0,940
Townsville,2005,11,990,0,990
Townsville,2005,12,930,0,930
Townsville,2006,1,893,0,893
Townsville,2006,2,855,0,855
Townsville,2006,3,934,1,935
Townsville,2006,4,884,1,885
Townsville,2006,5,921,1,922
Townsville,2006,6,894,0,894
Townsville,2006,7,934,0,934
Townsville,2006,8,937,0,937
Townsville,2006,9,904,0,904
Townsville,2006,10,939,0,939
Townsville,2006,11,891,0,891
Townsville,2006,12,846,0,846
Townsville,2007,1,825,0,825
Townsville,2007,2,848,0,848
Townsville,2007,3,925,0,925
Townsville,2007,4,791,0,791
Townsville,2007,5,865,0,865
Townsville,2007,6,845,0,845
Townsville,2007,7,849,0,849
Townsville,2007,8,859,0,859
Townsville,2007,9,800,0,800
Townsville,2007,10,878,0,878
Townsville,2007,11,853,0,853
Townsville,2007,12,831,0,831
Townsville,2008,1,800,0,800
Townsville,2008,2,813,0,813
Townsville,2008,3,852,0,852
Townsville,2008,4,818,0,818
Townsville,2008,5,862,0,862
Townsville,2008,6,848,0,848
Townsville,2008,7,906,0,906
Townsville,2008,8,898,0,898
Townsville,2008,9,821,0,821
Townsville,2008,10,864,0,864
Townsville,2008,11,831,0,831
Townsville,2008,12,826,0,826
Townsville,2009,1,745,0,745
Townsville,2009,2,772,0,772
Townsville,2009,3,889,0,889
Townsville,2009,4,978,0,978
Townsville,2009,5,1021,0,1021
Townsville,2009,6,1005,0,1005
Townsville,2009,7,1073,0,1073
Townsville,2009,8,1007,0,1007
Townsville,2009,9,1007,0,1007
Townsville,2009,10,1111,0,1111
Townsville,2009,11,1136,0,1136
Townsville,2009,12,1087,0,1087
Townsville,2010,1,1043,0,1043
Townsville,2010,2,909,0,909
Townsville,2010,3,1008,0,1008
Townsville,2010,4,1140,0,1140
Townsville,2010,5,1234,0,1234
Townsville,2010,6,1232,0,1232
Townsville,2010,7,1306,0,1306
Townsville,2010,8,1321,0,1321
Townsville,2010,9,1251,0,1251
Townsville,2010,10,1253,0,1253
Townsville,2010,11,1280,0,1280
Townsville,2010,12,1231,8,1239
Townsville,2011,1,1086,8,1094
Townsville,2011,2,1066,8,1074
Townsville,2011,3,1244,7,1251
Townsville,2011,4,1185,5,1190
Townsville,2011,5,1264,4,1268
Townsville,2011,6,1214,4,1218
Townsville,2011,7,1255,5,1260
Townsville,2011,8,1300,4,1304
Townsville,2011,9,1237,4,1241
Townsville,2011,10,1168,3,1171
Townsville,2011,11,1191,0,1191
Townsville,2011,12,1123,0,1123
Townsville,2012,1,1031,0,1031
Townsville,2012,2,1151,0,1151
Townsville,2012,3,1184,0,1184
Townsville,2012,4,1134,0,1134
Townsville,2012,5,1202,0,1202
Townsville,2012,6,1144,0,1144
Townsville,2012,7,1194,0,1194
Townsville,2012,8,1239,0,1239
Townsville,2012,9,1156,0,1156
Townsville,2012,10,1227,0,1227
Townsville,2012,11,1193,0,1193
Townsville,2012,12,1074,0,1074
Townsville,2013,1,1060,0,1060
Townsville,2013,2,1060,0,1060
Townsville,2013,3,1157,0,1157
Townsville,2013,4,1139,0,1139
Townsville,2013,5,1228,0,1228
Townsville,2013,6,1108,0,1108
Townsville,2013,7,1212,0,1212
Townsville,2013,8,1197,0,1197
Townsville,2013,9,1152,0,1152
Townsville,2013,10,1214,0,1214
Townsville,2013,11,1118,0,1118
Townsville,2013,12,1076,0,1076
Townsville,2014,1,1017,0,1017
Townsville,2014,2,1005,0,1005
Townsville,2014,3,1057,0,1057
Townsville,2014,4,1017,0,1017
Townsville,2014,5,1127,0,1127
Townsville,2014,6,1089,0,1089
Townsville,2014,7,1165,0,1165
Townsville,2014,8,1126,0,1126
Townsville,2014,9,1120,0,1120
Townsville,2014,10,1160,0,1160
Townsville,2014,11,1061,0,1061
Townsville,2014,12,1032,0,1032
Townsville,2015,1,1018,0,1018
Townsville,2015,2,980,0,980
Townsville,2015,3,1085,0,1085
Townsville,2015,4,1025,0,1025
Townsville,2015,5,1042,0,1042
Townsville,2015,6,1018,0,1018
Townsville,2015,7,1116,0,1116
Townsville,2015,8,1089,0,1089
Townsville,2015,9,1068,13,1081
Townsville,2015,10,1074,13,1087
Townsville,2015,11,1024,6,1030
Townsville,2015,12,990,13,1003
Townsville,2016,1,965,13,978
Townsville,2016,2,990,13,1003
Townsville,2016,3,1045,12,1057
Townsville,2016,4,1025,13,1038
Townsville,2016,5,1061,13,1074
Townsville,2016,6,1065,13,1078
Townsville,2016,7,1087,13,1100
Townsville,2016,8,1153,13,1166
Townsville,2016,9,1098,12,1110
Townsville,2016,10,1078,14,1092
Townsville,2016,11,1056,12,1068
Townsville,2016,12,1019,13,1032
Townsville,2017,1,1015,13,1028
Townsville,2017,2,974,12,986
Townsville,2017,3,1020,12,1032
Townsville,2017,4,1002,21,1023
Townsville,2017,5,1084,23,1107
Townsville,2017,6,1075,21,1096
Townsville,2017,7,1121,23,1144
Townsville,2017,8,1149,21,1170
Townsville,2017,9,1066,22,1088
Townsville,2017,10,1078,21,1099
Townsville,2017,11,1062,18,1080
Townsville,2017,12,996,21,1017
Townsville,2018,1,1031,23,1054
Townsville,2018,2,943,20,963
Townsville,2018,3,1029,17,1046
Townsville,2018,4,991,9,1000
Townsville,2018,5,1061,8,1069
Townsville,2018,6,1012,9,1021
Townsville,2018,7,1072,9,1081
Townsville,2018,8,1069,9,1078
Townsville,2018,9,998,8,1006
Townsville,2018,10,1055,0,1055
Townsville,2018,11,1000,0,1000
Townsville,2018,12,890,0,890
Townsville,2019,1,931,0,931
Townsville,2019,2,813,0,813
Townsville,2019,3,958,0,958
Townsville,2019,4,998,0,998
Townsville,2019,5,1088,0,1088
Townsville,2019,6,1002,0,1002
Townsville,2019,7,1089,0,1089
Townsville,2019,8,1070,0,1070
Townsville,2019,9,1053,0,1053
Townsville,2019,10,1079,0,1079
Townsville,2019,11,1011,0,1011
Townsville,2019,12,963,0,963
Townsville,2020,1,964,0,964
Townsville,2020,2,927,0,927
Townsville,2020,3,878,0,878
Townsville,2020,4,219,0,219
Townsville,2020,5,238,0,238
Townsville,2020,6,321,0,321
Townsville,2020,7,553,0,553
Townsville,2020,8,615,0,615
Townsville,2020,9,674,0,674
Townsville,2020,10,702,0,702
Townsville,2020,11,716,0,716
Townsville,2020,12,745,0,745
Townsville,2021,1,670,0,670
Townsville,2021,2,710,0,710
Townsville,2021,3,836,0,836
Townsville,2021,4,804,0,804
Townsville,2021,5,846,0,846
Townsville,2021,6,885,0,885
Townsville,2021,7,867,0,867
Townsville,2021,8,751,0,751
Townsville,2021,9,851,0,851
Townsville,2021,10,856,0,856
Townsville,2021,11,908,0,908
Townsville,2021,12,981,0,981
Townsville,2022,1,828,0,828
Townsville,2022,2,756,0,756
Townsville,2022,3,992,0,992
Townsville,2022,4,958,0,958
Townsville,2022,5,1047,0,1047
Townsville,2022,6,1081,0,1081
Townsville,2022,7,1032,0,1032
Townsville,2022,8,1077,0,1077
Townsville,2022,9,1005,0,1005
Townsville,2022,10,1021,0,1021
Townsville,2022,11,1038,0,1038
Townsville,2022,12,970,0,970
Townsville,2023,1,960,0,960
Townsville,2023,2,924,0,924
Townsville,2023,3,1084,0,1084
Townsville,2023,4,1007,0,1007
Townsville,2023,5,1121,0,1121
Townsville,2023,6,1072,0,1072
Townsville,2023,7,1061,0,1061
Townsville,2023,8,1115,0,1115
Townsville,2023,9,1041,0,1041
Townsville,2023,10,1085,0,1085
Townsville,2023,11,1059,0,1059
Townsville,2023,12,953,0,953
Townsville,2024,1,902,0,902
Townsville,2024,2,913,0,913
Townsville,2024,3,1010,0,1010
Townsville,2024,4,1006,0,1006
Townsville,2024,5,1024,0,1024
Townsville,2024,6,954,0,954
Townsville,2024,7,1107,0,1107
Townsville,2024,8,1072,0,1072
Townsville,2024,9,1047,0,1047
Townsville,2024,10,1086,0,1086
Townsville,2024,11,989,0,989
Townsville,2024,12,958,0,958
All Australian Airports,1985,1,34670,1731,36401
All Australian Airports,1985,2,31181,1578,32759
All Australian Airports,1985,3,35812,1750,37562
All Australian Airports,1985,4,34463,1670,36133
All Australian Airports,1985,5,37863,1749,39612
All Australian Airports,1985,6,34215,1696,35911
All Australian Airports,1985,7,34088,1640,35728
All Australian Airports,1985,8,37299,1779,39078
All Australian Airports,1985,9,35965,1721,37686
All Australian Airports,1985,10,37207,1753,38960
All Australian Airports,1985,11,35955,1823,37778
All Australian Airports,1985,12,36472,1938,38410
All Australian Airports,1986,1,35804,1969,37773
All Australian Airports,1986,2,31883,1706,33589
All Australian Airports,1986,3,35225,1924,37149
All Australian Airports,1986,4,35040,1941,36981
All Australian Airports,1986,5,36834,2044,38878
All Australian Airports,1986,6,34678,1977,36655
All Australian Airports,1986,7,35573,2027,37600
All Australian Airports,1986,8,36781,2073,38854
All Australian Airports,1986,9,36729,1906,38635
All Australian Airports,1986,10,36695,2119,38814
All Australian Airports,1986,11,34938,2148,37086
All Australian Airports,1986,12,37517,2234,39751
All Australian Airports,1987,1,35518,2297,37815
All Australian Airports,1987,2,33194,2026,35220
All Australian Airports,1987,3,35950,2203,38153
All Australian Airports,1987,4,35736,2112,37848
All Australian Airports,1987,5,34216,2212,36428
All Australian Airports,1987,6,34302,2111,36413
All Australian Airports,1987,7,36872,2240,39112
All Australian Airports,1987,8,35812,2259,38071
All Australian Airports,1987,9,36264,2190,38454
All Australian Airports,1987,10,37469,2308,39777
All Australian Airports,1987,11,36667,2274,38941
All Australian Airports,1987,12,37913,2437,40350
All Australian Airports,1988,1,35486,2512,37998
All Australian Airports,1988,2,33515,2245,35760
All Australian Airports,1988,3,37193,2330,39523
All Australian Airports,1988,4,35852,2385,38237
All Australian Airports,1988,5,36162,2482,38644
All Australian Airports,1988,6,36417,2408,38825
All Australian Airports,1988,7,39467,2551,42018
All Australian Airports,1988,8,40066,2520,42586
All Australian Airports,1988,9,40441,2435,42876
All Australian Airports,1988,10,39981,2577,42558
All Australian Airports,1988,11,37938,2616,40554
All Australian Airports,1988,12,37962,2858,40820
All Australian Airports,1989,1,37156,2896,40052
All Australian Airports,1989,2,34391,2558,36949
All Australian Airports,1989,3,37501,2700,40201
All Australian Airports,1989,4,35663,2727,38390
All Australian Airports,1989,5,36759,2715,39474
All Australian Airports,1989,6,35108,2604,37712
All Australian Airports,1989,7,36075,2749,38824
All Australian Airports,1989,8,28818,2778,31596
All Australian Airports,1989,9,22160,2772,24932
All Australian Airports,1989,10,26147,2867,29014
All Australian Airports,1989,11,27709,2862,30571
All Australian Airports,1989,12,28833,2993,31826
All Australian Airports,1990,1,30592,3027,33619
All Australian Airports,1990,2,28707,2728,31435
All Australian Airports,1990,3,32357,2992,35349
All Australian Airports,1990,4,33873,2890,36763
All Australian Airports,1990,5,35219,2993,38212
All Australian Airports,1990,6,34105,2897,37002
All Australian Airports,1990,7,36419,3016,39435
All Australian Airports,1990,8,35941,3038,38979
All Australian Airports,1990,9,36236,2953,39189
All Australian Airports,1990,10,39250,3091,42341
All Australian Airports,1990,11,37188,3087,40275
All Australian Airports,1990,12,35305,3244,38549
All Australian Airports,1991,1,37068,3281,40349
All Australian Airports,1991,2,33831,2916,36747
All Australian Airports,1991,3,37322,3218,40540
All Australian Airports,1991,4,38070,2897,40967
All Australian Airports,1991,5,39047,2967,42014
All Australian Airports,1991,6,38506,2974,41480
All Australian Airports,1991,7,41158,3088,44246
All Australian Airports,1991,8,39839,3092,42931
All Australian Airports,1991,9,39849,2988,42837
All Australian Airports,1991,10,42247,3075,45322
All Australian Airports,1991,11,41630,3134,44764
All Australian Airports,1991,12,41254,3300,44554
All Australian Airports,1992,1,40729,3325,44054
All Australian Airports,1992,2,38030,3112,41142
All Australian Airports,1992,3,41314,3298,44612
All Australian Airports,1992,4,41245,3262,44507
All Australian Airports,1992,5,41861,3373,45234
All Australian Airports,1992,6,41584,3243,44827
All Australian Airports,1992,7,43983,3349,47332
All Australian Airports,1992,8,42167,3406,45573
All Australian Airports,1992,9,44195,3322,47517
All Australian Airports,1992,10,45739,3482,49221
All Australian Airports,1992,11,43473,3503,46976
All Australian Airports,1992,12,44472,3755,48227
All Australian Airports,1993,1,42926,3727,46653
All Australian Airports,1993,2,40449,3381,43830
All Australian Airports,1993,3,44596,3650,48246
All Australian Airports,1993,4,44170,3557,47727
All Australian Airports,1993,5,43563,3680,47243
All Australian Airports,1993,6,43146,3519,46665
All Australian Airports,1993,7,44088,3705,47793
All Australian Airports,1993,8,44230,3652,47882
All Australian Airports,1993,9,44372,3583,47955
All Australian Airports,1993,10,46191,3746,49937
All Australian Airports,1993,11,44565,3536,48101
All Australian Airports,1993,12,45216,3755,48971
All Australian Airports,1994,1,43413,3786,47199
All Australian Airports,1994,2,40735,3363,44098
All Australian Airports,1994,3,46486,3655,50141
All Australian Airports,1994,4,44427,3498,47925
All Australian Airports,1994,5,45655,3603,49258
All Australian Airports,1994,6,44993,3506,48499
All Australian Airports,1994,7,47448,3695,51143
All Australian Airports,1994,8,47616,3632,51248
All Australian Airports,1994,9,46950,3619,50569
All Australian Airports,1994,10,48357,3778,52135
All Australian Airports,1994,11,46359,3767,50126
All Australian Airports,1994,12,47584,3927,51511
All Australian Airports,1995,1,45318,3970,49288
All Australian Airports,1995,2,42933,3570,46503
All Australian Airports,1995,3,48138,3920,52058
All Australian Airports,1995,4,47166,3849,51015
All Australian Airports,1995,5,48249,3947,52196
All Australian Airports,1995,6,47164,3862,51026
All Australian Airports,1995,7,48695,4024,52719
All Australian Airports,1995,8,49143,3998,53141
All Australian Airports,1995,9,48004,3875,51879
All Australian Airports,1995,10,49797,4022,53819
All Australian Airports,1995,11,48511,3981,52492
All Australian Airports,1995,12,47825,4228,52053
All Australian Airports,1996,1,48089,4240,52329
All Australian Airports,1996,2,46132,4023,50155
All Australian Airports,1996,3,49265,4214,53479
All Australian Airports,1996,4,48457,4125,52582
All Australian Airports,1996,5,49839,4199,54038
All Australian Airports,1996,6,47315,4121,51436
All Australian Airports,1996,7,50956,4345,55301
All Australian Airports,1996,8,50246,4309,54555
All Australian Airports,1996,9,49027,4210,53237
All Australian Airports,1996,10,51330,4301,55631
All Australian Airports,1996,11,49277,4292,53569
All Australian Airports,1996,12,48858,4521,53379
All Australian Airports,1997,1,47507,4521,52028
All Australian Airports,1997,2,44937,4048,48985
All Australian Airports,1997,3,48835,4401,53236
All Australian Airports,1997,4,47851,4194,52045
All Australian Airports,1997,5,48564,4324,52888
All Australian Airports,1997,6,47092,4195,51287
All Australian Airports,1997,7,50638,4444,55082
All Australian Airports,1997,8,49701,4439,54140
All Australian Airports,1997,9,49254,4218,53472
All Australian Airports,1997,10,50964,4432,55396
All Australian Airports,1997,11,48079,4452,52531
All Australian Airports,1997,12,48301,4615,52916
All Australian Airports,1998,1,46997,4619,51616
All Australian Airports,1998,2,44341,4084,48425
All Australian Airports,1998,3,49365,4429,53794
All Australian Airports,1998,4,48119,4349,52468
All Australian Airports,1998,5,48726,4487,53213
All Australian Airports,1998,6,47376,4247,51623
All Australian Airports,1998,7,50304,4474,54778
All Australian Airports,1998,8,49760,4503,54263
All Australian Airports,1998,9,49751,4348,54099
All Australian Airports,1998,10,50954,4519,55473
All Australian Airports,1998,11,49204,4269,53473
All Australian Airports,1998,12,49616,4463,54079
All Australian Airports,1999,1,47314,4539,51853
All Australian Airports,1999,2,45302,4059,49361
All Australian Airports,1999,3,50772,4443,55215
All Australian Airports,1999,4,48842,4262,53104
All Australian Airports,1999,5,49547,4345,53892
All Australian Airports,1999,6,48368,4149,52517
All Australian Airports,1999,7,49836,4461,54297
All Australian Airports,1999,8,50098,4447,54545
All Australian Airports,1999,9,49297,4301,53598
All Australian Airports,1999,10,50302,4431,54733
All Australian Airports,1999,11,48839,4333,53172
All Australian Airports,1999,12,49095,4562,53657
All Australian Airports,2000,1,46320,4641,50961
All Australian Airports,2000,2,45871,4313,50184
All Australian Airports,2000,3,50400,4576,54976
All Australian Airports,2000,4,47852,4575,52427
All Australian Airports,2000,5,50984,4582,55566
All Australian Airports,2000,6,50583,4471,55054
All Australian Airports,2000,7,51801,4796,56597
All Australian Airports,2000,8,53116,4741,57857
All Australian Airports,2000,9,51541,4675,56216
All Australian Airports,2000,10,53691,4770,58461
All Australian Airports,2000,11,52127,4609,56736
All Australian Airports,2000,12,51494,4909,56403
All Australian Airports,2001,1,50819,4861,55680
All Australian Airports,2001,2,47966,4238,52204
All Australian Airports,2001,3,54166,4715,58881
All Australian Airports,2001,4,51824,4637,56461
All Australian Airports,2001,5,52923,4674,57597
All Australian Airports,2001,6,48870,4552,53422
All Australian Airports,2001,7,49879,4647,54526
All Australian Airports,2001,8,50611,4628,55239
All Australian Airports,2001,9,38495,4423,42918
All Australian Airports,2001,10,38548,4472,43020
All Australian Airports,2001,11,39859,4214,44073
All Australian Airports,2001,12,39967,4570,44537
All Australian Airports,2002,1,39227,4483,43710
All Australian Airports,2002,2,37123,3997,41120
All Australian Airports,2002,3,38889,4389,43278
All Australian Airports,2002,4,38199,4165,42364
All Australian Airports,2002,5,39751,4337,44088
All Australian Airports,2002,6,38148,4219,42367
All Australian Airports,2002,7,41669,4517,46186
All Australian Airports,2002,8,41566,4510,46076
All Australian Airports,2002,9,41303,4309,45612
All Australian Airports,2002,10,42712,4459,47171
All Australian Airports,2002,11,40119,4469,44588
All Australian Airports,2002,12,40005,4683,44688
All Australian Airports,2003,1,38983,4674,43657
All Australian Airports,2003,2,36770,4200,40970
All Australian Airports,2003,3,40344,4577,44921
All Australian Airports,2003,4,38308,4351,42659
All Australian Airports,2003,5,39779,4156,43935
All Australian Airports,2003,6,38473,4027,42500
All Australian Airports,2003,7,40636,4446,45082
All Australian Airports,2003,8,40065,4548,44613
All Australian Airports,2003,9,40751,4525,45276
All Australian Airports,2003,10,42368,4746,47114
All Australian Airports,2003,11,40736,4865,45601
All Australian Airports,2003,12,40874,5096,45970
All Australian Airports,2004,1,40201,5180,45381
All Australian Airports,2004,2,39684,4822,44506
All Australian Airports,2004,3,43506,5182,48688
All Australian Airports,2004,4,41603,5107,46710
All Australian Airports,2004,5,42649,5282,47931
All Australian Airports,2004,6,43109,5153,48262
All Australian Airports,2004,7,45090,5524,50614
All Australian Airports,2004,8,45825,5495,51320
All Australian Airports,2004,9,45293,5388,50681
All Australian Airports,2004,10,46046,5557,51603
All Australian Airports,2004,11,45062,5472,50534
All Australian Airports,2004,12,45610,5827,51437
All Australian Airports,2005,1,43186,5867,49053
All Australian Airports,2005,2,41587,5215,46802
All Australian Airports,2005,3,45764,5644,51408
All Australian Airports,2005,4,44687,5529,50216
All Australian Airports,2005,5,46024,5623,51647
All Australian Airports,2005,6,44920,5517,50437
All Australian Airports,2005,7,46220,5823,52043
All Australian Airports,2005,8,46988,5691,52679
All Australian Airports,2005,9,45658,5528,51186
All Australian Airports,2005,10,46516,5666,52182
All Australian Airports,2005,11,45156,5347,50503
All Australian Airports,2005,12,44885,5679,50564
All Australian Airports,2006,1,42745,5769,48514
All Australian Airports,2006,2,41432,5122,46554
All Australian Airports,2006,3,46659,5557,52216
All Australian Airports,2006,4,43688,5342,49030
All Australian Airports,2006,5,46887,5372,52259
All Australian Airports,2006,6,44576,5271,49847
All Australian Airports,2006,7,45832,5634,51466
All Australian Airports,2006,8,46511,5544,52055
All Australian Airports,2006,9,45325,5433,50758
All Australian Airports,2006,10,46024,5512,51536
All Australian Airports,2006,11,45139,5448,50587
All Australian Airports,2006,12,44084,5734,49818
All Australian Airports,2007,1,42620,5751,48371
All Australian Airports,2007,2,41158,5171,46329
All Australian Airports,2007,3,46572,5659,52231
All Australian Airports,2007,4,43939,5429,49368
All Australian Airports,2007,5,46717,5522,52239
All Australian Airports,2007,6,44699,5439,50138
All Australian Airports,2007,7,46523,5710,52233
All Australian Airports,2007,8,47743,5657,53400
All Australian Airports,2007,9,45192,5541,50733
All Australian Airports,2007,10,47704,5706,53410
All Australian Airports,2007,11,46390,5611,52001
All Australian Airports,2007,12,46121,5990,52111
All Australian Airports,2008,1,45726,6036,51762
All Australian Airports,2008,2,44869,5548,50417
All Australian Airports,2008,3,47416,5866,53282
All Australian Airports,2008,4,46685,5758,52443
All Australian Airports,2008,5,48466,5924,54390
All Australian Airports,2008,6,46462,5769,52231
All Australian Airports,2008,7,48863,6165,55028
All Australian Airports,2008,8,48244,6034,54278
All Australian Airports,2008,9,47568,5879,53447
All Australian Airports,2008,10,49758,6128,55886
All Australian Airports,2008,11,47299,6027,53326
All Australian Airports,2008,12,47004,6476,53480
All Australian Airports,2009,1,44493,6480,50973
All Australian Airports,2009,2,41580,5599,47179
All Australian Airports,2009,3,46527,6149,52676
All Australian Airports,2009,4,45622,6016,51638
All Australian Airports,2009,5,46550,6030,52580
All Australian Airports,2009,6,45535,5898,51433
All Australian Airports,2009,7,48421,6335,54756
All Australian Airports,2009,8,47006,6370,53376
All Australian Airports,2009,9,46917,6196,53113
All Australian Airports,2009,10,48808,6421,55229
All Australian Airports,2009,11,46958,6232,53190
All Australian Airports,2009,12,46886,6730,53616
All Australian Airports,2010,1,45369,6842,52211
All Australian Airports,2010,2,43979,6050,50029
All Australian Airports,2010,3,50283,6589,56872
All Australian Airports,2010,4,49779,6315,56094
All Australian Airports,2010,5,50649,6390,57039
All Australian Airports,2010,6,49279,6322,55601
All Australian Airports,2010,7,52565,6857,59422
All Australian Airports,2010,8,51655,6713,58368
All Australian Airports,2010,9,50847,6503,57350
All Australian Airports,2010,10,52211,6653,58864
All Australian Airports,2010,11,51123,6500,57623
All Australian Airports,2010,12,52122,7039,59161
All Australian Airports,2011,1,48440,7210,55650
All Australian Airports,2011,2,45609,6268,51877
All Australian Airports,2011,3,52333,6835,59168
All Australian Airports,2011,4,50323,6757,57080
All Australian Airports,2011,5,51782,6785,58567
All Australian Airports,2011,6,48585,6318,54903
All Australian Airports,2011,7,51895,7026,58921
All Australian Airports,2011,8,52557,6949,59506
All Australian Airports,2011,9,50999,6720,57719
All Australian Airports,2011,10,51209,6968,58177
All Australian Airports,2011,11,51000,6675,57675
All Australian Airports,2011,12,50824,7182,58006
All Australian Airports,2012,1,49228,7322,56550
All Australian Airports,2012,2,49322,6469,55791
All Australian Airports,2012,3,53209,6775,59984
All Australian Airports,2012,4,51372,6802,58174
All Australian Airports,2012,5,52545,6623,59168
All Australian Airports,2012,6,50057,6676,56733
All Australian Airports,2012,7,54770,7282,62052
All Australian Airports,2012,8,55522,7145,62667
All Australian Airports,2012,9,53425,6964,60389
All Australian Airports,2012,10,55950,7125,63075
All Australian Airports,2012,11,54319,6835,61154
All Australian Airports,2012,12,52143,7435,59578
All Australian Airports,2013,1,51211,7442,58653
All Australian Airports,2013,2,48054,6478,54532
All Australian Airports,2013,3,53740,7194,60934
All Australian Airports,2013,4,54109,7039,61148
All Australian Airports,2013,5,54686,6923,61609
All Australian Airports,2013,6,51635,6973,58608
All Australian Airports,2013,7,56470,7728,64198
All Australian Airports,2013,8,55323,7557,62880
All Australian Airports,2013,9,54705,7405,62110
All Australian Airports,2013,10,56616,7675,64291
All Australian Airports,2013,11,53216,7363,60579
All Australian Airports,2013,12,52930,8095,61025
All Australian Airports,2014,1,51429,8215,59644
All Australian Airports,2014,2,47544,6971,54515
All Australian Airports,2014,3,53457,7661,61118
All Australian Airports,2014,4,52824,7535,60359
All Australian Airports,2014,5,53641,7267,60908
All Australian Airports,2014,6,51595,7248,58843
All Australian Airports,2014,7,55239,7906,63145
All Australian Airports,2014,8,53607,7682,61289
All Australian Airports,2014,9,53860,7458,61318
All Australian Airports,2014,10,55793,7607,63400
All Australian Airports,2014,11,51845,7148,58993
All Australian Airports,2014,12,52827,8029,60856
All Australian Airports,2015,1,50494,8166,58660
All Australian Airports,2015,2,47706,6877,54583
All Australian Airports,2015,3,54023,7367,61390
All Australian Airports,2015,4,52551,7357,59908
All Australian Airports,2015,5,52974,7147,60121
All Australian Airports,2015,6,52485,7135,59620
All Australian Airports,2015,7,55930,7752,63682
All Australian Airports,2015,8,54276,7468,61744
All Australian Airports,2015,9,54304,7316,61620
All Australian Airports,2015,10,55440,7603,63043
All Australian Airports,2015,11,53295,7178,60473
All Australian Airports,2015,12,53445,8449,61894
All Australian Airports,2016,1,50777,8704,59481
All Australian Airports,2016,2,50973,7539,58512
All Australian Airports,2016,3,54883,7954,62837
All Australian Airports,2016,4,53135,7800,60935
All Australian Airports,2016,5,53112,7668,60780
All Australian Airports,2016,6,51580,7654,59234
All Australian Airports,2016,7,55254,8452,63706
All Australian Airports,2016,8,55812,8091,63903
All Australian Airports,2016,9,55009,7936,62945
All Australian Airports,2016,10,55316,8263,63579
All Australian Airports,2016,11,54099,7875,61974
All Australian Airports,2016,12,53720,8855,62575
All Australian Airports,2017,1,51488,8992,60480
All Australian Airports,2017,2,48976,7622,56598
All Australian Airports,2017,3,54779,8220,62999
All Australian Airports,2017,4,51785,8195,59980
All Australian Airports,2017,5,53546,7886,61432
All Australian Airports,2017,6,51988,7980,59968
All Australian Airports,2017,7,55055,9044,64099
All Australian Airports,2017,8,55256,8416,63672
All Australian Airports,2017,9,53229,8278,61507
All Australian Airports,2017,10,55380,8552,63932
All Australian Airports,2017,11,54049,8152,62201
All Australian Airports,2017,12,52679,9214,61893
All Australian Airports,2018,1,51588,9435,61023
All Australian Airports,2018,2,48581,8029,56610
All Australian Airports,2018,3,53753,8688,62441
All Australian Airports,2018,4,52057,8589,60646
All Australian Airports,2018,5,52777,8312,61089
All Australian Airports,2018,6,49857,8387,58244
All Australian Airports,2018,7,54219,9224,63443
All Australian Airports,2018,8,53893,8896,62789
All Australian Airports,2018,9,52023,8609,60632
All Australian Airports,2018,10,55482,8917,64399
All Australian Airports,2018,11,53238,8591,61829
All Australian Airports,2018,12,51672,9484,61156
All Australian Airports,2019,1,51456,9630,61086
All Australian Airports,2019,2,48624,8203,56827
All Australian Airports,2019,3,53619,8762,62381
All Australian Airports,2019,4,53384,8650,62034
All Australian Airports,2019,5,54345,8371,62716
All Australian Airports,2019,6,50994,8416,59410
All Australian Airports,2019,7,55839,9173,65012
All Australian Airports,2019,8,53458,8824,62282
All Australian Airports,2019,9,53319,8602,61921
All Australian Airports,2019,10,56051,8910,64961
All Australian Airports,2019,11,52514,8659,61173
All Australian Airports,2019,12,52026,9655,61681
All Australian Airports,2020,1,50134,9863,59997
All Australian Airports,2020,2,48327,7866,56193
All Australian Airports,2020,3,43051,5905,48956
All Australian Airports,2020,4,8240,1289,9529
All Australian Airports,2020,5,7820,1556,9376
All Australian Airports,2020,6,10334,1531,11865
All Australian Airports,2020,7,14904,1593,16497
All Australian Airports,2020,8,14250,1750,16000
All Australian Airports,2020,9,16047,1739,17786
All Australian Airports,2020,10,18193,1911,20104
All Australian Airports,2020,11,20641,1983,22624
All Australian Airports,2020,12,30349,2088,32437
All Australian Airports,2021,1,25948,1933,27881
All Australian Airports,2021,2,26186,1663,27849
All Australian Airports,2021,3,37149,1910,39059
All Australian Airports,2021,4,42850,2122,44972
All Australian Airports,2021,5,43718,2652,46370
All Australian Airports,2021,6,36378,2478,38856
All Australian Airports,2021,7,27353,2433,29786
All Australian Airports,2021,8,19364,2157,21521
All Australian Airports,2021,9,20698,2141,22839
All Australian Airports,2021,10,21366,2223,23589
All Australian Airports,2021,11,26901,2418,29319
All Australian Airports,2021,12,39602,2836,42438
All Australian Airports,2022,1,36732,2940,39672
All Australian Airports,2022,2,32229,2822,35051
All Australian Airports,2022,3,43723,3407,47130
All Australian Airports,2022,4,49940,3897,53837
All Australian Airports,2022,5,50836,4218,55054
All Australian Airports,2022,6,49343,4495,53838
All Australian Airports,2022,7,49167,5379,54546
All Australian Airports,2022,8,49234,5357,54591
All Australian Airports,2022,9,47974,5277,53251
All Australian Airports,2022,10,48841,5643,54484
All Australian Airports,2022,11,49144,6160,55304
All Australian Airports,2022,12,49516,6965,56481
All Australian Airports,2023,1,48916,7311,56227
All Australian Airports,2023,2,45948,6368,52316
All Australian Airports,2023,3,52582,7028,59610
All Australian Airports,2023,4,50026,7334,57360
All Australian Airports,2023,5,52399,7194,59593
All Australian Airports,2023,6,50376,7414,57790
All Australian Airports,2023,7,52006,8154,60160
All Australian Airports,2023,8,53074,7982,61056
All Australian Airports,2023,9,51500,7903,59403
All Australian Airports,2023,10,52928,7994,60922
All Australian Airports,2023,11,51194,8044,59238
All Australian Airports,2023,12,50208,9355,59563
All Australian Airports,2024,1,50739,9556,60295
All Australian Airports,2024,2,48655,8260,56915
All Australian Airports,2024,3,51866,8623,60489
All Australian Airports,2024,4,52509,8361,60870
All Australian Airports,2024,5,52390,8146,60536
All Australian Airports,2024,6,49259,8196,57455
All Australian Airports,2024,7,54064,8841,62905
All Australian Airports,2024,8,50965,8578,59543
All Australian Airports,2024,9,50865,8476,59341
All Australian Airports,2024,10,52790,8687,61477
All Australian Airports,2024,11,49490,8579,58069
All Australian Airports,2024,12,49835,9867,59702