AIRPORT,Year,Month,Dom_Acm_In,Int_Acm_In,Acm_In
Adelaide,1985,1,1908,35,1943
Adelaide,1985,2,1672,31,1703
Adelaide,1985,3,1878,39,1917
Adelaide,1985,4,1803,28,1831
Adelaide,1985,5,2014,31,2045
Adelaide,1985,6,1783,32,1815
Adelaide,1985,7,1935,29,1964
Adelaide,1985,8,2156,34,2190
Adelaide,1985,9,1992,29,2021
Adelaide,1985,10,2090,35,2125
Adelaide,1985,11,2207,55,2262
Adelaide,1985,12,2088,65,2153
Adelaide,1986,1,2000,70,2070
Adelaide,1986,2,1927,62,1989
Adelaide,1986,3,2158,70,2228
Adelaide,1986,4,2187,68,2255
Adelaide,1986,5,2406,70,2476
Adelaide,1986,6,2428,67,2495
Adelaide,1986,7,2470,69,2539
Adelaide,1986,8,2501,70,2571
Adelaide,1986,9,2551,68,2619
Adelaide,1986,10,1891,72,1963
Adelaide,1986,11,1775,71,1846
Adelaide,1986,12,1972,77,2049
Adelaide,1987,1,1811,71,1882
Adelaide,1987,2,1742,67,1809
Adelaide,1987,3,2088,74,2162
Adelaide,1987,4,1921,63,1984
Adelaide,1987,5,1888,64,1952
Adelaide,1987,6,1821,66,1887
Adelaide,1987,7,1959,68,2027
Adelaide,1987,8,1981,65,2046
Adelaide,1987,9,1815,70,1885
Adelaide,1987,10,2007,71,2078
Adelaide,1987,11,2030,68,2098
Adelaide,1987,12,1979,70,2049
Adelaide,1988,1,1827,75,1902
Adelaide,1988,2,1822,69,1891
Adelaide,1988,3,1999,70,2069
Adelaide,1988,4,1866,63,1929
Adelaide,1988,5,1904,67,1971
Adelaide,1988,6,1842,68,1910
Adelaide,1988,7,2138,66,2204
Adelaide,1988,8,2073,66,2139
Adelaide,1988,9,2116,65,2181
Adelaide,1988,10,2020,66,2086
Adelaide,1988,11,2117,69,2186
Adelaide,1988,12,1907,70,1977
Adelaide,1989,1,1881,74,1955
Adelaide,1989,2,1806,64,1870
Adelaide,1989,3,2047,70,2117
Adelaide,1989,4,1953,82,2035
Adelaide,1989,5,1973,84,2057
Adelaide,1989,6,1958,80,2038
Adelaide,1989,7,2135,86,2221
Adelaide,1989,8,1812,88,1900
Adelaide,1989,9,1286,86,1372
Adelaide,1989,10,1533,93,1626
Adelaide,1989,11,1695,88,1783
Adelaide,1989,12,1532,90,1622
Adelaide,1990,1,1438,93,1531
Adelaide,1990,2,1548,84,1632
Adelaide,1990,3,1688,94,1782
Adelaide,1990,4,1665,90,1755
Adelaide,1990,5,1757,94,1851
Adelaide,1990,6,1671,90,1761
Adelaide,1990,7,1831,91,1922
Adelaide,1990,8,1851,92,1943
Adelaide,1990,9,1895,92,1987
Adelaide,1990,10,2162,100,2262
Adelaide,1990,11,2077,88,2165
Adelaide,1990,12,2005,95,2100
Adelaide,1991,1,2008,99,2107
Adelaide,1991,2,1922,87,2009
Adelaide,1991,3,2111,91,2202
Adelaide,1991,4,2111,86,2197
Adelaide,1991,5,2066,86,2152
Adelaide,1991,6,2037,101,2138
Adelaide,1991,7,2199,103,2302
Adelaide,1991,8,2226,108,2334
Adelaide,1991,9,2136,95,2231
Adelaide,1991,10,2348,95,2443
Adelaide,1991,11,2348,101,2449
Adelaide,1991,12,2279,100,2379
Adelaide,1992,1,2112,100,2212
Adelaide,1992,2,2033,98,2131
Adelaide,1992,3,2334,100,2434
Adelaide,1992,4,2210,101,2311
Adelaide,1992,5,2268,99,2367
Adelaide,1992,6,2225,97,2322
Adelaide,1992,7,2343,102,2445
Adelaide,1992,8,2390,101,2491
Adelaide,1992,9,2400,100,2500
Adelaide,1992,10,2443,105,2548
Adelaide,1992,11,2467,90,2557
Adelaide,1992,12,2396,94,2490
Adelaide,1993,1,2189,91,2280
Adelaide,1993,2,2181,84,2265
Adelaide,1993,3,2441,90,2531
Adelaide,1993,4,2270,99,2369
Adelaide,1993,5,2297,93,2390
Adelaide,1993,6,2315,93,2408
Adelaide,1993,7,2393,101,2494
Adelaide,1993,8,2451,95,2546
Adelaide,1993,9,2423,94,2517
Adelaide,1993,10,2457,99,2556
Adelaide,1993,11,2440,94,2534
Adelaide,1993,12,2366,100,2466
Adelaide,1994,1,2266,98,2364
Adelaide,1994,2,2190,89,2279
Adelaide,1994,3,2550,97,2647
Adelaide,1994,4,2365,94,2459
Adelaide,1994,5,2491,97,2588
Adelaide,1994,6,2299,93,2392
Adelaide,1994,7,2526,97,2623
Adelaide,1994,8,2604,97,2701
Adelaide,1994,9,2515,96,2611
Adelaide,1994,10,2592,94,2686
Adelaide,1994,11,2607,97,2704
Adelaide,1994,12,2478,97,2575
Adelaide,1995,1,2417,97,2514
Adelaide,1995,2,2362,89,2451
Adelaide,1995,3,2660,94,2754
Adelaide,1995,4,2505,87,2592
Adelaide,1995,5,2716,88,2804
Adelaide,1995,6,2559,86,2645
Adelaide,1995,7,2748,88,2836
Adelaide,1995,8,2846,90,2936
Adelaide,1995,9,2728,85,2813
Adelaide,1995,10,2860,88,2948
Adelaide,1995,11,2726,87,2813
Adelaide,1995,12,2573,88,2661
Adelaide,1996,1,2598,94,2692
Adelaide,1996,2,2552,90,2642
Adelaide,1996,3,2729,90,2819
Adelaide,1996,4,2680,91,2771
Adelaide,1996,5,2747,89,2836
Adelaide,1996,6,2584,92,2676
Adelaide,1996,7,2868,92,2960
Adelaide,1996,8,2887,91,2978
Adelaide,1996,9,2785,93,2878
Adelaide,1996,10,2953,88,3041
Adelaide,1996,11,2852,85,2937
Adelaide,1996,12,2697,92,2789
Adelaide,1997,1,2602,90,2692
Adelaide,1997,2,2578,82,2660
Adelaide,1997,3,2814,93,2907
Adelaide,1997,4,2844,89,2933
Adelaide,1997,5,2827,90,2917
Adelaide,1997,6,2733,80,2813
Adelaide,1997,7,2952,84,3036
Adelaide,1997,8,2961,84,3045
Adelaide,1997,9,2980,81,3061
Adelaide,1997,10,3137,84,3221
Adelaide,1997,11,2995,82,3077
Adelaide,1997,12,2916,82,2998
Adelaide,1998,1,2759,82,2841
Adelaide,1998,2,2761,74,2835
Adelaide,1998,3,3072,85,3157
Adelaide,1998,4,2953,81,3034
Adelaide,1998,5,2964,83,3047
Adelaide,1998,6,2859,80,2939
Adelaide,1998,7,3080,79,3159
Adelaide,1998,8,3058,95,3153
Adelaide,1998,9,3065,88,3153
Adelaide,1998,10,3132,91,3223
Adelaide,1998,11,3035,91,3126
Adelaide,1998,12,2986,89,3075
Adelaide,1999,1,2797,90,2887
Adelaide,1999,2,2752,81,2833
Adelaide,1999,3,3106,87,3193
Adelaide,1999,4,2944,84,3028
Adelaide,1999,5,2876,85,2961
Adelaide,1999,6,2783,75,2858
Adelaide,1999,7,2956,74,3030
Adelaide,1999,8,2992,78,3070
Adelaide,1999,9,2907,75,2982
Adelaide,1999,10,3073,81,3154
Adelaide,1999,11,2947,85,3032
Adelaide,1999,12,2954,88,3042
Adelaide,2000,1,2685,88,2773
Adelaide,2000,2,2785,83,2868
Adelaide,2000,3,3032,86,3118
Adelaide,2000,4,2794,74,2868
Adelaide,2000,5,2976,74,3050
Adelaide,2000,6,2704,74,2778
Adelaide,2000,7,2799,76,2875
Adelaide,2000,8,2988,76,3064
Adelaide,2000,9,2853,78,2931
Adelaide,2000,10,3045,80,3125
Adelaide,2000,11,3059,78,3137
Adelaide,2000,12,2949,80,3029
Adelaide,2001,1,2930,80,3010
Adelaide,2001,2,2798,68,2866
Adelaide,2001,3,3235,73,3308
Adelaide,2001,4,3066,76,3142
Adelaide,2001,5,3147,72,3219
Adelaide,2001,6,3033,73,3106
Adelaide,2001,7,3206,74,3280
Adelaide,2001,8,3251,75,3326
Adelaide,2001,9,2586,72,2658
Adelaide,2001,10,2575,75,2650
Adelaide,2001,11,2643,67,2710
Adelaide,2001,12,2658,74,2732
Adelaide,2002,1,2696,69,2765
Adelaide,2002,2,2521,64,2585
Adelaide,2002,3,2707,72,2779
Adelaide,2002,4,2558,60,2618
Adelaide,2002,5,2606,61,2667
Adelaide,2002,6,2453,61,2514
Adelaide,2002,7,2709,76,2785
Adelaide,2002,8,2829,76,2905
Adelaide,2002,9,2848,77,2925
Adelaide,2002,10,2921,74,2995
Adelaide,2002,11,2740,67,2807
Adelaide,2002,12,2712,63,2775
Adelaide,2003,1,2632,63,2695
Adelaide,2003,2,2531,56,2587
Adelaide,2003,3,2788,64,2852
Adelaide,2003,4,2574,73,2647
Adelaide,2003,5,2544,77,2621
Adelaide,2003,6,2428,76,2504
Adelaide,2003,7,2581,82,2663
Adelaide,2003,8,2625,85,2710
Adelaide,2003,9,2707,82,2789
Adelaide,2003,10,2804,82,2886
Adelaide,2003,11,2731,72,2803
Adelaide,2003,12,2767,76,2843
Adelaide,2004,1,2698,75,2773
Adelaide,2004,2,2675,69,2744
Adelaide,2004,3,2947,85,3032
Adelaide,2004,4,2768,79,2847
Adelaide,2004,5,2533,83,2616
Adelaide,2004,6,2721,83,2804
Adelaide,2004,7,2856,85,2941
Adelaide,2004,8,2855,84,2939
Adelaide,2004,9,2838,83,2921
Adelaide,2004,10,2867,86,2953
Adelaide,2004,11,2908,86,2994
Adelaide,2004,12,2951,97,3048
Adelaide,2005,1,2679,97,2776
Adelaide,2005,2,2718,92,2810
Adelaide,2005,3,2974,99,3073
Adelaide,2005,4,2859,99,2958
Adelaide,2005,5,2907,101,3008
Adelaide,2005,6,2825,99,2924
Adelaide,2005,7,2923,102,3025
Adelaide,2005,8,2987,104,3091
Adelaide,2005,9,2898,89,2987
Adelaide,2005,10,2953,100,3053
Adelaide,2005,11,2731,95,2826
Adelaide,2005,12,2695,92,2787
Adelaide,2006,1,2603,92,2695
Adelaide,2006,2,2648,83,2731
Adelaide,2006,3,3043,98,3141
Adelaide,2006,4,2809,121,2930
Adelaide,2006,5,3017,124,3141
Adelaide,2006,6,2871,133,3004
Adelaide,2006,7,2811,136,2947
Adelaide,2006,8,2920,134,3054
Adelaide,2006,9,2841,125,2966
Adelaide,2006,10,2937,127,3064
Adelaide,2006,11,2907,123,3030
Adelaide,2006,12,2866,127,2993
Adelaide,2007,1,2760,126,2886
Adelaide,2007,2,2647,118,2765
Adelaide,2007,3,3081,129,3210
Adelaide,2007,4,2919,122,3041
Adelaide,2007,5,3074,128,3202
Adelaide,2007,6,2956,125,3081
Adelaide,2007,7,3138,125,3263
Adelaide,2007,8,3174,120,3294
Adelaide,2007,9,2977,117,3094
Adelaide,2007,10,3107,129,3236
Adelaide,2007,11,2929,137,3066
Adelaide,2007,12,2908,150,3058
Adelaide,2008,1,2928,145,3073
Adelaide,2008,2,2840,132,2972
Adelaide,2008,3,2952,142,3094
Adelaide,2008,4,2944,137,3081
Adelaide,2008,5,3044,138,3182
Adelaide,2008,6,2866,133,2999
Adelaide,2008,7,2992,138,3130
Adelaide,2008,8,2978,137,3115
Adelaide,2008,9,2989,134,3123
Adelaide,2008,10,3187,135,3322
Adelaide,2008,11,3026,139,3165
Adelaide,2008,12,3009,152,3161
Adelaide,2009,1,2800,152,2952
Adelaide,2009,2,2721,133,2854
Adelaide,2009,3,3127,146,3273
Adelaide,2009,4,3031,142,3173
Adelaide,2009,5,2933,143,3076
Adelaide,2009,6,2814,147,2961
Adelaide,2009,7,2956,148,3104
Adelaide,2009,8,2888,141,3029
Adelaide,2009,9,2871,148,3019
Adelaide,2009,10,2953,158,3111
Adelaide,2009,11,2789,150,2939
Adelaide,2009,12,2836,153,2989
Adelaide,2010,1,2815,154,2969
Adelaide,2010,2,2757,132,2889
Adelaide,2010,3,3202,146,3348
Adelaide,2010,4,3164,139,3303
Adelaide,2010,5,3210,133,3343
Adelaide,2010,6,3078,131,3209
Adelaide,2010,7,3218,134,3352
Adelaide,2010,8,3123,133,3256
Adelaide,2010,9,3093,132,3225
Adelaide,2010,10,3174,137,3311
Adelaide,2010,11,3060,132,3192
Adelaide,2010,12,3169,140,3309
Adelaide,2011,1,2945,136,3081
Adelaide,2011,2,2719,121,2840
Adelaide,2011,3,3127,138,3265
Adelaide,2011,4,2992,144,3136
Adelaide,2011,5,3066,146,3212
Adelaide,2011,6,2761,136,2897
Adelaide,2011,7,2997,146,3143
Adelaide,2011,8,3004,143,3147
Adelaide,2011,9,2881,144,3025
Adelaide,2011,10,2879,151,3030
Adelaide,2011,11,2822,151,2973
Adelaide,2011,12,2845,172,3017
Adelaide,2012,1,2690,175,2865
Adelaide,2012,2,2734,146,2880
Adelaide,2012,3,2992,154,3146
Adelaide,2012,4,2848,150,2998
Adelaide,2012,5,2875,155,3030
Adelaide,2012,6,2738,155,2893
Adelaide,2012,7,3009,173,3182
Adelaide,2012,8,3060,167,3227
Adelaide,2012,9,2925,170,3095
Adelaide,2012,10,3071,174,3245
Adelaide,2012,11,3061,194,3255
Adelaide,2012,12,2991,207,3198
Adelaide,2013,1,2866,208,3074
Adelaide,2013,2,2689,192,2881
Adelaide,2013,3,3021,210,3231
Adelaide,2013,4,3000,194,3194
Adelaide,2013,5,3027,178,3205
Adelaide,2013,6,2807,175,2982
Adelaide,2013,7,3067,195,3262
Adelaide,2013,8,3024,177,3201
Adelaide,2013,9,3011,191,3202
Adelaide,2013,10,3115,191,3306
Adelaide,2013,11,2958,203,3161
Adelaide,2013,12,2956,239,3195
Adelaide,2014,1,2862,251,3113
Adelaide,2014,2,2703,217,2920
Adelaide,2014,3,3090,232,3322
Adelaide,2014,4,3042,233,3275
Adelaide,2014,5,3091,230,3321
Adelaide,2014,6,2979,228,3207
Adelaide,2014,7,3156,238,3394
Adelaide,2014,8,3103,225,3328
Adelaide,2014,9,3112,195,3307
Adelaide,2014,10,3203,203,3406
Adelaide,2014,11,2979,193,3172
Adelaide,2014,12,3039,223,3262
Adelaide,2015,1,2837,223,3060
Adelaide,2015,2,2746,175,2921
Adelaide,2015,3,3135,178,3313
Adelaide,2015,4,3100,182,3282
Adelaide,2015,5,3170,182,3352
Adelaide,2015,6,3048,176,3224
Adelaide,2015,7,3248,174,3422
Adelaide,2015,8,3137,161,3298
Adelaide,2015,9,3156,168,3324
Adelaide,2015,10,3220,180,3400
Adelaide,2015,11,3127,153,3280
Adelaide,2015,12,3140,195,3335
Adelaide,2016,1,2951,199,3150
Adelaide,2016,2,3020,165,3185
Adelaide,2016,3,3191,168,3359
Adelaide,2016,4,3083,171,3254
Adelaide,2016,5,3042,198,3240
Adelaide,2016,6,2915,191,3106
Adelaide,2016,7,3156,215,3371
Adelaide,2016,8,3216,192,3408
Adelaide,2016,9,3155,196,3351
Adelaide,2016,10,3227,208,3435
Adelaide,2016,11,3160,191,3351
Adelaide,2016,12,3085,228,3313
Adelaide,2017,1,2847,223,3070
Adelaide,2017,2,2844,176,3020
Adelaide,2017,3,3248,194,3442
Adelaide,2017,4,2980,183,3163
Adelaide,2017,5,3057,183,3240
Adelaide,2017,6,2916,178,3094
Adelaide,2017,7,3088,212,3300
Adelaide,2017,8,3101,208,3309
Adelaide,2017,9,3091,207,3298
Adelaide,2017,10,3193,204,3397
Adelaide,2017,11,3148,184,3332
Adelaide,2017,12,3113,234,3347
Adelaide,2018,1,3005,259,3264
Adelaide,2018,2,2850,189,3039
Adelaide,2018,3,3158,201,3359
Adelaide,2018,4,2989,198,3187
Adelaide,2018,5,3007,187,3194
Adelaide,2018,6,2862,187,3049
Adelaide,2018,7,3135,207,3342
Adelaide,2018,8,3118,204,3322
Adelaide,2018,9,3049,200,3249
Adelaide,2018,10,3262,213,3475
Adelaide,2018,11,3121,215,3336
Adelaide,2018,12,3016,230,3246
Adelaide,2019,1,2995,237,3232
Adelaide,2019,2,2874,199,3073
Adelaide,2019,3,3193,205,3398
Adelaide,2019,4,3062,211,3273
Adelaide,2019,5,3152,206,3358
Adelaide,2019,6,2951,212,3163
Adelaide,2019,7,3205,250,3455
Adelaide,2019,8,3106,234,3340
Adelaide,2019,9,3073,235,3308
Adelaide,2019,10,3239,239,3478
Adelaide,2019,11,3055,220,3275
Adelaide,2019,12,3006,263,3269
Adelaide,2020,1,2855,278,3133
Adelaide,2020,2,2835,201,3036
Adelaide,2020,3,2547,138,2685
Adelaide,2020,4,440,0,440
Adelaide,2020,5,430,4,434
Adelaide,2020,6,476,10,486
Adelaide,2020,7,678,14,692
Adelaide,2020,8,752,20,772
Adelaide,2020,9,891,21,912
Adelaide,2020,10,1157,25,1182
Adelaide,2020,11,1157,33,1190
Adelaide,2020,12,1534,35,1569
Adelaide,2021,1,1489,40,1529
Adelaide,2021,2,1408,34,1442
Adelaide,2021,3,2038,37,2075
Adelaide,2021,4,2390,37,2427
Adelaide,2021,5,2470,48,2518
Adelaide,2021,6,2069,46,2115
Adelaide,2021,7,1497,48,1545
Adelaide,2021,8,1066,36,1102
Adelaide,2021,9,1371,35,1406
Adelaide,2021,10,1490,40,1530
Adelaide,2021,11,1747,35,1782
Adelaide,2021,12,2410,52,2462
Adelaide,2022,1,1910,71,1981
Adelaide,2022,2,1752,65,1817
Adelaide,2022,3,2489,72,2561
Adelaide,2022,4,2795,74,2869
Adelaide,2022,5,2855,95,2950
Adelaide,2022,6,2752,104,2856
Adelaide,2022,7,2760,152,2912
Adelaide,2022,8,2755,137,2892
Adelaide,2022,9,2672,128,2800
Adelaide,2022,10,2806,134,2940
Adelaide,2022,11,2749,148,2897
Adelaide,2022,12,2852,203,3055
Adelaide,2023,1,2865,237,3102
Adelaide,2023,2,2686,193,2879
Adelaide,2023,3,3068,222,3290
Adelaide,2023,4,2977,254,3231
Adelaide,2023,5,3077,218,3295
Adelaide,2023,6,2873,218,3091
Adelaide,2023,7,2955,276,3231
Adelaide,2023,8,2991,229,3220
Adelaide,2023,9,2941,211,3152
Adelaide,2023,10,3079,229,3308
Adelaide,2023,11,2979,196,3175
Adelaide,2023,12,2954,286,3240
Adelaide,2024,1,2938,314,3252
Adelaide,2024,2,2820,199,3019
Adelaide,2024,3,2979,203,3182
Adelaide,2024,4,3078,234,3312
Adelaide,2024,5,3047,201,3248
Adelaide,2024,6,2832,202,3034
Adelaide,2024,7,3081,228,3309
Adelaide,2024,8,2900,180,3080
Adelaide,2024,9,2879,180,3059
Adelaide,2024,10,2996,202,3198
Adelaide,2024,11,2818,220,3038
Adelaide,2024,12,2886,234,3120
Alice Springs,1985,1,264,0,264
Alice Springs,1985,2,243,0,243
Alice Springs,1985,3,284,0,284
Alice Springs,1985,4,261,0,261
Alice Springs,1985,5,298,0,298
Alice Springs,1985,6,277,0,277
Alice Springs,1985,7,303,0,303
Alice Springs,1985,8,326,0,326
Alice Springs,1985,9,313,0,313
Alice Springs,1985,10,312,0,312
Alice Springs,1985,11,321,0,321
Alice Springs,1985,12,300,0,300
Alice Springs,1986,1,304,0,304
Alice Springs,1986,2,277,0,277
Alice Springs,1986,3,360,0,360
Alice Springs,1986,4,366,0,366
Alice Springs,1986,5,325,0,325
Alice Springs,1986,6,304,0,304
Alice Springs,1986,7,322,0,322
Alice Springs,1986,8,356,0,356
Alice Springs,1986,9,333,0,333
Alice Springs,1986,10,384,0,384
Alice Springs,1986,11,389,0,389
Alice Springs,1986,12,380,0,380
Alice Springs,1987,1,413,0,413
Alice Springs,1987,2,388,0,388
Alice Springs,1987,3,396,0,396
Alice Springs,1987,4,376,0,376
Alice Springs,1987,5,391,0,391
Alice Springs,1987,6,405,0,405
Alice Springs,1987,7,451,0,451
Alice Springs,1987,8,430,0,430
Alice Springs,1987,9,440,0,440
Alice Springs,1987,10,484,0,484
Alice Springs,1987,11,456,0,456
Alice Springs,1987,12,413,0,413
Alice Springs,1988,1,418,0,418
Alice Springs,1988,2,359,0,359
Alice Springs,1988,3,401,0,401
Alice Springs,1988,4,399,0,399
Alice Springs,1988,5,381,0,381
Alice Springs,1988,6,382,0,382
Alice Springs,1988,7,428,0,428
Alice Springs,1988,8,421,0,421
Alice Springs,1988,9,405,0,405
Alice Springs,1988,10,436,0,436
Alice Springs,1988,11,416,0,416
Alice Springs,1988,12,394,0,394
Alice Springs,1989,1,396,0,396
Alice Springs,1989,2,348,0,348
Alice Springs,1989,3,399,0,399
Alice Springs,1989,4,398,0,398
Alice Springs,1989,5,383,0,383
Alice Springs,1989,6,369,0,369
Alice Springs,1989,7,431,0,431
Alice Springs,1989,8,275,0,275
Alice Springs,1989,9,13,0,13
Alice Springs,1989,10,50,0,50
Alice Springs,1989,11,111,0,111
Alice Springs,1989,12,180,0,180
Alice Springs,1990,1,227,0,227
Alice Springs,1990,2,251,0,251
Alice Springs,1990,3,353,0,353
Alice Springs,1990,4,366,0,366
Alice Springs,1990,5,389,0,389
Alice Springs,1990,6,372,0,372
Alice Springs,1990,7,415,0,415
Alice Springs,1990,8,396,0,396
Alice Springs,1990,9,379,0,379
Alice Springs,1990,10,466,0,466
Alice Springs,1990,11,480,0,480
Alice Springs,1990,12,454,0,454
Alice Springs,1991,1,436,0,436
Alice Springs,1991,2,398,0,398
Alice Springs,1991,3,413,0,413
Alice Springs,1991,4,366,0,366
Alice Springs,1991,5,381,0,381
Alice Springs,1991,6,381,0,381
Alice Springs,1991,7,426,0,426
Alice Springs,1991,8,450,0,450
Alice Springs,1991,9,441,0,441
Alice Springs,1991,10,462,0,462
Alice Springs,1991,11,464,0,464
Alice Springs,1991,12,439,0,439
Alice Springs,1992,1,443,0,443
Alice Springs,1992,2,392,0,392
Alice Springs,1992,3,435,0,435
Alice Springs,1992,4,419,0,419
Alice Springs,1992,5,429,0,429
Alice Springs,1992,6,408,0,408
Alice Springs,1992,7,456,0,456
Alice Springs,1992,8,458,0,458
Alice Springs,1992,9,439,0,439
Alice Springs,1992,10,489,0,489
Alice Springs,1992,11,474,0,474
Alice Springs,1992,12,480,0,480
Alice Springs,1993,1,467,0,467
Alice Springs,1993,2,445,0,445
Alice Springs,1993,3,500,0,500
Alice Springs,1993,4,475,0,475
Alice Springs,1993,5,484,0,484
Alice Springs,1993,6,493,0,493
Alice Springs,1993,7,526,0,526
Alice Springs,1993,8,532,0,532
Alice Springs,1993,9,505,0,505
Alice Springs,1993,10,551,0,551
Alice Springs,1993,11,532,0,532
Alice Springs,1993,12,538,0,538
Alice Springs,1994,1,546,0,546
Alice Springs,1994,2,468,0,468
Alice Springs,1994,3,526,0,526
Alice Springs,1994,4,514,0,514
Alice Springs,1994,5,527,0,527
Alice Springs,1994,6,550,0,550
Alice Springs,1994,7,603,0,603
Alice Springs,1994,8,581,0,581
Alice Springs,1994,9,568,0,568
Alice Springs,1994,10,605,0,605
Alice Springs,1994,11,589,0,589
Alice Springs,1994,12,610,0,610
Alice Springs,1995,1,597,0,597
Alice Springs,1995,2,535,0,535
Alice Springs,1995,3,592,0,592
Alice Springs,1995,4,568,0,568
Alice Springs,1995,5,567,0,567
Alice Springs,1995,6,551,0,551
Alice Springs,1995,7,593,0,593
Alice Springs,1995,8,585,0,585
Alice Springs,1995,9,575,0,575
Alice Springs,1995,10,591,0,591
Alice Springs,1995,11,515,0,515
Alice Springs,1995,12,546,0,546
Alice Springs,1996,1,529,0,529
Alice Springs,1996,2,501,0,501
Alice Springs,1996,3,537,0,537
Alice Springs,1996,4,519,0,519
Alice Springs,1996,5,535,0,535
Alice Springs,1996,6,530,0,530
Alice Springs,1996,7,546,0,546
Alice Springs,1996,8,545,0,545
Alice Springs,1996,9,527,0,527
Alice Springs,1996,10,612,0,612
Alice Springs,1996,11,553,0,553
Alice Springs,1996,12,570,0,570
Alice Springs,1997,1,568,0,568
Alice Springs,1997,2,509,0,509
Alice Springs,1997,3,553,0,553
Alice Springs,1997,4,531,0,531
Alice Springs,1997,5,555,0,555
Alice Springs,1997,6,537,0,537
Alice Springs,1997,7,559,0,559
Alice Springs,1997,8,567,0,567
Alice Springs,1997,9,541,0,541
Alice Springs,1997,10,571,0,571
Alice Springs,1997,11,568,0,568
Alice Springs,1997,12,573,0,573
Alice Springs,1998,1,569,0,569
Alice Springs,1998,2,500,0,500
Alice Springs,1998,3,559,0,559
Alice Springs,1998,4,532,0,532
Alice Springs,1998,5,551,0,551
Alice Springs,1998,6,535,0,535
Alice Springs,1998,7,552,0,552
Alice Springs,1998,8,559,0,559
Alice Springs,1998,9,536,0,536
Alice Springs,1998,10,559,0,559
Alice Springs,1998,11,534,0,534
Alice Springs,1998,12,518,0,518
Alice Springs,1999,1,499,0,499
Alice Springs,1999,2,483,0,483
Alice Springs,1999,3,535,0,535
Alice Springs,1999,4,525,0,525
Alice Springs,1999,5,536,0,536
Alice Springs,1999,6,512,0,512
Alice Springs,1999,7,542,0,542
Alice Springs,1999,8,540,0,540
Alice Springs,1999,9,521,0,521
Alice Springs,1999,10,538,0,538
Alice Springs,1999,11,536,0,536
Alice Springs,1999,12,524,0,524
Alice Springs,2000,1,516,0,516
Alice Springs,2000,2,510,0,510
Alice Springs,2000,3,536,0,536
Alice Springs,2000,4,546,0,546
Alice Springs,2000,5,540,0,540
Alice Springs,2000,6,523,0,523
Alice Springs,2000,7,475,0,475
Alice Springs,2000,8,447,0,447
Alice Springs,2000,9,436,0,436
Alice Springs,2000,10,492,0,492
Alice Springs,2000,11,467,0,467
Alice Springs,2000,12,478,0,478
Alice Springs,2001,1,459,0,459
Alice Springs,2001,2,435,0,435
Alice Springs,2001,3,488,0,488
Alice Springs,2001,4,475,0,475
Alice Springs,2001,5,485,0,485
Alice Springs,2001,6,480,0,480
Alice Springs,2001,7,503,0,503
Alice Springs,2001,8,490,0,490
Alice Springs,2001,9,332,0,332
Alice Springs,2001,10,284,0,284
Alice Springs,2001,11,288,0,288
Alice Springs,2001,12,299,0,299
Alice Springs,2002,1,283,0,283
Alice Springs,2002,2,257,0,257
Alice Springs,2002,3,293,0,293
Alice Springs,2002,4,288,0,288
Alice Springs,2002,5,294,0,294
Alice Springs,2002,6,317,0,317
Alice Springs,2002,7,342,0,342
Alice Springs,2002,8,341,0,341
Alice Springs,2002,9,336,0,336
Alice Springs,2002,10,343,0,343
Alice Springs,2002,11,299,0,299
Alice Springs,2002,12,295,0,295
Alice Springs,2003,1,293,0,293
Alice Springs,2003,2,269,0,269
Alice Springs,2003,3,309,0,309
Alice Springs,2003,4,314,0,314
Alice Springs,2003,5,333,0,333
Alice Springs,2003,6,350,0,350
Alice Springs,2003,7,358,0,358
Alice Springs,2003,8,367,0,367
Alice Springs,2003,9,355,0,355
Alice Springs,2003,10,360,0,360
Alice Springs,2003,11,310,0,310
Alice Springs,2003,12,322,0,322
Alice Springs,2004,1,319,0,319
Alice Springs,2004,2,299,0,299
Alice Springs,2004,3,316,0,316
Alice Springs,2004,4,311,0,311
Alice Springs,2004,5,322,0,322
Alice Springs,2004,6,312,0,312
Alice Springs,2004,7,327,0,327
Alice Springs,2004,8,327,0,327
Alice Springs,2004,9,310,0,310
Alice Springs,2004,10,319,0,319
Alice Springs,2004,11,301,0,301
Alice Springs,2004,12,304,0,304
Alice Springs,2005,1,316,0,316
Alice Springs,2005,2,280,0,280
Alice Springs,2005,3,306,0,306
Alice Springs,2005,4,302,0,302
Alice Springs,2005,5,309,0,309
Alice Springs,2005,6,308,0,308
Alice Springs,2005,7,317,0,317
Alice Springs,2005,8,315,0,315
Alice Springs,2005,9,290,0,290
Alice Springs,2005,10,298,0,298
Alice Springs,2005,11,291,0,291
Alice Springs,2005,12,296,0,296
Alice Springs,2006,1,303,0,303
Alice Springs,2006,2,266,0,266
Alice Springs,2006,3,293,0,293
Alice Springs,2006,4,289,0,289
Alice Springs,2006,5,297,0,297
Alice Springs,2006,6,287,0,287
Alice Springs,2006,7,299,0,299
Alice Springs,2006,8,298,0,298
Alice Springs,2006,9,270,0,270
Alice Springs,2006,10,263,0,263
Alice Springs,2006,11,251,0,251
Alice Springs,2006,12,256,0,256
Alice Springs,2007,1,257,0,257
Alice Springs,2007,2,235,0,235
Alice Springs,2007,3,264,0,264
Alice Springs,2007,4,250,0,250
Alice Springs,2007,5,256,0,256
Alice Springs,2007,6,253,0,253
Alice Springs,2007,7,261,0,261
Alice Springs,2007,8,256,0,256
Alice Springs,2007,9,253,0,253
Alice Springs,2007,10,259,0,259
Alice Springs,2007,11,261,0,261
Alice Springs,2007,12,268,0,268
Alice Springs,2008,1,259,0,259
Alice Springs,2008,2,243,0,243
Alice Springs,2008,3,273,0,273
Alice Springs,2008,4,275,0,275
Alice Springs,2008,5,285,0,285
Alice Springs,2008,6,281,0,281
Alice Springs,2008,7,301,0,301
Alice Springs,2008,8,292,0,292
Alice Springs,2008,9,281,0,281
Alice Springs,2008,10,285,0,285
Alice Springs,2008,11,265,0,265
Alice Springs,2008,12,272,0,272
Ballina,1985,1,0,0,0
Ballina,1985,2,0,0,0
Ballina,1985,3,0,0,0
Ballina,1985,4,0,0,0
Ballina,1985,5,0,0,0
Ballina,1985,6,0,0,0
Ballina,1985,7,0,0,0
Ballina,1985,8,0,0,0
Ballina,1985,9,0,0,0
Ballina,1985,10,0,0,0
Ballina,1985,11,0,0,0
Ballina,1985,12,0,0,0
Ballina,1986,1,0,0,0
Ballina,1986,2,0,0,0
Ballina,1986,3,0,0,0
Ballina,1986,4,0,0,0
Ballina,1986,5,0,0,0
Ballina,1986,6,0,0,0
Ballina,1986,7,0,0,0
Ballina,1986,8,0,0,0
Ballina,1986,9,0,0,0
Ballina,1986,10,0,0,0
Ballina,1986,11,0,0,0
Ballina,1986,12,12,0,12
Ballina,1987,1,31,0,31
Ballina,1987,2,29,0,29
Ballina,1987,3,32,0,32
Ballina,1987,4,35,0,35
Ballina,1987,5,28,0,28
Ballina,1987,6,32,0,32
Ballina,1987,7,113,0,113
Ballina,1987,8,137,0,137
Ballina,1987,9,134,0,134
Ballina,1987,10,144,0,144
Ballina,1987,11,145,0,145
Ballina,1987,12,172,0,172
Ballina,1988,1,167,0,167
Ballina,1988,2,152,0,152
Ballina,1988,3,170,0,170
Ballina,1988,4,165,0,165
Ballina,1988,5,140,0,140
Ballina,1988,6,142,0,142
Ballina,1988,7,176,0,176
Ballina,1988,8,165,0,165
Ballina,1988,9,195,0,195
Ballina,1988,10,198,0,198
Ballina,1988,11,164,0,164
Ballina,1988,12,186,0,186
Ballina,1989,1,203,0,203
Ballina,1989,2,206,0,206
Ballina,1989,3,215,0,215
Ballina,1989,4,217,0,217
Ballina,1989,5,219,0,219
Ballina,1989,6,231,0,231
Ballina,1989,7,258,0,258
Ballina,1989,8,235,0,235
Ballina,1989,9,236,0,236
Ballina,1989,10,212,0,212
Ballina,1989,11,206,0,206
Ballina,1989,12,228,0,228
Ballina,1990,1,235,0,235
Ballina,1990,2,208,0,208
Ballina,1990,3,239,0,239
Ballina,1990,4,259,0,259
Ballina,1990,5,253,0,253
Ballina,1990,6,261,0,261
Ballina,1990,7,160,0,160
Ballina,1990,8,166,0,166
Ballina,1990,9,193,0,193
Ballina,1990,10,196,0,196
Ballina,1990,11,184,0,184
Ballina,1990,12,184,0,184
Ballina,1991,1,294,0,294
Ballina,1991,2,243,0,243
Ballina,1991,3,296,0,296
Ballina,1991,4,296,0,296
Ballina,1991,5,332,0,332
Ballina,1991,6,355,0,355
Ballina,1991,7,364,0,364
Ballina,1991,8,331,0,331
Ballina,1991,9,338,0,338
Ballina,1991,10,355,0,355
Ballina,1991,11,344,0,344
Ballina,1991,12,119,0,119
Ballina,1992,1,114,0,114
Ballina,1992,2,102,0,102
Ballina,1992,3,92,0,92
Ballina,1992,4,110,0,110
Ballina,1992,5,179,0,179
Ballina,1992,6,176,0,176
Ballina,1992,7,180,0,180
Ballina,1992,8,176,0,176
Ballina,1992,9,178,0,178
Ballina,1992,10,179,0,179
Ballina,1992,11,176,0,176
Ballina,1992,12,192,0,192
Ballina,1993,1,76,0,76
Ballina,1993,2,65,0,65
Ballina,1993,3,72,0,72
Ballina,1993,4,67,0,67
Ballina,1993,5,75,0,75
Ballina,1993,6,68,0,68
Ballina,1993,7,70,0,70
Ballina,1993,8,71,0,71
Ballina,1993,9,69,0,69
Ballina,1993,10,70,0,70
Ballina,1993,11,69,0,69
Ballina,1993,12,78,0,78
Ballina,1994,1,81,0,81
Ballina,1994,2,64,0,64
Ballina,1994,3,77,0,77
Ballina,1994,4,73,0,73
Ballina,1994,5,77,0,77
Ballina,1994,6,72,0,72
Ballina,1994,7,76,0,76
Ballina,1994,8,76,0,76
Ballina,1994,9,73,0,73
Ballina,1994,10,78,0,78
Ballina,1994,11,73,0,73
Ballina,1994,12,80,0,80
Ballina,1995,1,85,0,85
Ballina,1995,2,77,0,77
Ballina,1995,3,100,0,100
Ballina,1995,4,106,0,106
Ballina,1995,5,104,0,104
Ballina,1995,6,104,0,104
Ballina,1995,7,106,0,106
Ballina,1995,8,111,0,111
Ballina,1995,9,105,0,105
Ballina,1995,10,98,0,98
Ballina,1995,11,102,0,102
Ballina,1995,12,101,0,101
Ballina,1996,1,110,0,110
Ballina,1996,2,104,0,104
Ballina,1996,3,107,0,107
Ballina,1996,4,84,0,84
Ballina,1996,5,84,0,84
Ballina,1996,6,78,0,78
Ballina,1996,7,85,0,85
Ballina,1996,8,82,0,82
Ballina,1996,9,109,0,109
Ballina,1996,10,115,0,115
Ballina,1996,11,105,0,105
Ballina,1996,12,112,0,112
Ballina,1997,1,113,0,113
Ballina,1997,2,100,0,100
Ballina,1997,3,107,0,107
Ballina,1997,4,107,0,107
Ballina,1997,5,109,0,109
Ballina,1997,6,108,0,108
Ballina,1997,7,111,0,111
Ballina,1997,8,109,0,109
Ballina,1997,9,108,0,108
Ballina,1997,10,113,0,113
Ballina,1997,11,105,0,105
Ballina,1997,12,112,0,112
Ballina,1998,1,109,0,109
Ballina,1998,2,100,0,100
Ballina,1998,3,112,0,112
Ballina,1998,4,107,0,107
Ballina,1998,5,108,0,108
Ballina,1998,6,108,0,108
Ballina,1998,7,112,0,112
Ballina,1998,8,109,0,109
Ballina,1998,9,108,0,108
Ballina,1998,10,111,0,111
Ballina,1998,11,115,0,115
Ballina,1998,12,132,0,132
Ballina,1999,1,135,0,135
Ballina,1999,2,130,0,130
Ballina,1999,3,144,0,144
Ballina,1999,4,138,0,138
Ballina,1999,5,143,0,143
Ballina,1999,6,139,0,139
Ballina,1999,7,135,0,135
Ballina,1999,8,141,0,141
Ballina,1999,9,132,0,132
Ballina,1999,10,137,0,137
Ballina,1999,11,133,0,133
Ballina,1999,12,136,0,136
Ballina,2000,1,137,0,137
Ballina,2000,2,130,0,130
Ballina,2000,3,148,0,148
Ballina,2000,4,189,0,189
Ballina,2000,5,242,0,242
Ballina,2000,6,270,0,270
Ballina,2000,7,278,0,278
Ballina,2000,8,280,0,280
Ballina,2000,9,268,0,268
Ballina,2000,10,281,0,281
Ballina,2000,11,202,0,202
Ballina,2000,12,211,0,211
Ballina,2001,1,213,0,213
Ballina,2001,2,191,0,191
Ballina,2001,3,186,0,186
Ballina,2001,4,180,0,180
Ballina,2001,5,191,0,191
Ballina,2001,6,182,0,182
Ballina,2001,7,260,0,260
Ballina,2001,8,289,0,289
Ballina,2001,9,206,0,206
Ballina,2001,10,220,0,220
Ballina,2001,11,229,0,229
Ballina,2001,12,230,0,230
Ballina,2002,1,224,0,224
Ballina,2002,2,221,0,221
Ballina,2002,3,246,0,246
Ballina,2002,4,251,0,251
Ballina,2002,5,249,0,249
Ballina,2002,6,232,0,232
Ballina,2002,7,245,0,245
Ballina,2002,8,225,0,225
Ballina,2002,9,296,0,296
Ballina,2002,10,306,0,306
Ballina,2002,11,267,0,267
Ballina,2002,12,266,0,266
Ballina,2003,1,274,0,274
Ballina,2003,2,245,0,245
Ballina,2003,3,270,0,270
Ballina,2003,4,263,0,263
Ballina,2003,5,269,0,269
Ballina,2003,6,254,0,254
Ballina,2003,7,260,0,260
Ballina,2003,8,204,0,204
Ballina,2003,9,180,0,180
Ballina,2003,10,185,0,185
Ballina,2003,11,174,0,174
Ballina,2003,12,191,0,191
Ballina,2004,1,200,0,200
Ballina,2004,2,152,0,152
Ballina,2004,3,167,0,167
Ballina,2004,4,157,0,157
Ballina,2004,5,165,0,165
Ballina,2004,6,165,0,165
Ballina,2004,7,184,0,184
Ballina,2004,8,209,0,209
Ballina,2004,9,202,0,202
Ballina,2004,10,202,0,202
Ballina,2004,11,203,0,203
Ballina,2004,12,216,0,216
Ballina,2005,1,211,0,211
Ballina,2005,2,193,0,193
Ballina,2005,3,215,0,215
Ballina,2005,4,206,0,206
Ballina,2005,5,211,0,211
Ballina,2005,6,210,0,210
Ballina,2005,7,191,0,191
Ballina,2005,8,169,0,169
Ballina,2005,9,164,0,164
Ballina,2005,10,166,0,166
Ballina,2005,11,162,0,162
Ballina,2005,12,187,0,187
Ballina,2006,1,184,0,184
Ballina,2006,2,152,0,152
Ballina,2006,3,170,0,170
Ballina,2006,4,189,0,189
Ballina,2006,5,182,0,182
Ballina,2006,6,177,0,177
Ballina,2006,7,194,0,194
Ballina,2006,8,192,0,192
Ballina,2006,9,186,0,186
Ballina,2006,10,192,0,192
Ballina,2006,11,177,0,177
Ballina,2006,12,201,0,201
Ballina,2007,1,198,0,198
Ballina,2007,2,165,0,165
Ballina,2007,3,182,0,182
Ballina,2007,4,181,0,181
Ballina,2007,5,183,0,183
Ballina,2007,6,179,0,179
Ballina,2007,7,178,0,178
Ballina,2007,8,177,0,177
Ballina,2007,9,171,0,171
Ballina,2007,10,174,0,174
Ballina,2007,11,174,0,174
Ballina,2007,12,198,0,198
Ballina,2008,1,195,0,195
Ballina,2008,2,167,0,167
Ballina,2008,3,180,0,180
Ballina,2008,4,170,0,170
Ballina,2008,5,176,0,176
Ballina,2008,6,153,0,153
Ballina,2008,7,162,0,162
Ballina,2008,8,161,0,161
Ballina,2008,9,159,0,159
Ballina,2008,10,173,0,173
Ballina,2008,11,166,0,166
Ballina,2008,12,186,0,186
Ballina,2009,1,177,0,177
Ballina,2009,2,153,0,153
Ballina,2009,3,167,0,167
Ballina,2009,4,169,0,169
Ballina,2009,5,166,0,166
Ballina,2009,6,163,0,163
Ballina,2009,7,177,0,177
Ballina,2009,8,145,0,145
Ballina,2009,9,141,0,141
Ballina,2009,10,166,0,166
Ballina,2009,11,160,0,160
Ballina,2009,12,169,0,169
Ballina,2010,1,165,0,165
Ballina,2010,2,139,0,139
Ballina,2010,3,154,0,154
Ballina,2010,4,151,0,151
Ballina,2010,5,141,0,141
Ballina,2010,6,140,0,140
Ballina,2010,7,146,0,146
Ballina,2010,8,152,0,152
Ballina,2010,9,164,0,164
Ballina,2010,10,168,0,168
Ballina,2010,11,150,0,150
Ballina,2010,12,191,0,191
Ballina,2011,1,171,0,171
Ballina,2011,2,142,0,142
Ballina,2011,3,159,0,159
Ballina,2011,4,158,0,158
Ballina,2011,5,152,0,152
Ballina,2011,6,140,0,140
Ballina,2011,7,156,0,156
Ballina,2011,8,156,0,156
Ballina,2011,9,159,0,159
Ballina,2011,10,160,0,160
Ballina,2011,11,162,0,162
Ballina,2011,12,171,0,171
Ballina,2012,1,187,0,187
Ballina,2012,2,154,0,154
Ballina,2012,3,162,0,162
Ballina,2012,4,181,0,181
Ballina,2012,5,174,0,174
Ballina,2012,6,157,0,157
Ballina,2012,7,201,0,201
Ballina,2012,8,191,0,191
Ballina,2012,9,181,0,181
Ballina,2012,10,193,0,193
Ballina,2012,11,171,0,171
Ballina,2012,12,189,0,189
Ballina,2013,1,200,0,200
Ballina,2013,2,144,0,144
Ballina,2013,3,179,0,179
Ballina,2013,4,210,0,210
Ballina,2013,5,192,0,192
Ballina,2013,6,185,0,185
Ballina,2013,7,200,0,200
Ballina,2013,8,179,0,179
Ballina,2013,9,202,0,202
Ballina,2013,10,207,0,207
Ballina,2013,11,180,0,180
Ballina,2013,12,212,0,212
Ballina,2014,1,207,0,207
Ballina,2014,2,163,0,163
Ballina,2014,3,185,0,185
Ballina,2014,4,193,0,193
Ballina,2014,5,158,0,158
Ballina,2014,6,166,0,166
Ballina,2014,7,194,0,194
Ballina,2014,8,173,0,173
Ballina,2014,9,196,0,196
Ballina,2014,10,195,0,195
Ballina,2014,11,175,0,175
Ballina,2014,12,188,0,188
Ballina,2015,1,194,0,194
Ballina,2015,2,149,0,149
Ballina,2015,3,176,0,176
Ballina,2015,4,188,0,188
Ballina,2015,5,168,0,168
Ballina,2015,6,169,0,169
Ballina,2015,7,190,0,190
Ballina,2015,8,176,0,176
Ballina,2015,9,200,0,200
Ballina,2015,10,191,0,191
Ballina,2015,11,146,0,146
Ballina,2015,12,177,0,177
Ballina,2016,1,187,0,187
Ballina,2016,2,170,0,170
Ballina,2016,3,197,0,197
Ballina,2016,4,180,0,180
Ballina,2016,5,169,0,169
Ballina,2016,6,174,0,174
Ballina,2016,7,198,0,198
Ballina,2016,8,179,0,179
Ballina,2016,9,195,0,195
Ballina,2016,10,201,0,201
Ballina,2016,11,177,0,177
Ballina,2016,12,222,0,222
Ballina,2017,1,225,0,225
Ballina,2017,2,168,0,168
Ballina,2017,3,191,0,191
Ballina,2017,4,215,0,215
Ballina,2017,5,172,0,172
Ballina,2017,6,170,0,170
Ballina,2017,7,196,0,196
Ballina,2017,8,173,0,173
Ballina,2017,9,194,0,194
Ballina,2017,10,212,0,212
Ballina,2017,11,181,0,181
Ballina,2017,12,209,0,209
Ballina,2018,1,210,0,210
Ballina,2018,2,178,0,178
Ballina,2018,3,194,0,194
Ballina,2018,4,199,0,199
Ballina,2018,5,172,0,172
Ballina,2018,6,168,0,168
Ballina,2018,7,206,0,206
Ballina,2018,8,188,0,188
Ballina,2018,9,187,0,187
Ballina,2018,10,211,0,211
Ballina,2018,11,178,0,178
Ballina,2018,12,207,0,207
Ballina,2019,1,207,0,207
Ballina,2019,2,166,0,166
Ballina,2019,3,187,0,187
Ballina,2019,4,206,0,206
Ballina,2019,5,172,0,172
Ballina,2019,6,167,0,167
Ballina,2019,7,199,0,199
Ballina,2019,8,174,0,174
Ballina,2019,9,189,0,189
Ballina,2019,10,196,0,196
Ballina,2019,11,183,0,183
Ballina,2019,12,204,0,204
Ballina,2020,1,209,0,209
Ballina,2020,2,175,0,175
Ballina,2020,3,152,0,152
Ballina,2020,4,12,0,12
Ballina,2020,5,24,0,24
Ballina,2020,6,53,0,53
Ballina,2020,7,169,0,169
Ballina,2020,8,158,0,158
Ballina,2020,9,187,0,187
Ballina,2020,10,261,0,261
Ballina,2020,11,276,0,276
Ballina,2020,12,353,0,353
Ballina,2021,1,307,0,307
Ballina,2021,2,251,0,251
Ballina,2021,3,314,0,314
Ballina,2021,4,361,0,361
Ballina,2021,5,302,0,302
Ballina,2021,6,273,0,273
Ballina,2021,7,125,0,125
Ballina,2021,8,64,0,64
Ballina,2021,9,51,0,51
Ballina,2021,10,73,0,73
Ballina,2021,11,397,0,397
Ballina,2021,12,501,0,501
Ballina,2022,1,421,0,421
Ballina,2022,2,236,0,236
Ballina,2022,3,272,0,272
Ballina,2022,4,358,0,358
Ballina,2022,5,348,0,348
Ballina,2022,6,296,0,296
Ballina,2022,7,246,0,246
Ballina,2022,8,238,0,238
Ballina,2022,9,228,0,228
Ballina,2022,10,237,0,237
Ballina,2022,11,262,0,262
Ballina,2022,12,279,0,279
Ballina,2023,1,288,0,288
Ballina,2023,2,234,0,234
Ballina,2023,3,267,0,267
Ballina,2023,4,251,0,251
Ballina,2023,5,226,0,226
Ballina,2023,6,238,0,238
Ballina,2023,7,256,0,256
Ballina,2023,8,252,0,252
Ballina,2023,9,233,0,233
Ballina,2023,10,221,0,221
Ballina,2023,11,206,0,206
Ballina,2023,12,225,0,225
Ballina,2024,1,219,0,219
Ballina,2024,2,195,0,195
Ballina,2024,3,210,0,210
Ballina,2024,4,212,0,212
Ballina,2024,5,182,0,182
Ballina,2024,6,177,0,177
Ballina,2024,7,217,0,217
Ballina,2024,8,201,0,201
Ballina,2024,9,203,0,203
Ballina,2024,10,213,0,213
Ballina,2024,11,203,0,203
Ballina,2024,12,209,0,209
Brisbane,1985,1,2071,183,2254
Brisbane,1985,2,1812,158,1970
Brisbane,1985,3,2077,186,2263
Brisbane,1985,4,1953,173,2126
Brisbane,1985,5,2177,183,2360
Brisbane,1985,6,1905,176,2081
Brisbane,1985,7,1890,180,2070
Brisbane,1985,8,2060,192,2252
Brisbane,1985,9,2038,177,2215
Brisbane,1985,10,2079,176,2255
Brisbane,1985,11,1879,191,2070
Brisbane,1985,12,1946,215,2161
Brisbane,1986,1,2007,222,2229
Brisbane,1986,2,1617,199,1816
Brisbane,1986,3,1868,228,2096
Brisbane,1986,4,1866,230,2096
Brisbane,1986,5,2049,258,2307
Brisbane,1986,6,1877,235,2112
Brisbane,1986,7,1992,239,2231
Brisbane,1986,8,2109,238,2347
Brisbane,1986,9,2075,242,2317
Brisbane,1986,10,2230,251,2481
Brisbane,1986,11,2037,242,2279
Brisbane,1986,12,2143,250,2393
Brisbane,1987,1,2086,269,2355
Brisbane,1987,2,1853,224,2077
Brisbane,1987,3,2009,255,2264
Brisbane,1987,4,2151,259,2410
Brisbane,1987,5,2028,283,2311
Brisbane,1987,6,2251,260,2511
Brisbane,1987,7,2502,279,2781
Brisbane,1987,8,2423,285,2708
Brisbane,1987,9,2305,268,2573
Brisbane,1987,10,2456,286,2742
Brisbane,1987,11,2354,274,2628
Brisbane,1987,12,2458,302,2760
Brisbane,1988,1,2460,317,2777
Brisbane,1988,2,2193,282,2475
Brisbane,1988,3,2404,283,2687
Brisbane,1988,4,2392,352,2744
Brisbane,1988,5,2495,387,2882
Brisbane,1988,6,2611,386,2997
Brisbane,1988,7,2828,417,3245
Brisbane,1988,8,2672,390,3062
Brisbane,1988,9,2817,372,3189
Brisbane,1988,10,2809,356,3165
Brisbane,1988,11,2519,323,2842
Brisbane,1988,12,2482,392,2874
Brisbane,1989,1,2377,393,2770
Brisbane,1989,2,2185,328,2513
Brisbane,1989,3,2609,346,2955
Brisbane,1989,4,2480,399,2879
Brisbane,1989,5,2459,386,2845
Brisbane,1989,6,2481,361,2842
Brisbane,1989,7,2652,394,3046
Brisbane,1989,8,1893,382,2275
Brisbane,1989,9,1172,378,1550
Brisbane,1989,10,1402,391,1793
Brisbane,1989,11,1634,389,2023
Brisbane,1989,12,1857,425,2282
Brisbane,1990,1,1976,429,2405
Brisbane,1990,2,1874,386,2260
Brisbane,1990,3,2294,422,2716
Brisbane,1990,4,2391,437,2828
Brisbane,1990,5,2591,443,3034
Brisbane,1990,6,2485,429,2914
Brisbane,1990,7,2565,432,2997
Brisbane,1990,8,2474,437,2911
Brisbane,1990,9,2526,445,2971
Brisbane,1990,10,2637,462,3099
Brisbane,1990,11,2596,469,3065
Brisbane,1990,12,2440,499,2939
Brisbane,1991,1,2840,498,3338
Brisbane,1991,2,2532,438,2970
Brisbane,1991,3,2901,488,3389
Brisbane,1991,4,2955,454,3409
Brisbane,1991,5,3092,472,3564
Brisbane,1991,6,3113,491,3604
Brisbane,1991,7,3396,499,3895
Brisbane,1991,8,3374,500,3874
Brisbane,1991,9,3425,486,3911
Brisbane,1991,10,3537,503,4040
Brisbane,1991,11,3481,476,3957
Brisbane,1991,12,3812,506,4318
Brisbane,1992,1,3583,512,4095
Brisbane,1992,2,3107,470,3577
Brisbane,1992,3,3405,499,3904
Brisbane,1992,4,3445,488,3933
Brisbane,1992,5,3458,502,3960
Brisbane,1992,6,3458,481,3939
Brisbane,1992,7,3724,508,4232
Brisbane,1992,8,3566,503,4069
Brisbane,1992,9,3733,494,4227
Brisbane,1992,10,3864,505,4369
Brisbane,1992,11,3740,510,4250
Brisbane,1992,12,3804,568,4372
Brisbane,1993,1,3763,558,4321
Brisbane,1993,2,3327,503,3830
Brisbane,1993,3,3535,544,4079
Brisbane,1993,4,3397,538,3935
Brisbane,1993,5,3550,577,4127
Brisbane,1993,6,3555,540,4095
Brisbane,1993,7,3762,572,4334
Brisbane,1993,8,3800,570,4370
Brisbane,1993,9,3839,556,4395
Brisbane,1993,10,3980,584,4564
Brisbane,1993,11,3725,574,4299
Brisbane,1993,12,3837,611,4448
Brisbane,1994,1,3715,628,4343
Brisbane,1994,2,3440,565,4005
Brisbane,1994,3,3935,587,4522
Brisbane,1994,4,3818,563,4381
Brisbane,1994,5,4012,582,4594
Brisbane,1994,6,4012,567,4579
Brisbane,1994,7,4214,595,4809
Brisbane,1994,8,4199,598,4797
Brisbane,1994,9,4197,621,4818
Brisbane,1994,10,4301,668,4969
Brisbane,1994,11,4117,674,4791
Brisbane,1994,12,4240,696,4936
Brisbane,1995,1,4144,732,4876
Brisbane,1995,2,3799,637,4436
Brisbane,1995,3,4218,695,4913
Brisbane,1995,4,4260,709,4969
Brisbane,1995,5,4419,719,5138
Brisbane,1995,6,4293,701,4994
Brisbane,1995,7,4555,729,5284
Brisbane,1995,8,4462,728,5190
Brisbane,1995,9,4406,701,5107
Brisbane,1995,10,4570,745,5315
Brisbane,1995,11,4426,707,5133
Brisbane,1995,12,4467,771,5238
Brisbane,1996,1,4578,762,5340
Brisbane,1996,2,4337,714,5051
Brisbane,1996,3,4629,752,5381
Brisbane,1996,4,4577,745,5322
Brisbane,1996,5,4619,754,5373
Brisbane,1996,6,4451,765,5216
Brisbane,1996,7,4756,819,5575
Brisbane,1996,8,4667,800,5467
Brisbane,1996,9,4583,772,5355
Brisbane,1996,10,4807,763,5570
Brisbane,1996,11,4501,752,5253
Brisbane,1996,12,4436,808,5244
Brisbane,1997,1,4284,807,5091
Brisbane,1997,2,3983,740,4723
Brisbane,1997,3,4400,788,5188
Brisbane,1997,4,4276,768,5044
Brisbane,1997,5,4245,803,5048
Brisbane,1997,6,4284,755,5039
Brisbane,1997,7,4732,819,5551
Brisbane,1997,8,4640,817,5457
Brisbane,1997,9,4549,782,5331
Brisbane,1997,10,4719,815,5534
Brisbane,1997,11,4427,819,5246
Brisbane,1997,12,4447,864,5311
Brisbane,1998,1,4304,858,5162
Brisbane,1998,2,3894,731,4625
Brisbane,1998,3,4411,769,5180
Brisbane,1998,4,4362,762,5124
Brisbane,1998,5,4402,792,5194
Brisbane,1998,6,4351,756,5107
Brisbane,1998,7,4653,784,5437
Brisbane,1998,8,4610,802,5412
Brisbane,1998,9,4577,784,5361
Brisbane,1998,10,4763,792,5555
Brisbane,1998,11,4675,727,5402
Brisbane,1998,12,4750,781,5531
Brisbane,1999,1,4592,813,5405
Brisbane,1999,2,4220,700,4920
Brisbane,1999,3,4747,758,5505
Brisbane,1999,4,4656,708,5364
Brisbane,1999,5,4693,733,5426
Brisbane,1999,6,4624,696,5320
Brisbane,1999,7,4889,741,5630
Brisbane,1999,8,4882,748,5630
Brisbane,1999,9,4841,718,5559
Brisbane,1999,10,5071,743,5814
Brisbane,1999,11,4769,684,5453
Brisbane,1999,12,4903,745,5648
Brisbane,2000,1,4708,770,5478
Brisbane,2000,2,4385,705,5090
Brisbane,2000,3,4876,729,5605
Brisbane,2000,4,4680,757,5437
Brisbane,2000,5,4926,759,5685
Brisbane,2000,6,4964,722,5686
Brisbane,2000,7,5063,779,5842
Brisbane,2000,8,5176,765,5941
Brisbane,2000,9,5427,734,6161
Brisbane,2000,10,5718,755,6473
Brisbane,2000,11,5552,693,6245
Brisbane,2000,12,5725,744,6469
Brisbane,2001,1,5745,742,6487
Brisbane,2001,2,5279,651,5930
Brisbane,2001,3,5955,729,6684
Brisbane,2001,4,5878,760,6638
Brisbane,2001,5,5922,750,6672
Brisbane,2001,6,5550,742,6292
Brisbane,2001,7,5516,781,6297
Brisbane,2001,8,5520,780,6300
Brisbane,2001,9,4305,749,5054
Brisbane,2001,10,4224,736,4960
Brisbane,2001,11,4557,630,5187
Brisbane,2001,12,4623,712,5335
Brisbane,2002,1,4524,701,5225
Brisbane,2002,2,4164,631,4795
Brisbane,2002,3,4243,675,4918
Brisbane,2002,4,4132,701,4833
Brisbane,2002,5,4249,731,4980
Brisbane,2002,6,4094,724,4818
Brisbane,2002,7,4318,793,5111
Brisbane,2002,8,4273,799,5072
Brisbane,2002,9,4262,746,5008
Brisbane,2002,10,4445,758,5203
Brisbane,2002,11,4214,726,4940
Brisbane,2002,12,4283,713,4996
Brisbane,2003,1,4169,725,4894
Brisbane,2003,2,3651,646,4297
Brisbane,2003,3,4058,686,4744
Brisbane,2003,4,4024,672,4696
Brisbane,2003,5,4043,669,4712
Brisbane,2003,6,3946,643,4589
Brisbane,2003,7,4111,693,4804
Brisbane,2003,8,4109,677,4786
Brisbane,2003,9,4193,665,4858
Brisbane,2003,10,4445,703,5148
Brisbane,2003,11,4379,761,5140
Brisbane,2003,12,4472,810,5282
Brisbane,2004,1,4498,847,5345
Brisbane,2004,2,4236,792,5028
Brisbane,2004,3,4530,829,5359
Brisbane,2004,4,4380,822,5202
Brisbane,2004,5,4625,840,5465
Brisbane,2004,6,4661,823,5484
Brisbane,2004,7,4889,924,5813
Brisbane,2004,8,4973,911,5884
Brisbane,2004,9,4871,903,5774
Brisbane,2004,10,4968,934,5902
Brisbane,2004,11,4798,926,5724
Brisbane,2004,12,5048,962,6010
Brisbane,2005,1,4843,971,5814
Brisbane,2005,2,4545,836,5381
Brisbane,2005,3,5006,912,5918
Brisbane,2005,4,4915,934,5849
Brisbane,2005,5,5070,964,6034
Brisbane,2005,6,4899,947,5846
Brisbane,2005,7,5119,1004,6123
Brisbane,2005,8,5117,987,6104
Brisbane,2005,9,5040,961,6001
Brisbane,2005,10,5138,972,6110
Brisbane,2005,11,4916,886,5802
Brisbane,2005,12,4978,923,5901
Brisbane,2006,1,4825,947,5772
Brisbane,2006,2,4526,835,5361
Brisbane,2006,3,5079,884,5963
Brisbane,2006,4,4885,927,5812
Brisbane,2006,5,5165,916,6081
Brisbane,2006,6,4931,931,5862
Brisbane,2006,7,5154,1056,6210
Brisbane,2006,8,5178,1034,6212
Brisbane,2006,9,5020,1012,6032
Brisbane,2006,10,5199,1003,6202
Brisbane,2006,11,5045,946,5991
Brisbane,2006,12,5020,997,6017
Brisbane,2007,1,4953,989,5942
Brisbane,2007,2,4604,863,5467
Brisbane,2007,3,5146,988,6134
Brisbane,2007,4,4914,992,5906
Brisbane,2007,5,5134,1001,6135
Brisbane,2007,6,4955,992,5947
Brisbane,2007,7,5198,1041,6239
Brisbane,2007,8,5280,1030,6310
Brisbane,2007,9,5014,1004,6018
Brisbane,2007,10,5424,1020,6444
Brisbane,2007,11,5374,941,6315
Brisbane,2007,12,5493,1067,6560
Brisbane,2008,1,5423,1077,6500
Brisbane,2008,2,4924,993,5917
Brisbane,2008,3,5222,1034,6256
Brisbane,2008,4,5147,1046,6193
Brisbane,2008,5,5382,1087,6469
Brisbane,2008,6,5179,1069,6248
Brisbane,2008,7,5553,1174,6727
Brisbane,2008,8,5631,1149,6780
Brisbane,2008,9,5566,1087,6653
Brisbane,2008,10,5902,1066,6968
Brisbane,2008,11,5621,1036,6657
Brisbane,2008,12,5707,1151,6858
Brisbane,2009,1,5424,1167,6591
Brisbane,2009,2,4959,1022,5981
Brisbane,2009,3,5484,1089,6573
Brisbane,2009,4,5312,1099,6411
Brisbane,2009,5,5286,1091,6377
Brisbane,2009,6,5207,1068,6275
Brisbane,2009,7,5514,1153,6667
Brisbane,2009,8,5380,1160,6540
Brisbane,2009,9,5410,1099,6509
Brisbane,2009,10,5613,1114,6727
Brisbane,2009,11,5250,1051,6301
Brisbane,2009,12,5438,1117,6555
Brisbane,2010,1,5288,1149,6437
Brisbane,2010,2,4921,1019,5940
Brisbane,2010,3,5528,1112,6640
Brisbane,2010,4,5755,1116,6871
Brisbane,2010,5,5807,1129,6936
Brisbane,2010,6,5661,1098,6759
Brisbane,2010,7,6051,1217,7268
Brisbane,2010,8,5945,1181,7126
Brisbane,2010,9,5866,1141,7007
Brisbane,2010,10,6084,1109,7193
Brisbane,2010,11,5939,1072,7011
Brisbane,2010,12,6049,1148,7197
Brisbane,2011,1,5515,1188,6703
Brisbane,2011,2,5261,1040,6301
Brisbane,2011,3,6031,1132,7163
Brisbane,2011,4,5940,1120,7060
Brisbane,2011,5,6073,1151,7224
Brisbane,2011,6,5794,1071,6865
Brisbane,2011,7,6356,1210,7566
Brisbane,2011,8,6388,1196,7584
Brisbane,2011,9,6101,1154,7255
Brisbane,2011,10,6234,1191,7425
Brisbane,2011,11,6277,1094,7371
Brisbane,2011,12,6411,1162,7573
Brisbane,2012,1,6252,1166,7418
Brisbane,2012,2,6107,1021,7128
Brisbane,2012,3,6580,1067,7647
Brisbane,2012,4,6324,1098,7422
Brisbane,2012,5,6423,1054,7477
Brisbane,2012,6,6159,1092,7251
Brisbane,2012,7,6766,1200,7966
Brisbane,2012,8,6960,1168,8128
Brisbane,2012,9,6724,1103,7827
Brisbane,2012,10,6995,1115,8110
Brisbane,2012,11,6768,1046,7814
Brisbane,2012,12,6669,1142,7811
Brisbane,2013,1,6618,1150,7768
Brisbane,2013,2,6112,1027,7139
Brisbane,2013,3,6725,1127,7852
Brisbane,2013,4,6757,1121,7878
Brisbane,2013,5,6893,1108,8001
Brisbane,2013,6,6597,1136,7733
Brisbane,2013,7,7225,1230,8455
Brisbane,2013,8,7093,1245,8338
Brisbane,2013,9,6963,1201,8164
Brisbane,2013,10,7306,1207,8513
Brisbane,2013,11,6859,1140,7999
Brisbane,2013,12,6930,1244,8174
Brisbane,2014,1,6862,1253,8115
Brisbane,2014,2,6131,1082,7213
Brisbane,2014,3,6869,1196,8065
Brisbane,2014,4,6850,1203,8053
Brisbane,2014,5,6987,1169,8156
Brisbane,2014,6,6743,1186,7929
Brisbane,2014,7,7225,1296,8521
Brisbane,2014,8,7027,1281,8308
Brisbane,2014,9,6971,1232,8203
Brisbane,2014,10,7226,1201,8427
Brisbane,2014,11,6680,1133,7813
Brisbane,2014,12,6980,1288,8268
Brisbane,2015,1,6830,1282,8112
Brisbane,2015,2,6177,1122,7299
Brisbane,2015,3,6999,1206,8205
Brisbane,2015,4,6835,1208,8043
Brisbane,2015,5,6891,1174,8065
Brisbane,2015,6,6829,1161,7990
Brisbane,2015,7,7203,1277,8480
Brisbane,2015,8,7021,1245,8266
Brisbane,2015,9,6917,1205,8122
Brisbane,2015,10,7013,1223,8236
Brisbane,2015,11,6822,1130,7952
Brisbane,2015,12,6940,1333,8273
Brisbane,2016,1,6670,1362,8032
Brisbane,2016,2,6425,1163,7588
Brisbane,2016,3,6900,1211,8111
Brisbane,2016,4,6614,1182,7796
Brisbane,2016,5,6584,1175,7759
Brisbane,2016,6,6444,1207,7651
Brisbane,2016,7,6880,1339,8219
Brisbane,2016,8,6917,1280,8197
Brisbane,2016,9,6849,1275,8124
Brisbane,2016,10,6825,1313,8138
Brisbane,2016,11,6673,1235,7908
Brisbane,2016,12,6799,1394,8193
Brisbane,2017,1,6622,1414,8036
Brisbane,2017,2,5977,1199,7176
Brisbane,2017,3,6582,1305,7887
Brisbane,2017,4,6472,1348,7820
Brisbane,2017,5,6595,1296,7891
Brisbane,2017,6,6472,1305,7777
Brisbane,2017,7,6881,1395,8276
Brisbane,2017,8,6961,1366,8327
Brisbane,2017,9,6673,1357,8030
Brisbane,2017,10,6833,1388,8221
Brisbane,2017,11,6645,1298,7943
Brisbane,2017,12,6602,1518,8120
Brisbane,2018,1,6420,1546,7966
Brisbane,2018,2,5903,1309,7212
Brisbane,2018,3,6557,1419,7976
Brisbane,2018,4,6432,1414,7846
Brisbane,2018,5,6494,1375,7869
Brisbane,2018,6,6111,1381,7492
Brisbane,2018,7,6767,1521,8288
Brisbane,2018,8,6671,1483,8154
Brisbane,2018,9,6417,1426,7843
Brisbane,2018,10,6780,1449,8229
Brisbane,2018,11,6544,1370,7914
Brisbane,2018,12,6526,1533,8059
Brisbane,2019,1,6398,1571,7969
Brisbane,2019,2,5986,1338,7324
Brisbane,2019,3,6581,1444,8025
Brisbane,2019,4,6662,1419,8081
Brisbane,2019,5,6771,1360,8131
Brisbane,2019,6,6431,1380,7811
Brisbane,2019,7,7112,1547,8659
Brisbane,2019,8,6830,1529,8359
Brisbane,2019,9,6740,1476,8216
Brisbane,2019,10,7000,1507,8507
Brisbane,2019,11,6579,1427,8006
Brisbane,2019,12,6662,1590,8252
Brisbane,2020,1,6457,1628,8085
Brisbane,2020,2,6070,1324,7394
Brisbane,2020,3,5403,979,6382
Brisbane,2020,4,1025,115,1140
Brisbane,2020,5,831,140,971
Brisbane,2020,6,1205,146,1351
Brisbane,2020,7,2065,172,2237
Brisbane,2020,8,2119,176,2295
Brisbane,2020,9,2239,172,2411
Brisbane,2020,10,2429,188,2617
Brisbane,2020,11,2702,187,2889
Brisbane,2020,12,4258,207,4465
Brisbane,2021,1,3586,174,3760
Brisbane,2021,2,3515,168,3683
Brisbane,2021,3,4753,190,4943
Brisbane,2021,4,4653,251,4904
Brisbane,2021,5,5156,370,5526
Brisbane,2021,6,4814,394,5208
Brisbane,2021,7,3651,383,4034
Brisbane,2021,8,2268,248,2516
Brisbane,2021,9,2911,275,3186
Brisbane,2021,10,3118,279,3397
Brisbane,2021,11,3354,294,3648
Brisbane,2021,12,4839,303,5142
Brisbane,2022,1,4491,276,4767
Brisbane,2022,2,3873,300,4173
Brisbane,2022,3,5346,350,5696
Brisbane,2022,4,6011,472,6483
Brisbane,2022,5,6315,529,6844
Brisbane,2022,6,6100,559,6659
Brisbane,2022,7,5992,688,6680
Brisbane,2022,8,5920,697,6617
Brisbane,2022,9,5825,706,6531
Brisbane,2022,10,6048,767,6815
Brisbane,2022,11,6202,830,7032
Brisbane,2022,12,6374,915,7289
Brisbane,2023,1,6348,954,7302
Brisbane,2023,2,5915,812,6727
Brisbane,2023,3,6698,895,7593
Brisbane,2023,4,6462,963,7425
Brisbane,2023,5,6838,955,7793
Brisbane,2023,6,6584,1008,7592
Brisbane,2023,7,6742,1058,7800
Brisbane,2023,8,6879,1043,7922
Brisbane,2023,9,6697,1058,7755
Brisbane,2023,10,6826,1075,7901
Brisbane,2023,11,6614,1172,7786
Brisbane,2023,12,6472,1372,7844
Brisbane,2024,1,6351,1369,7720
Brisbane,2024,2,6257,1214,7471
Brisbane,2024,3,6660,1299,7959
Brisbane,2024,4,6701,1228,7929
Brisbane,2024,5,6872,1206,8078
Brisbane,2024,6,6535,1210,7745
Brisbane,2024,7,7083,1292,8375
Brisbane,2024,8,6602,1279,7881
Brisbane,2024,9,6646,1281,7927
Brisbane,2024,10,6861,1307,8168
Brisbane,2024,11,6458,1334,7792
Brisbane,2024,12,6525,1508,8033
Cairns,1985,1,486,36,522
Cairns,1985,2,384,29,413
Cairns,1985,3,454,35,489
Cairns,1985,4,445,34,479
Cairns,1985,5,479,35,514
Cairns,1985,6,463,36,499
Cairns,1985,7,426,36,462
Cairns,1985,8,443,36,479
Cairns,1985,9,409,35,444
Cairns,1985,10,371,34,405
Cairns,1985,11,438,42,480
Cairns,1985,12,460,40,500
Cairns,1986,1,438,41,479
Cairns,1986,2,346,39,385
Cairns,1986,3,441,45,486
Cairns,1986,4,453,44,497
Cairns,1986,5,467,46,513
Cairns,1986,6,485,43,528
Cairns,1986,7,476,45,521
Cairns,1986,8,557,39,596
Cairns,1986,9,564,40,604
Cairns,1986,10,616,46,662
Cairns,1986,11,543,46,589
Cairns,1986,12,594,47,641
Cairns,1987,1,570,51,621
Cairns,1987,2,462,44,506
Cairns,1987,3,540,48,588
Cairns,1987,4,570,58,628
Cairns,1987,5,561,57,618
Cairns,1987,6,582,54,636
Cairns,1987,7,644,60,704
Cairns,1987,8,628,57,685
Cairns,1987,9,643,67,710
Cairns,1987,10,720,75,795
Cairns,1987,11,667,77,744
Cairns,1987,12,727,83,810
Cairns,1988,1,702,81,783
Cairns,1988,2,566,74,640
Cairns,1988,3,624,87,711
Cairns,1988,4,661,80,741
Cairns,1988,5,607,92,699
Cairns,1988,6,658,92,750
Cairns,1988,7,760,96,856
Cairns,1988,8,709,100,809
Cairns,1988,9,709,98,807
Cairns,1988,10,727,97,824
Cairns,1988,11,702,124,826
Cairns,1988,12,735,136,871
Cairns,1989,1,703,145,848
Cairns,1989,2,581,121,702
Cairns,1989,3,715,129,844
Cairns,1989,4,711,124,835
Cairns,1989,5,696,124,820
Cairns,1989,6,730,129,859
Cairns,1989,7,813,139,952
Cairns,1989,8,575,131,706
Cairns,1989,9,273,139,412
Cairns,1989,10,316,133,449
Cairns,1989,11,331,133,464
Cairns,1989,12,400,130,530
Cairns,1990,1,460,131,591
Cairns,1990,2,411,116,527
Cairns,1990,3,525,130,655
Cairns,1990,4,524,131,655
Cairns,1990,5,576,133,709
Cairns,1990,6,627,131,758
Cairns,1990,7,718,158,876
Cairns,1990,8,886,154,1040
Cairns,1990,9,830,168,998
Cairns,1990,10,865,162,1027
Cairns,1990,11,872,216,1088
Cairns,1990,12,657,226,883
Cairns,1991,1,896,231,1127
Cairns,1991,2,742,204,946
Cairns,1991,3,920,232,1152
Cairns,1991,4,956,196,1152
Cairns,1991,5,1028,201,1229
Cairns,1991,6,1038,205,1243
Cairns,1991,7,1134,206,1340
Cairns,1991,8,1123,209,1332
Cairns,1991,9,1149,193,1342
Cairns,1991,10,1216,197,1413
Cairns,1991,11,1169,253,1422
Cairns,1991,12,1138,284,1422
Cairns,1992,1,1114,279,1393
Cairns,1992,2,955,260,1215
Cairns,1992,3,993,279,1272
Cairns,1992,4,1073,324,1397
Cairns,1992,5,1032,324,1356
Cairns,1992,6,1052,316,1368
Cairns,1992,7,1179,333,1512
Cairns,1992,8,1169,329,1498
Cairns,1992,9,1147,326,1473
Cairns,1992,10,1231,332,1563
Cairns,1992,11,1186,352,1538
Cairns,1992,12,1192,384,1576
Cairns,1993,1,1145,391,1536
Cairns,1993,2,987,330,1317
Cairns,1993,3,1126,361,1487
Cairns,1993,4,1132,357,1489
Cairns,1993,5,1124,366,1490
Cairns,1993,6,1115,360,1475
Cairns,1993,7,1220,380,1600
Cairns,1993,8,1227,374,1601
Cairns,1993,9,1220,363,1583
Cairns,1993,10,1293,375,1668
Cairns,1993,11,1237,373,1610
Cairns,1993,12,1225,400,1625
Cairns,1994,1,1238,391,1629
Cairns,1994,2,1096,349,1445
Cairns,1994,3,1263,392,1655
Cairns,1994,4,1273,389,1662
Cairns,1994,5,1259,409,1668
Cairns,1994,6,1261,396,1657
Cairns,1994,7,1393,402,1795
Cairns,1994,8,1408,410,1818
Cairns,1994,9,1352,393,1745
Cairns,1994,10,1436,399,1835
Cairns,1994,11,1356,394,1750
Cairns,1994,12,1378,398,1776
Cairns,1995,1,1340,404,1744
Cairns,1995,2,1171,358,1529
Cairns,1995,3,1351,389,1740
Cairns,1995,4,1357,388,1745
Cairns,1995,5,1364,392,1756
Cairns,1995,6,1347,384,1731
Cairns,1995,7,1457,402,1859
Cairns,1995,8,1475,400,1875
Cairns,1995,9,1432,378,1810
Cairns,1995,10,1493,393,1886
Cairns,1995,11,1407,389,1796
Cairns,1995,12,1445,414,1859
Cairns,1996,1,1402,406,1808
Cairns,1996,2,1267,391,1658
Cairns,1996,3,1361,410,1771
Cairns,1996,4,1370,392,1762
Cairns,1996,5,1348,408,1756
Cairns,1996,6,1334,399,1733
Cairns,1996,7,1441,426,1867
Cairns,1996,8,1452,422,1874
Cairns,1996,9,1396,419,1815
Cairns,1996,10,1534,423,1957
Cairns,1996,11,1468,426,1894
Cairns,1996,12,1514,451,1965
Cairns,1997,1,1445,431,1876
Cairns,1997,2,1319,394,1713
Cairns,1997,3,1388,424,1812
Cairns,1997,4,1396,346,1742
Cairns,1997,5,1386,362,1748
Cairns,1997,6,1376,364,1740
Cairns,1997,7,1474,374,1848
Cairns,1997,8,1461,383,1844
Cairns,1997,9,1427,362,1789
Cairns,1997,10,1510,375,1885
Cairns,1997,11,1407,341,1748
Cairns,1997,12,1443,347,1790
Cairns,1998,1,1437,345,1782
Cairns,1998,2,1236,300,1536
Cairns,1998,3,1396,329,1725
Cairns,1998,4,1395,310,1705
Cairns,1998,5,1402,319,1721
Cairns,1998,6,1368,305,1673
Cairns,1998,7,1471,333,1804
Cairns,1998,8,1453,322,1775
Cairns,1998,9,1449,311,1760
Cairns,1998,10,1517,317,1834
Cairns,1998,11,1427,296,1723
Cairns,1998,12,1460,311,1771
Cairns,1999,1,1412,307,1719
Cairns,1999,2,1241,282,1523
Cairns,1999,3,1424,321,1745
Cairns,1999,4,1389,316,1705
Cairns,1999,5,1416,321,1737
Cairns,1999,6,1410,291,1701
Cairns,1999,7,1511,317,1828
Cairns,1999,8,1465,306,1771
Cairns,1999,9,1427,305,1732
Cairns,1999,10,1486,305,1791
Cairns,1999,11,1401,278,1679
Cairns,1999,12,1440,283,1723
Cairns,2000,1,1417,275,1692
Cairns,2000,2,1317,253,1570
Cairns,2000,3,1454,277,1731
Cairns,2000,4,1406,271,1677
Cairns,2000,5,1495,275,1770
Cairns,2000,6,1476,272,1748
Cairns,2000,7,1558,284,1842
Cairns,2000,8,1551,269,1820
Cairns,2000,9,1506,250,1756
Cairns,2000,10,1565,252,1817
Cairns,2000,11,1486,249,1735
Cairns,2000,12,1494,266,1760
Cairns,2001,1,1452,264,1716
Cairns,2001,2,1314,235,1549
Cairns,2001,3,1480,256,1736
Cairns,2001,4,1478,247,1725
Cairns,2001,5,1534,253,1787
Cairns,2001,6,1454,244,1698
Cairns,2001,7,1485,228,1713
Cairns,2001,8,1431,234,1665
Cairns,2001,9,1195,238,1433
Cairns,2001,10,1134,255,1389
Cairns,2001,11,1113,249,1362
Cairns,2001,12,1147,268,1415
Cairns,2002,1,1093,264,1357
Cairns,2002,2,1048,233,1281
Cairns,2002,3,1187,259,1446
Cairns,2002,4,1165,244,1409
Cairns,2002,5,1288,309,1597
Cairns,2002,6,1232,300,1532
Cairns,2002,7,1397,306,1703
Cairns,2002,8,1424,308,1732
Cairns,2002,9,1325,293,1618
Cairns,2002,10,1394,314,1708
Cairns,2002,11,1287,336,1623
Cairns,2002,12,1269,347,1616
Cairns,2003,1,1227,354,1581
Cairns,2003,2,1167,319,1486
Cairns,2003,3,1294,351,1645
Cairns,2003,4,1253,331,1584
Cairns,2003,5,1297,265,1562
Cairns,2003,6,1238,231,1469
Cairns,2003,7,1340,263,1603
Cairns,2003,8,1420,272,1692
Cairns,2003,9,1401,265,1666
Cairns,2003,10,1467,304,1771
Cairns,2003,11,1400,361,1761
Cairns,2003,12,1470,366,1836
Cairns,2004,1,1432,379,1811
Cairns,2004,2,1271,349,1620
Cairns,2004,3,1403,368,1771
Cairns,2004,4,1452,358,1810
Cairns,2004,5,1472,367,1839
Cairns,2004,6,1440,359,1799
Cairns,2004,7,1578,368,1946
Cairns,2004,8,1628,367,1995
Cairns,2004,9,1552,355,1907
Cairns,2004,10,1614,366,1980
Cairns,2004,11,1559,362,1921
Cairns,2004,12,1506,350,1856
Cairns,2005,1,1453,337,1790
Cairns,2005,2,1411,318,1729
Cairns,2005,3,1563,346,1909
Cairns,2005,4,1543,332,1875
Cairns,2005,5,1581,336,1917
Cairns,2005,6,1589,332,1921
Cairns,2005,7,1649,348,1997
Cairns,2005,8,1710,366,2076
Cairns,2005,9,1698,352,2050
Cairns,2005,10,1721,356,2077
Cairns,2005,11,1658,356,2014
Cairns,2005,12,1637,377,2014
Cairns,2006,1,1590,375,1965
Cairns,2006,2,1349,338,1687
Cairns,2006,3,1519,369,1888
Cairns,2006,4,1441,331,1772
Cairns,2006,5,1539,344,1883
Cairns,2006,6,1554,341,1895
Cairns,2006,7,1639,342,1981
Cairns,2006,8,1622,343,1965
Cairns,2006,9,1578,331,1909
Cairns,2006,10,1619,332,1951
Cairns,2006,11,1580,335,1915
Cairns,2006,12,1480,341,1821
Cairns,2007,1,1451,358,1809
Cairns,2007,2,1387,324,1711
Cairns,2007,3,1535,349,1884
Cairns,2007,4,1451,312,1763
Cairns,2007,5,1567,328,1895
Cairns,2007,6,1553,319,1872
Cairns,2007,7,1524,331,1855
Cairns,2007,8,1536,331,1867
Cairns,2007,9,1448,317,1765
Cairns,2007,10,1508,321,1829
Cairns,2007,11,1499,305,1804
Cairns,2007,12,1491,311,1802
Cairns,2008,1,1473,317,1790
Cairns,2008,2,1389,302,1691
Cairns,2008,3,1518,313,1831
Cairns,2008,4,1484,305,1789
Cairns,2008,5,1557,311,1868
Cairns,2008,6,1557,299,1856
Cairns,2008,7,1596,317,1913
Cairns,2008,8,1624,335,1959
Cairns,2008,9,1505,322,1827
Cairns,2008,10,1465,337,1802
Cairns,2008,11,1337,326,1663
Cairns,2008,12,1329,279,1608
Cairns,2009,1,1295,216,1511
Cairns,2009,2,1176,183,1359
Cairns,2009,3,1307,212,1519
Cairns,2009,4,1342,209,1551
Cairns,2009,5,1316,214,1530
Cairns,2009,6,1318,202,1520
Cairns,2009,7,1476,204,1680
Cairns,2009,8,1417,212,1629
Cairns,2009,9,1394,199,1593
Cairns,2009,10,1439,200,1639
Cairns,2009,11,1392,189,1581
Cairns,2009,12,1397,195,1592
Cairns,2010,1,1370,195,1565
Cairns,2010,2,1297,185,1482
Cairns,2010,3,1439,207,1646
Cairns,2010,4,1503,218,1721
Cairns,2010,5,1463,219,1682
Cairns,2010,6,1476,216,1692
Cairns,2010,7,1577,265,1842
Cairns,2010,8,1519,262,1781
Cairns,2010,9,1552,247,1799
Cairns,2010,10,1594,249,1843
Cairns,2010,11,1526,244,1770
Cairns,2010,12,1560,256,1816
Cairns,2011,1,1511,265,1776
Cairns,2011,2,1292,218,1510
Cairns,2011,3,1509,260,1769
Cairns,2011,4,1578,247,1825
Cairns,2011,5,1566,253,1819
Cairns,2011,6,1566,236,1802
Cairns,2011,7,1676,269,1945
Cairns,2011,8,1674,277,1951
Cairns,2011,9,1598,265,1863
Cairns,2011,10,1601,253,1854
Cairns,2011,11,1479,233,1712
Cairns,2011,12,1493,246,1739
Cairns,2012,1,1517,245,1762
Cairns,2012,2,1414,231,1645
Cairns,2012,3,1559,238,1797
Cairns,2012,4,1627,231,1858
Cairns,2012,5,1629,230,1859
Cairns,2012,6,1569,220,1789
Cairns,2012,7,1761,246,2007
Cairns,2012,8,1709,257,1966
Cairns,2012,9,1645,248,1893
Cairns,2012,10,1736,244,1980
Cairns,2012,11,1577,236,1813
Cairns,2012,12,1593,241,1834
Cairns,2013,1,1612,231,1843
Cairns,2013,2,1403,222,1625
Cairns,2013,3,1556,232,1788
Cairns,2013,4,1699,223,1922
Cairns,2013,5,1662,245,1907
Cairns,2013,6,1646,240,1886
Cairns,2013,7,1830,268,2098
Cairns,2013,8,1778,268,2046
Cairns,2013,9,1735,241,1976
Cairns,2013,10,1792,250,2042
Cairns,2013,11,1572,212,1784
Cairns,2013,12,1631,212,1843
Cairns,2014,1,1665,225,1890
Cairns,2014,2,1353,205,1558
Cairns,2014,3,1479,217,1696
Cairns,2014,4,1624,191,1815
Cairns,2014,5,1591,216,1807
Cairns,2014,6,1595,216,1811
Cairns,2014,7,1784,231,2015
Cairns,2014,8,1717,239,1956
Cairns,2014,9,1724,222,1946
Cairns,2014,10,1744,228,1972
Cairns,2014,11,1541,198,1739
Cairns,2014,12,1625,206,1831
Cairns,2015,1,1619,211,1830
Cairns,2015,2,1464,216,1680
Cairns,2015,3,1581,210,1791
Cairns,2015,4,1605,228,1833
Cairns,2015,5,1577,217,1794
Cairns,2015,6,1635,227,1862
Cairns,2015,7,1850,255,2105
Cairns,2015,8,1818,273,2091
Cairns,2015,9,1818,242,2060
Cairns,2015,10,1828,241,2069
Cairns,2015,11,1656,222,1878
Cairns,2015,12,1781,257,2038
Cairns,2016,1,1751,286,2037
Cairns,2016,2,1616,282,1898
Cairns,2016,3,1721,286,2007
Cairns,2016,4,1781,277,2058
Cairns,2016,5,1705,260,1965
Cairns,2016,6,1758,257,2015
Cairns,2016,7,1926,275,2201
Cairns,2016,8,1898,281,2179
Cairns,2016,9,1885,272,2157
Cairns,2016,10,1880,270,2150
Cairns,2016,11,1684,231,1915
Cairns,2016,12,1817,255,2072
Cairns,2017,1,1808,264,2072
Cairns,2017,2,1528,226,1754
Cairns,2017,3,1730,238,1968
Cairns,2017,4,1780,243,2023
Cairns,2017,5,1730,226,1956
Cairns,2017,6,1746,224,1970
Cairns,2017,7,1960,262,2222
Cairns,2017,8,1896,280,2176
Cairns,2017,9,1832,248,2080
Cairns,2017,10,1864,246,2110
Cairns,2017,11,1688,212,1900
Cairns,2017,12,1730,214,1944
Cairns,2018,1,1816,231,2047
Cairns,2018,2,1538,199,1737
Cairns,2018,3,1674,209,1883
Cairns,2018,4,1799,200,1999
Cairns,2018,5,1689,193,1882
Cairns,2018,6,1695,188,1883
Cairns,2018,7,1925,225,2150
Cairns,2018,8,1870,233,2103
Cairns,2018,9,1791,210,2001
Cairns,2018,10,1876,215,2091
Cairns,2018,11,1640,156,1796
Cairns,2018,12,1703,182,1885
Cairns,2019,1,1785,190,1975
Cairns,2019,2,1511,173,1684
Cairns,2019,3,1581,177,1758
Cairns,2019,4,1738,217,1955
Cairns,2019,5,1679,212,1891
Cairns,2019,6,1612,211,1823
Cairns,2019,7,1890,236,2126
Cairns,2019,8,1763,243,2006
Cairns,2019,9,1720,224,1944
Cairns,2019,10,1802,221,2023
Cairns,2019,11,1602,183,1785
Cairns,2019,12,1660,156,1816
Cairns,2020,1,1700,169,1869
Cairns,2020,2,1441,145,1586
Cairns,2020,3,1271,113,1384
Cairns,2020,4,239,13,252
Cairns,2020,5,277,17,294
Cairns,2020,6,359,18,377
Cairns,2020,7,688,17,705
Cairns,2020,8,737,18,755
Cairns,2020,9,946,18,964
Cairns,2020,10,991,20,1011
Cairns,2020,11,914,22,936
Cairns,2020,12,1178,19,1197
Cairns,2021,1,1149,19,1168
Cairns,2021,2,938,20,958
Cairns,2021,3,1196,20,1216
Cairns,2021,4,1508,16,1524
Cairns,2021,5,1437,12,1449
Cairns,2021,6,1448,15,1463
Cairns,2021,7,1438,17,1455
Cairns,2021,8,1027,9,1036
Cairns,2021,9,1221,9,1230
Cairns,2021,10,1245,12,1257
Cairns,2021,11,1244,11,1255
Cairns,2021,12,1531,10,1541
Cairns,2022,1,1439,54,1493
Cairns,2022,2,1020,61,1081
Cairns,2022,3,1388,69,1457
Cairns,2022,4,1746,85,1831
Cairns,2022,5,1601,88,1689
Cairns,2022,6,1636,91,1727
Cairns,2022,7,1689,71,1760
Cairns,2022,8,1646,92,1738
Cairns,2022,9,1640,69,1709
Cairns,2022,10,1654,82,1736
Cairns,2022,11,1513,75,1588
Cairns,2022,12,1584,79,1663
Cairns,2023,1,1543,89,1632
Cairns,2023,2,1287,91,1378
Cairns,2023,3,1518,106,1624
Cairns,2023,4,1666,121,1787
Cairns,2023,5,1624,120,1744
Cairns,2023,6,1659,121,1780
Cairns,2023,7,1782,175,1957
Cairns,2023,8,1777,186,1963
Cairns,2023,9,1758,165,1923
Cairns,2023,10,1814,160,1974
Cairns,2023,11,1590,153,1743
Cairns,2023,12,1478,152,1630
Cairns,2024,1,1705,171,1876
Cairns,2024,2,1480,159,1639
Cairns,2024,3,1605,166,1771
Cairns,2024,4,1814,157,1971
Cairns,2024,5,1694,160,1854
Cairns,2024,6,1682,151,1833
Cairns,2024,7,1953,163,2116
Cairns,2024,8,1866,172,2038
Cairns,2024,9,1850,167,2017
Cairns,2024,10,1845,168,2013
Cairns,2024,11,1610,159,1769
Cairns,2024,12,1702,196,1898
Canberra,1985,1,690,0,690
Canberra,1985,2,737,0,737
Canberra,1985,3,837,0,837
Canberra,1985,4,757,0,757
Canberra,1985,5,848,0,848
Canberra,1985,6,722,0,722
Canberra,1985,7,741,0,741
Canberra,1985,8,839,0,839
Canberra,1985,9,896,0,896
Canberra,1985,10,958,0,958
Canberra,1985,11,885,0,885
Canberra,1985,12,850,0,850
Canberra,1986,1,743,0,743
Canberra,1986,2,810,0,810
Canberra,1986,3,898,0,898
Canberra,1986,4,903,0,903
Canberra,1986,5,913,0,913
Canberra,1986,6,870,0,870
Canberra,1986,7,873,0,873
Canberra,1986,8,918,0,918
Canberra,1986,9,915,0,915
Canberra,1986,10,953,0,953
Canberra,1986,11,911,0,911
Canberra,1986,12,888,0,888
Canberra,1987,1,768,0,768
Canberra,1987,2,836,0,836
Canberra,1987,3,934,0,934
Canberra,1987,4,920,0,920
Canberra,1987,5,953,0,953
Canberra,1987,6,902,0,902
Canberra,1987,7,969,0,969
Canberra,1987,8,961,0,961
Canberra,1987,9,941,0,941
Canberra,1987,10,997,0,997
Canberra,1987,11,983,0,983
Canberra,1987,12,886,0,886
Canberra,1988,1,733,0,733
Canberra,1988,2,833,0,833
Canberra,1988,3,896,0,896
Canberra,1988,4,799,0,799
Canberra,1988,5,928,0,928
Canberra,1988,6,881,0,881
Canberra,1988,7,835,0,835
Canberra,1988,8,972,0,972
Canberra,1988,9,936,0,936
Canberra,1988,10,889,0,889
Canberra,1988,11,928,0,928
Canberra,1988,12,809,0,809
Canberra,1989,1,614,0,614
Canberra,1989,2,818,0,818
Canberra,1989,3,850,0,850
Canberra,1989,4,831,0,831
Canberra,1989,5,956,0,956
Canberra,1989,6,903,0,903
Canberra,1989,7,967,0,967
Canberra,1989,8,617,0,617
Canberra,1989,9,273,0,273
Canberra,1989,10,549,0,549
Canberra,1989,11,660,0,660
Canberra,1989,12,527,0,527
Canberra,1990,1,438,0,438
Canberra,1990,2,534,0,534
Canberra,1990,3,602,0,602
Canberra,1990,4,696,0,696
Canberra,1990,5,825,0,825
Canberra,1990,6,835,0,835
Canberra,1990,7,899,0,899
Canberra,1990,8,990,0,990
Canberra,1990,9,921,0,921
Canberra,1990,10,970,0,970
Canberra,1990,11,978,0,978
Canberra,1990,12,908,0,908
Canberra,1991,1,750,0,750
Canberra,1991,2,861,0,861
Canberra,1991,3,950,0,950
Canberra,1991,4,935,0,935
Canberra,1991,5,1061,0,1061
Canberra,1991,6,981,0,981
Canberra,1991,7,1095,0,1095
Canberra,1991,8,1104,0,1104
Canberra,1991,9,1086,0,1086
Canberra,1991,10,1158,0,1158
Canberra,1991,11,1142,0,1142
Canberra,1991,12,1025,0,1025
Canberra,1992,1,750,0,750
Canberra,1992,2,1057,0,1057
Canberra,1992,3,1127,0,1127
Canberra,1992,4,1149,0,1149
Canberra,1992,5,1158,0,1158
Canberra,1992,6,1142,0,1142
Canberra,1992,7,1211,0,1211
Canberra,1992,8,1196,0,1196
Canberra,1992,9,1246,0,1246
Canberra,1992,10,1280,0,1280
Canberra,1992,11,1244,0,1244
Canberra,1992,12,1127,0,1127
Canberra,1993,1,900,0,900
Canberra,1993,2,1158,0,1158
Canberra,1993,3,1329,0,1329
Canberra,1993,4,1256,0,1256
Canberra,1993,5,1320,0,1320
Canberra,1993,6,1268,0,1268
Canberra,1993,7,1264,0,1264
Canberra,1993,8,1289,0,1289
Canberra,1993,9,1242,0,1242
Canberra,1993,10,1273,0,1273
Canberra,1993,11,1304,0,1304
Canberra,1993,12,1191,0,1191
Canberra,1994,1,957,0,957
Canberra,1994,2,1279,0,1279
Canberra,1994,3,1459,0,1459
Canberra,1994,4,1393,0,1393
Canberra,1994,5,1529,0,1529
Canberra,1994,6,1461,0,1461
Canberra,1994,7,1468,0,1468
Canberra,1994,8,1527,0,1527
Canberra,1994,9,1538,0,1538
Canberra,1994,10,1509,0,1509
Canberra,1994,11,1558,0,1558
Canberra,1994,12,1441,0,1441
Canberra,1995,1,1151,0,1151
Canberra,1995,2,1444,0,1444
Canberra,1995,3,1619,0,1619
Canberra,1995,4,1454,0,1454
Canberra,1995,5,1599,0,1599
Canberra,1995,6,1511,0,1511
Canberra,1995,7,1574,0,1574
Canberra,1995,8,1595,0,1595
Canberra,1995,9,1537,0,1537
Canberra,1995,10,1612,0,1612
Canberra,1995,11,1603,0,1603
Canberra,1995,12,1413,0,1413
Canberra,1996,1,1286,0,1286
Canberra,1996,2,1488,0,1488
Canberra,1996,3,1571,0,1571
Canberra,1996,4,1603,0,1603
Canberra,1996,5,1731,0,1731
Canberra,1996,6,1567,0,1567
Canberra,1996,7,1700,0,1700
Canberra,1996,8,1690,0,1690
Canberra,1996,9,1643,0,1643
Canberra,1996,10,1725,0,1725
Canberra,1996,11,1623,0,1623
Canberra,1996,12,1460,0,1460
Canberra,1997,1,1211,0,1211
Canberra,1997,2,1528,0,1528
Canberra,1997,3,1635,0,1635
Canberra,1997,4,1639,0,1639
Canberra,1997,5,1649,0,1649
Canberra,1997,6,1602,0,1602
Canberra,1997,7,1720,0,1720
Canberra,1997,8,1664,0,1664
Canberra,1997,9,1652,0,1652
Canberra,1997,10,1715,0,1715
Canberra,1997,11,1628,0,1628
Canberra,1997,12,1493,0,1493
Canberra,1998,1,1285,0,1285
Canberra,1998,2,1543,0,1543
Canberra,1998,3,1717,0,1717
Canberra,1998,4,1586,0,1586
Canberra,1998,5,1648,0,1648
Canberra,1998,6,1590,0,1590
Canberra,1998,7,1693,0,1693
Canberra,1998,8,1649,0,1649
Canberra,1998,9,1626,0,1626
Canberra,1998,10,1658,0,1658
Canberra,1998,11,1602,0,1602
Canberra,1998,12,1474,0,1474
Canberra,1999,1,1245,0,1245
Canberra,1999,2,1549,0,1549
Canberra,1999,3,1703,0,1703
Canberra,1999,4,1571,0,1571
Canberra,1999,5,1654,0,1654
Canberra,1999,6,1624,0,1624
Canberra,1999,7,1720,0,1720
Canberra,1999,8,1735,0,1735
Canberra,1999,9,1698,0,1698
Canberra,1999,10,1707,0,1707
Canberra,1999,11,1679,0,1679
Canberra,1999,12,1601,0,1601
Canberra,2000,1,1406,0,1406
Canberra,2000,2,1644,0,1644
Canberra,2000,3,1813,0,1813
Canberra,2000,4,1626,0,1626
Canberra,2000,5,1828,0,1828
Canberra,2000,6,2015,0,2015
Canberra,2000,7,2128,0,2128
Canberra,2000,8,2128,0,2128
Canberra,2000,9,1996,0,1996
Canberra,2000,10,2121,0,2121
Canberra,2000,11,2108,0,2108
Canberra,2000,12,1922,0,1922
Canberra,2001,1,1764,0,1764
Canberra,2001,2,2194,0,2194
Canberra,2001,3,2497,0,2497
Canberra,2001,4,2420,0,2420
Canberra,2001,5,2517,0,2517
Canberra,2001,6,2067,0,2067
Canberra,2001,7,2172,0,2172
Canberra,2001,8,2289,0,2289
Canberra,2001,9,1602,0,1602
Canberra,2001,10,1483,0,1483
Canberra,2001,11,1613,0,1613
Canberra,2001,12,1536,0,1536
Canberra,2002,1,1385,0,1385
Canberra,2002,2,1527,0,1527
Canberra,2002,3,1586,0,1586
Canberra,2002,4,1557,0,1557
Canberra,2002,5,1624,0,1624
Canberra,2002,6,1484,0,1484
Canberra,2002,7,1503,0,1503
Canberra,2002,8,1479,0,1479
Canberra,2002,9,1526,0,1526
Canberra,2002,10,1663,0,1663
Canberra,2002,11,1516,0,1516
Canberra,2002,12,1390,0,1390
Canberra,2003,1,1284,0,1284
Canberra,2003,2,1418,0,1418
Canberra,2003,3,1574,0,1574
Canberra,2003,4,1396,0,1396
Canberra,2003,5,1625,0,1625
Canberra,2003,6,1638,0,1638
Canberra,2003,7,1764,0,1764
Canberra,2003,8,1625,0,1625
Canberra,2003,9,1668,0,1668
Canberra,2003,10,1699,0,1699
Canberra,2003,11,1555,0,1555
Canberra,2003,12,1480,0,1480
Canberra,2004,1,1387,0,1387
Canberra,2004,2,1617,0,1617
Canberra,2004,3,1810,0,1810
Canberra,2004,4,1715,0,1715
Canberra,2004,5,1770,0,1770
Canberra,2004,6,1730,0,1730
Canberra,2004,7,1775,8,1783
Canberra,2004,8,1807,9,1816
Canberra,2004,9,1712,4,1716
Canberra,2004,10,1709,0,1709
Canberra,2004,11,1723,0,1723
Canberra,2004,12,1567,0,1567
Canberra,2005,1,1293,0,1293
Canberra,2005,2,1456,0,1456
Canberra,2005,3,1586,0,1586
Canberra,2005,4,1514,0,1514
Canberra,2005,5,1623,0,1623
Canberra,2005,6,1598,0,1598
Canberra,2005,7,1614,0,1614
Canberra,2005,8,1703,0,1703
Canberra,2005,9,1665,0,1665
Canberra,2005,10,1686,0,1686
Canberra,2005,11,1687,0,1687
Canberra,2005,12,1430,0,1430
Canberra,2006,1,1211,0,1211
Canberra,2006,2,1505,0,1505
Canberra,2006,3,1690,0,1690
Canberra,2006,4,1548,0,1548
Canberra,2006,5,1803,0,1803
Canberra,2006,6,1658,0,1658
Canberra,2006,7,1698,0,1698
Canberra,2006,8,1773,0,1773
Canberra,2006,9,1672,0,1672
Canberra,2006,10,1690,0,1690
Canberra,2006,11,1671,0,1671
Canberra,2006,12,1404,0,1404
Canberra,2007,1,1249,0,1249
Canberra,2007,2,1536,0,1536
Canberra,2007,3,1704,0,1704
Canberra,2007,4,1481,0,1481
Canberra,2007,5,1749,0,1749
Canberra,2007,6,1606,0,1606
Canberra,2007,7,1574,0,1574
Canberra,2007,8,1789,0,1789
Canberra,2007,9,1624,0,1624
Canberra,2007,10,1695,0,1695
Canberra,2007,11,1690,0,1690
Canberra,2007,12,1487,0,1487
Canberra,2008,1,1332,0,1332
Canberra,2008,2,1733,0,1733
Canberra,2008,3,1896,0,1896
Canberra,2008,4,1933,0,1933
Canberra,2008,5,2013,0,2013
Canberra,2008,6,1926,0,1926
Canberra,2008,7,1980,0,1980
Canberra,2008,8,1977,0,1977
Canberra,2008,9,1967,0,1967
Canberra,2008,10,2011,0,2011
Canberra,2008,11,1889,0,1889
Canberra,2008,12,1703,0,1703
Canberra,2009,1,1585,0,1585
Canberra,2009,2,1758,0,1758
Canberra,2009,3,1939,0,1939
Canberra,2009,4,1897,0,1897
Canberra,2009,5,2006,0,2006
Canberra,2009,6,1923,0,1923
Canberra,2009,7,1961,0,1961
Canberra,2009,8,1939,0,1939
Canberra,2009,9,1907,0,1907
Canberra,2009,10,1831,0,1831
Canberra,2009,11,1873,0,1873
Canberra,2009,12,1763,0,1763
Canberra,2010,1,1570,0,1570
Canberra,2010,2,1772,0,1772
Canberra,2010,3,1969,0,1969
Canberra,2010,4,1850,0,1850
Canberra,2010,5,1908,0,1908
Canberra,2010,6,1847,0,1847
Canberra,2010,7,1868,0,1868
Canberra,2010,8,1854,0,1854
Canberra,2010,9,1765,0,1765
Canberra,2010,10,1905,0,1905
Canberra,2010,11,1887,0,1887
Canberra,2010,12,1767,0,1767
Canberra,2011,1,1539,0,1539
Canberra,2011,2,1737,0,1737
Canberra,2011,3,1956,0,1956
Canberra,2011,4,1771,0,1771
Canberra,2011,5,1881,0,1881
Canberra,2011,6,1732,0,1732
Canberra,2011,7,1883,0,1883
Canberra,2011,8,1928,0,1928
Canberra,2011,9,1857,0,1857
Canberra,2011,10,1818,0,1818
Canberra,2011,11,1879,0,1879
Canberra,2011,12,1737,0,1737
Canberra,2012,1,1495,0,1495
Canberra,2012,2,1795,0,1795
Canberra,2012,3,1893,0,1893
Canberra,2012,4,1763,0,1763
Canberra,2012,5,1836,0,1836
Canberra,2012,6,1661,0,1661
Canberra,2012,7,1808,0,1808
Canberra,2012,8,1858,0,1858
Canberra,2012,9,1742,0,1742
Canberra,2012,10,1840,0,1840
Canberra,2012,11,1807,0,1807
Canberra,2012,12,1582,0,1582
Canberra,2013,1,1487,0,1487
Canberra,2013,2,1675,0,1675
Canberra,2013,3,1826,0,1826
Canberra,2013,4,1752,0,1752
Canberra,2013,5,1853,0,1853
Canberra,2013,6,1728,0,1728
Canberra,2013,7,1819,0,1819
Canberra,2013,8,1794,0,1794
Canberra,2013,9,1752,0,1752
Canberra,2013,10,1818,0,1818
Canberra,2013,11,1746,0,1746
Canberra,2013,12,1638,0,1638
Canberra,2014,1,1428,0,1428
Canberra,2014,2,1568,0,1568
Canberra,2014,3,1716,0,1716
Canberra,2014,4,1638,0,1638
Canberra,2014,5,1722,0,1722
Canberra,2014,6,1655,0,1655
Canberra,2014,7,1726,0,1726
Canberra,2014,8,1714,0,1714
Canberra,2014,9,1690,0,1690
Canberra,2014,10,1741,0,1741
Canberra,2014,11,1613,0,1613
Canberra,2014,12,1575,0,1575
Canberra,2015,1,1382,0,1382
Canberra,2015,2,1530,0,1530
Canberra,2015,3,1684,0,1684
Canberra,2015,4,1539,0,1539
Canberra,2015,5,1623,0,1623
Canberra,2015,6,1618,0,1618
Canberra,2015,7,1679,0,1679
Canberra,2015,8,1664,0,1664
Canberra,2015,9,1644,0,1644
Canberra,2015,10,1706,0,1706
Canberra,2015,11,1679,0,1679
Canberra,2015,12,1472,0,1472
Canberra,2016,1,1286,0,1286
Canberra,2016,2,1628,0,1628
Canberra,2016,3,1677,0,1677
Canberra,2016,4,1617,0,1617
Canberra,2016,5,1682,0,1682
Canberra,2016,6,1546,0,1546
Canberra,2016,7,1633,0,1633
Canberra,2016,8,1729,0,1729
Canberra,2016,9,1630,12,1642
Canberra,2016,10,1635,36,1671
Canberra,2016,11,1643,34,1677
Canberra,2016,12,1472,36,1508
Canberra,2017,1,1251,36,1287
Canberra,2017,2,1576,35,1611
Canberra,2017,3,1718,36,1754
Canberra,2017,4,1497,35,1532
Canberra,2017,5,1697,35,1732
Canberra,2017,6,1602,35,1637
Canberra,2017,7,1698,36,1734
Canberra,2017,8,1753,33,1786
Canberra,2017,9,1633,32,1665
Canberra,2017,10,1693,34,1727
Canberra,2017,11,1691,34,1725
Canberra,2017,12,1492,36,1528
Canberra,2018,1,1287,36,1323
Canberra,2018,2,1556,49,1605
Canberra,2018,3,1716,60,1776
Canberra,2018,4,1519,65,1584
Canberra,2018,5,1730,62,1792
Canberra,2018,6,1602,60,1662
Canberra,2018,7,1698,63,1761
Canberra,2018,8,1751,62,1813
Canberra,2018,9,1641,60,1701
Canberra,2018,10,1708,62,1770
Canberra,2018,11,1666,60,1726
Canberra,2018,12,1453,61,1514
Canberra,2019,1,1290,63,1353
Canberra,2019,2,1549,56,1605
Canberra,2019,3,1681,62,1743
Canberra,2019,4,1593,60,1653
Canberra,2019,5,1700,62,1762
Canberra,2019,6,1591,60,1651
Canberra,2019,7,1709,62,1771
Canberra,2019,8,1694,62,1756
Canberra,2019,9,1682,60,1742
Canberra,2019,10,1731,62,1793
Canberra,2019,11,1647,58,1705
Canberra,2019,12,1475,62,1537
Canberra,2020,1,1233,62,1295
Canberra,2020,2,1541,58,1599
Canberra,2020,3,1284,43,1327
Canberra,2020,4,125,0,125
Canberra,2020,5,91,0,91
Canberra,2020,6,155,0,155
Canberra,2020,7,229,0,229
Canberra,2020,8,200,0,200
Canberra,2020,9,171,0,171
Canberra,2020,10,320,0,320
Canberra,2020,11,492,1,493
Canberra,2020,12,706,0,706
Canberra,2021,1,707,0,707
Canberra,2021,2,858,0,858
Canberra,2021,3,952,1,953
Canberra,2021,4,1054,0,1054
Canberra,2021,5,1394,0,1394
Canberra,2021,6,1167,0,1167
Canberra,2021,7,714,0,714
Canberra,2021,8,268,0,268
Canberra,2021,9,155,0,155
Canberra,2021,10,167,0,167
Canberra,2021,11,536,0,536
Canberra,2021,12,1005,0,1005
Canberra,2022,1,867,0,867
Canberra,2022,2,909,0,909
Canberra,2022,3,1342,0,1342
Canberra,2022,4,1671,0,1671
Canberra,2022,5,1837,0,1837
Canberra,2022,6,1656,0,1656
Canberra,2022,7,1664,0,1664
Canberra,2022,8,1665,0,1665
Canberra,2022,9,1567,0,1567
Canberra,2022,10,1588,0,1588
Canberra,2022,11,1633,0,1633
Canberra,2022,12,1565,0,1565
Canberra,2023,1,1390,0,1390
Canberra,2023,2,1544,0,1544
Canberra,2023,3,1756,0,1756
Canberra,2023,4,1623,1,1624
Canberra,2023,5,1828,0,1828
Canberra,2023,6,1730,0,1730
Canberra,2023,7,1718,3,1721
Canberra,2023,8,1793,9,1802
Canberra,2023,9,1728,9,1737
Canberra,2023,10,1746,14,1760
Canberra,2023,11,1703,12,1715
Canberra,2023,12,1493,14,1507
Canberra,2024,1,1298,13,1311
Canberra,2024,2,1598,8,1606
Canberra,2024,3,1692,10,1702
Canberra,2024,4,1596,13,1609
Canberra,2024,5,1674,9,1683
Canberra,2024,6,1556,19,1575
Canberra,2024,7,1610,25,1635
Canberra,2024,8,1584,21,1605
Canberra,2024,9,1530,19,1549
Canberra,2024,10,1609,21,1630
Canberra,2024,11,1600,13,1613
Canberra,2024,12,1354,20,1374
Darwin,1985,1,474,30,504
Darwin,1985,2,403,24,427
Darwin,1985,3,423,28,451
Darwin,1985,4,391,28,419
Darwin,1985,5,415,27,442
Darwin,1985,6,356,28,384
Darwin,1985,7,440,33,473
Darwin,1985,8,458,27,485
Darwin,1985,9,437,27,464
Darwin,1985,10,469,28,497
Darwin,1985,11,437,27,464
Darwin,1985,12,411,31,442
Darwin,1986,1,424,32,456
Darwin,1986,2,330,24,354
Darwin,1986,3,387,29,416
Darwin,1986,4,350,47,397
Darwin,1986,5,379,46,425
Darwin,1986,6,455,38,493
Darwin,1986,7,515,49,564
Darwin,1986,8,485,47,532
Darwin,1986,9,460,37,497
Darwin,1986,10,504,43,547
Darwin,1986,11,436,39,475
Darwin,1986,12,484,51,535
Darwin,1987,1,495,54,549
Darwin,1987,2,375,40,415
Darwin,1987,3,476,44,520
Darwin,1987,4,410,51,461
Darwin,1987,5,449,50,499
Darwin,1987,6,496,48,544
Darwin,1987,7,479,54,533
Darwin,1987,8,454,49,503
Darwin,1987,9,475,51,526
Darwin,1987,10,501,56,557
Darwin,1987,11,430,54,484
Darwin,1987,12,446,60,506
Darwin,1988,1,434,62,496
Darwin,1988,2,395,56,451
Darwin,1988,3,460,56,516
Darwin,1988,4,404,63,467
Darwin,1988,5,409,64,473
Darwin,1988,6,468,59,527
Darwin,1988,7,581,67,648
Darwin,1988,8,530,62,592
Darwin,1988,9,468,60,528
Darwin,1988,10,443,65,508
Darwin,1988,11,390,51,441
Darwin,1988,12,406,55,461
Darwin,1989,1,409,54,463
Darwin,1989,2,381,51,432
Darwin,1989,3,208,54,262
Darwin,1989,4,439,51,490
Darwin,1989,5,217,53,270
Darwin,1989,6,228,55,283
Darwin,1989,7,270,57,327
Darwin,1989,8,183,57,240
Darwin,1989,9,17,65,82
Darwin,1989,10,45,66,111
Darwin,1989,11,104,58,162
Darwin,1989,12,149,57,206
Darwin,1990,1,182,62,244
Darwin,1990,2,181,48,229
Darwin,1990,3,198,54,252
Darwin,1990,4,199,55,254
Darwin,1990,5,214,58,272
Darwin,1990,6,222,56,278
Darwin,1990,7,252,61,313
Darwin,1990,8,246,59,305
Darwin,1990,9,233,53,286
Darwin,1990,10,242,52,294
Darwin,1990,11,234,62,296
Darwin,1990,12,243,65,308
Darwin,1991,1,250,65,315
Darwin,1991,2,207,56,263
Darwin,1991,3,228,64,292
Darwin,1991,4,216,67,283
Darwin,1991,5,234,76,310
Darwin,1991,6,288,70,358
Darwin,1991,7,325,68,393
Darwin,1991,8,323,74,397
Darwin,1991,9,311,70,381
Darwin,1991,10,373,70,443
Darwin,1991,11,508,72,580
Darwin,1991,12,550,78,628
Darwin,1992,1,580,80,660
Darwin,1992,2,508,74,582
Darwin,1992,3,572,79,651
Darwin,1992,4,526,80,606
Darwin,1992,5,560,81,641
Darwin,1992,6,558,74,632
Darwin,1992,7,583,80,663
Darwin,1992,8,498,81,579
Darwin,1992,9,579,78,657
Darwin,1992,10,545,82,627
Darwin,1992,11,528,82,610
Darwin,1992,12,597,83,680
Darwin,1993,1,560,77,637
Darwin,1993,2,494,68,562
Darwin,1993,3,549,75,624
Darwin,1993,4,576,88,664
Darwin,1993,5,589,90,679
Darwin,1993,6,584,84,668
Darwin,1993,7,647,104,751
Darwin,1993,8,618,98,716
Darwin,1993,9,635,101,736
Darwin,1993,10,648,115,763
Darwin,1993,11,629,108,737
Darwin,1993,12,646,121,767
Darwin,1994,1,622,120,742
Darwin,1994,2,556,105,661
Darwin,1994,3,649,118,767
Darwin,1994,4,616,123,739
Darwin,1994,5,661,125,786
Darwin,1994,6,685,127,812
Darwin,1994,7,721,142,863
Darwin,1994,8,715,132,847
Darwin,1994,9,703,133,836
Darwin,1994,10,722,139,861
Darwin,1994,11,707,126,833
Darwin,1994,12,737,141,878
Darwin,1995,1,726,139,865
Darwin,1995,2,661,121,782
Darwin,1995,3,737,131,868
Darwin,1995,4,763,129,892
Darwin,1995,5,787,137,924
Darwin,1995,6,759,135,894
Darwin,1995,7,832,150,982
Darwin,1995,8,841,141,982
Darwin,1995,9,834,135,969
Darwin,1995,10,880,138,1018
Darwin,1995,11,811,137,948
Darwin,1995,12,823,141,964
Darwin,1996,1,890,140,1030
Darwin,1996,2,809,129,938
Darwin,1996,3,864,138,1002
Darwin,1996,4,892,144,1036
Darwin,1996,5,905,144,1049
Darwin,1996,6,836,147,983
Darwin,1996,7,892,159,1051
Darwin,1996,8,880,148,1028
Darwin,1996,9,848,150,998
Darwin,1996,10,898,159,1057
Darwin,1996,11,861,155,1016
Darwin,1996,12,874,166,1040
Darwin,1997,1,864,161,1025
Darwin,1997,2,753,145,898
Darwin,1997,3,835,162,997
Darwin,1997,4,837,163,1000
Darwin,1997,5,864,169,1033
Darwin,1997,6,837,169,1006
Darwin,1997,7,846,169,1015
Darwin,1997,8,830,169,999
Darwin,1997,9,815,166,981
Darwin,1997,10,847,169,1016
Darwin,1997,11,792,178,970
Darwin,1997,12,832,183,1015
Darwin,1998,1,805,182,987
Darwin,1998,2,739,163,902
Darwin,1998,3,822,179,1001
Darwin,1998,4,817,168,985
Darwin,1998,5,834,170,1004
Darwin,1998,6,826,168,994
Darwin,1998,7,891,170,1061
Darwin,1998,8,868,169,1037
Darwin,1998,9,853,163,1016
Darwin,1998,10,885,172,1057
Darwin,1998,11,892,164,1056
Darwin,1998,12,913,170,1083
Darwin,1999,1,888,168,1056
Darwin,1999,2,832,153,985
Darwin,1999,3,930,166,1096
Darwin,1999,4,880,156,1036
Darwin,1999,5,890,163,1053
Darwin,1999,6,879,156,1035
Darwin,1999,7,819,164,983
Darwin,1999,8,846,157,1003
Darwin,1999,9,836,155,991
Darwin,1999,10,830,158,988
Darwin,1999,11,797,148,945
Darwin,1999,12,745,138,883
Darwin,2000,1,729,135,864
Darwin,2000,2,688,126,814
Darwin,2000,3,830,137,967
Darwin,2000,4,743,132,875
Darwin,2000,5,778,156,934
Darwin,2000,6,790,155,945
Darwin,2000,7,806,164,970
Darwin,2000,8,824,191,1015
Darwin,2000,9,802,190,992
Darwin,2000,10,798,193,991
Darwin,2000,11,774,181,955
Darwin,2000,12,729,185,914
Darwin,2001,1,708,186,894
Darwin,2001,2,672,112,784
Darwin,2001,3,767,123,890
Darwin,2001,4,749,120,869
Darwin,2001,5,785,125,910
Darwin,2001,6,751,116,867
Darwin,2001,7,815,123,938
Darwin,2001,8,790,121,911
Darwin,2001,9,618,114,732
Darwin,2001,10,493,113,606
Darwin,2001,11,512,108,620
Darwin,2001,12,512,73,585
Darwin,2002,1,610,73,683
Darwin,2002,2,597,49,646
Darwin,2002,3,663,54,717
Darwin,2002,4,658,49,707
Darwin,2002,5,681,58,739
Darwin,2002,6,679,58,737
Darwin,2002,7,726,56,782
Darwin,2002,8,726,61,787
Darwin,2002,9,706,58,764
Darwin,2002,10,723,60,783
Darwin,2002,11,644,52,696
Darwin,2002,12,638,61,699
Darwin,2003,1,635,60,695
Darwin,2003,2,568,43,611
Darwin,2003,3,630,51,681
Darwin,2003,4,640,48,688
Darwin,2003,5,668,54,722
Darwin,2003,6,668,52,720
Darwin,2003,7,754,53,807
Darwin,2003,8,729,55,784
Darwin,2003,9,702,52,754
Darwin,2003,10,722,54,776
Darwin,2003,11,631,56,687
Darwin,2003,12,524,59,583
Darwin,2004,1,524,59,583
Darwin,2004,2,492,53,545
Darwin,2004,3,547,57,604
Darwin,2004,4,589,57,646
Darwin,2004,5,655,72,727
Darwin,2004,6,629,78,707
Darwin,2004,7,642,85,727
Darwin,2004,8,638,83,721
Darwin,2004,9,608,82,690
Darwin,2004,10,611,84,695
Darwin,2004,11,530,76,606
Darwin,2004,12,545,91,636
Darwin,2005,1,545,82,627
Darwin,2005,2,517,68,585
Darwin,2005,3,580,73,653
Darwin,2005,4,622,84,706
Darwin,2005,5,646,86,732
Darwin,2005,6,670,100,770
Darwin,2005,7,633,110,743
Darwin,2005,8,648,93,741
Darwin,2005,9,450,82,532
Darwin,2005,10,599,83,682
Darwin,2005,11,560,74,634
Darwin,2005,12,555,83,638
Darwin,2006,1,546,104,650
Darwin,2006,2,502,96,598
Darwin,2006,3,561,107,668
Darwin,2006,4,572,108,680
Darwin,2006,5,669,108,777
Darwin,2006,6,659,107,766
Darwin,2006,7,675,128,803
Darwin,2006,8,685,122,807
Darwin,2006,9,645,108,753
Darwin,2006,10,645,114,759
Darwin,2006,11,628,122,750
Darwin,2006,12,583,131,714
Darwin,2007,1,590,129,719
Darwin,2007,2,548,113,661
Darwin,2007,3,621,126,747
Darwin,2007,4,608,125,733
Darwin,2007,5,657,125,782
Darwin,2007,6,664,132,796
Darwin,2007,7,676,140,816
Darwin,2007,8,676,139,815
Darwin,2007,9,623,138,761
Darwin,2007,10,663,143,806
Darwin,2007,11,638,132,770
Darwin,2007,12,664,142,806
Darwin,2008,1,671,144,815
Darwin,2008,2,620,112,732
Darwin,2008,3,651,123,774
Darwin,2008,4,674,149,823
Darwin,2008,5,699,176,875
Darwin,2008,6,683,173,856
Darwin,2008,7,708,180,888
Darwin,2008,8,691,176,867
Darwin,2008,9,663,208,871
Darwin,2008,10,672,217,889
Darwin,2008,11,681,189,870
Darwin,2008,12,749,256,1005
Darwin,2009,1,721,252,973
Darwin,2009,2,656,228,884
Darwin,2009,3,731,245,976
Darwin,2009,4,769,227,996
Darwin,2009,5,852,228,1080
Darwin,2009,6,882,216,1098
Darwin,2009,7,925,212,1137
Darwin,2009,8,919,212,1131
Darwin,2009,9,891,207,1098
Darwin,2009,10,884,211,1095
Darwin,2009,11,859,210,1069
Darwin,2009,12,866,229,1095
Darwin,2010,1,847,226,1073
Darwin,2010,2,811,194,1005
Darwin,2010,3,927,214,1141
Darwin,2010,4,898,193,1091
Darwin,2010,5,928,199,1127
Darwin,2010,6,905,203,1108
Darwin,2010,7,986,222,1208
Darwin,2010,8,998,220,1218
Darwin,2010,9,953,211,1164
Darwin,2010,10,970,218,1188
Darwin,2010,11,905,213,1118
Darwin,2010,12,929,210,1139
Darwin,2011,1,909,209,1118
Darwin,2011,2,763,184,947
Darwin,2011,3,935,224,1159
Darwin,2011,4,924,222,1146
Darwin,2011,5,933,227,1160
Darwin,2011,6,929,220,1149
Darwin,2011,7,1079,170,1249
Darwin,2011,8,1061,163,1224
Darwin,2011,9,1003,163,1166
Darwin,2011,10,1012,160,1172
Darwin,2011,11,973,141,1114
Darwin,2011,12,973,158,1131
Darwin,2012,1,956,157,1113
Darwin,2012,2,912,128,1040
Darwin,2012,3,1022,144,1166
Darwin,2012,4,978,188,1166
Darwin,2012,5,971,164,1135
Darwin,2012,6,952,166,1118
Darwin,2012,7,1035,181,1216
Darwin,2012,8,1029,168,1197
Darwin,2012,9,977,154,1131
Darwin,2012,10,1037,160,1197
Darwin,2012,11,994,135,1129
Darwin,2012,12,744,146,890
Darwin,2013,1,894,139,1033
Darwin,2013,2,851,117,968
Darwin,2013,3,966,134,1100
Darwin,2013,4,976,135,1111
Darwin,2013,5,1018,133,1151
Darwin,2013,6,950,191,1141
Darwin,2013,7,1046,224,1270
Darwin,2013,8,1029,213,1242
Darwin,2013,9,972,167,1139
Darwin,2013,10,1006,172,1178
Darwin,2013,11,934,171,1105
Darwin,2013,12,914,192,1106
Darwin,2014,1,936,194,1130
Darwin,2014,2,837,157,994
Darwin,2014,3,969,171,1140
Darwin,2014,4,1038,134,1172
Darwin,2014,5,1078,134,1212
Darwin,2014,6,1043,135,1178
Darwin,2014,7,1076,149,1225
Darwin,2014,8,1049,146,1195
Darwin,2014,9,1034,139,1173
Darwin,2014,10,1089,138,1227
Darwin,2014,11,995,110,1105
Darwin,2014,12,998,129,1127
Darwin,2015,1,954,130,1084
Darwin,2015,2,889,104,993
Darwin,2015,3,999,112,1111
Darwin,2015,4,1068,107,1175
Darwin,2015,5,1040,109,1149
Darwin,2015,6,1072,119,1191
Darwin,2015,7,1125,130,1255
Darwin,2015,8,1091,118,1209
Darwin,2015,9,1092,111,1203
Darwin,2015,10,1101,110,1211
Darwin,2015,11,1027,108,1135
Darwin,2015,12,1054,125,1179
Darwin,2016,1,996,131,1127
Darwin,2016,2,961,105,1066
Darwin,2016,3,1035,115,1150
Darwin,2016,4,1051,125,1176
Darwin,2016,5,1042,126,1168
Darwin,2016,6,1116,124,1240
Darwin,2016,7,1154,139,1293
Darwin,2016,8,1154,124,1278
Darwin,2016,9,1109,120,1229
Darwin,2016,10,1116,124,1240
Darwin,2016,11,1064,115,1179
Darwin,2016,12,1056,141,1197
Darwin,2017,1,997,144,1141
Darwin,2017,2,921,120,1041
Darwin,2017,3,1050,127,1177
Darwin,2017,4,997,124,1121
Darwin,2017,5,1062,116,1178
Darwin,2017,6,1093,130,1223
Darwin,2017,7,1126,123,1249
Darwin,2017,8,1176,111,1287
Darwin,2017,9,1050,103,1153
Darwin,2017,10,1079,104,1183
Darwin,2017,11,1036,106,1142
Darwin,2017,12,961,129,1090
Darwin,2018,1,952,131,1083
Darwin,2018,2,867,91,958
Darwin,2018,3,948,88,1036
Darwin,2018,4,1011,63,1074
Darwin,2018,5,1051,53,1104
Darwin,2018,6,1063,79,1142
Darwin,2018,7,1151,71,1222
Darwin,2018,8,1113,81,1194
Darwin,2018,9,1036,73,1109
Darwin,2018,10,1049,70,1119
Darwin,2018,11,964,70,1034
Darwin,2018,12,934,87,1021
Darwin,2019,1,912,90,1002
Darwin,2019,2,844,69,913
Darwin,2019,3,953,68,1021
Darwin,2019,4,969,87,1056
Darwin,2019,5,1025,94,1119
Darwin,2019,6,1008,94,1102
Darwin,2019,7,1060,103,1163
Darwin,2019,8,1038,95,1133
Darwin,2019,9,997,90,1087
Darwin,2019,10,1053,89,1142
Darwin,2019,11,929,82,1011
Darwin,2019,12,918,94,1012
Darwin,2020,1,904,103,1007
Darwin,2020,2,842,74,916
Darwin,2020,3,790,49,839
Darwin,2020,4,240,0,240
Darwin,2020,5,226,0,226
Darwin,2020,6,381,1,382
Darwin,2020,7,533,0,533
Darwin,2020,8,602,22,624
Darwin,2020,9,628,28,656
Darwin,2020,10,699,26,725
Darwin,2020,11,707,31,738
Darwin,2020,12,710,22,732
Darwin,2021,1,711,25,736
Darwin,2021,2,668,19,687
Darwin,2021,3,814,29,843
Darwin,2021,4,883,30,913
Darwin,2021,5,954,26,980
Darwin,2021,6,952,51,1003
Darwin,2021,7,921,21,942
Darwin,2021,8,888,70,958
Darwin,2021,9,949,69,1018
Darwin,2021,10,931,64,995
Darwin,2021,11,791,88,879
Darwin,2021,12,760,152,912
Darwin,2022,1,652,181,833
Darwin,2022,2,557,158,715
Darwin,2022,3,782,197,979
Darwin,2022,4,886,214,1100
Darwin,2022,5,941,225,1166
Darwin,2022,6,977,141,1118
Darwin,2022,7,1022,109,1131
Darwin,2022,8,986,100,1086
Darwin,2022,9,956,59,1015
Darwin,2022,10,939,48,987
Darwin,2022,11,921,75,996
Darwin,2022,12,875,69,944
Darwin,2023,1,858,82,940
Darwin,2023,2,799,63,862
Darwin,2023,3,934,69,1003
Darwin,2023,4,932,64,996
Darwin,2023,5,1039,66,1105
Darwin,2023,6,1040,65,1105
Darwin,2023,7,1116,75,1191
Darwin,2023,8,1121,76,1197
Darwin,2023,9,1109,73,1182
Darwin,2023,10,1079,59,1138
Darwin,2023,11,894,74,968
Darwin,2023,12,889,74,963
Darwin,2024,1,910,76,986
Darwin,2024,2,865,71,936
Darwin,2024,3,917,74,991
Darwin,2024,4,982,80,1062
Darwin,2024,5,1011,83,1094
Darwin,2024,6,1007,81,1088
Darwin,2024,7,1099,82,1181
Darwin,2024,8,1055,79,1134
Darwin,2024,9,1025,80,1105
Darwin,2024,10,1018,82,1100
Darwin,2024,11,919,72,991
Darwin,2024,12,929,82,1011
Gold Coast,1985,1,710,0,710
Gold Coast,1985,2,547,0,547
Gold Coast,1985,3,613,0,613
Gold Coast,1985,4,607,0,607
Gold Coast,1985,5,665,0,665
Gold Coast,1985,6,455,0,455
Gold Coast,1985,7,446,0,446
Gold Coast,1985,8,581,0,581
Gold Coast,1985,9,575,0,575
Gold Coast,1985,10,546,0,546
Gold Coast,1985,11,509,0,509
Gold Coast,1985,12,564,0,564
Gold Coast,1986,1,605,0,605
Gold Coast,1986,2,466,0,466
Gold Coast,1986,3,538,0,538
Gold Coast,1986,4,519,0,519
Gold Coast,1986,5,585,0,585
Gold Coast,1986,6,523,0,523
Gold Coast,1986,7,532,0,532
Gold Coast,1986,8,656,0,656
Gold Coast,1986,9,639,0,639
Gold Coast,1986,10,750,0,750
Gold Coast,1986,11,705,0,705
Gold Coast,1986,12,771,0,771
Gold Coast,1987,1,835,0,835
Gold Coast,1987,2,627,0,627
Gold Coast,1987,3,694,0,694
Gold Coast,1987,4,747,0,747
Gold Coast,1987,5,656,0,656
Gold Coast,1987,6,743,0,743
Gold Coast,1987,7,849,0,849
Gold Coast,1987,8,813,0,813
Gold Coast,1987,9,849,0,849
Gold Coast,1987,10,883,0,883
Gold Coast,1987,11,751,0,751
Gold Coast,1987,12,886,0,886
Gold Coast,1988,1,889,0,889
Gold Coast,1988,2,713,0,713
Gold Coast,1988,3,761,0,761
Gold Coast,1988,4,819,0,819
Gold Coast,1988,5,791,0,791
Gold Coast,1988,6,821,0,821
Gold Coast,1988,7,959,0,959
Gold Coast,1988,8,927,0,927
Gold Coast,1988,9,978,0,978
Gold Coast,1988,10,1026,0,1026
Gold Coast,1988,11,879,0,879
Gold Coast,1988,12,972,0,972
Gold Coast,1989,1,1000,0,1000
Gold Coast,1989,2,784,0,784
Gold Coast,1989,3,951,0,951
Gold Coast,1989,4,875,0,875
Gold Coast,1989,5,839,0,839
Gold Coast,1989,6,920,0,920
Gold Coast,1989,7,956,0,956
Gold Coast,1989,8,606,0,606
Gold Coast,1989,9,377,0,377
Gold Coast,1989,10,466,0,466
Gold Coast,1989,11,471,0,471
Gold Coast,1989,12,630,0,630
Gold Coast,1990,1,777,0,777
Gold Coast,1990,2,656,0,656
Gold Coast,1990,3,770,0,770
Gold Coast,1990,4,892,0,892
Gold Coast,1990,5,821,0,821
Gold Coast,1990,6,842,0,842
Gold Coast,1990,7,785,0,785
Gold Coast,1990,8,717,0,717
Gold Coast,1990,9,886,0,886
Gold Coast,1990,10,898,0,898
Gold Coast,1990,11,800,0,800
Gold Coast,1990,12,902,0,902
Gold Coast,1991,1,1141,0,1141
Gold Coast,1991,2,908,0,908
Gold Coast,1991,3,1093,0,1093
Gold Coast,1991,4,1073,0,1073
Gold Coast,1991,5,1035,0,1035
Gold Coast,1991,6,1061,0,1061
Gold Coast,1991,7,1155,0,1155
Gold Coast,1991,8,1148,0,1148
Gold Coast,1991,9,1208,0,1208
Gold Coast,1991,10,1190,0,1190
Gold Coast,1991,11,1159,0,1159
Gold Coast,1991,12,1139,0,1139
Gold Coast,1992,1,1183,0,1183
Gold Coast,1992,2,888,0,888
Gold Coast,1992,3,947,0,947
Gold Coast,1992,4,985,0,985
Gold Coast,1992,5,1068,0,1068
Gold Coast,1992,6,1060,0,1060
Gold Coast,1992,7,1119,0,1119
Gold Coast,1992,8,1081,0,1081
Gold Coast,1992,9,1054,0,1054
Gold Coast,1992,10,1106,0,1106
Gold Coast,1992,11,1064,0,1064
Gold Coast,1992,12,1190,0,1190
Gold Coast,1993,1,1296,0,1296
Gold Coast,1993,2,984,0,984
Gold Coast,1993,3,1064,0,1064
Gold Coast,1993,4,1099,0,1099
Gold Coast,1993,5,1082,0,1082
Gold Coast,1993,6,1034,0,1034
Gold Coast,1993,7,1073,0,1073
Gold Coast,1993,8,1090,0,1090
Gold Coast,1993,9,1115,0,1115
Gold Coast,1993,10,1214,0,1214
Gold Coast,1993,11,1202,0,1202
Gold Coast,1993,12,1364,0,1364
Gold Coast,1994,1,1234,0,1234
Gold Coast,1994,2,991,0,991
Gold Coast,1994,3,1096,0,1096
Gold Coast,1994,4,1080,0,1080
Gold Coast,1994,5,1066,0,1066
Gold Coast,1994,6,1083,0,1083
Gold Coast,1994,7,1178,0,1178
Gold Coast,1994,8,1110,0,1110
Gold Coast,1994,9,1107,0,1107
Gold Coast,1994,10,1136,0,1136
Gold Coast,1994,11,1084,0,1084
Gold Coast,1994,12,1223,0,1223
Gold Coast,1995,1,1265,0,1265
Gold Coast,1995,2,1001,0,1001
Gold Coast,1995,3,1111,0,1111
Gold Coast,1995,4,1094,0,1094
Gold Coast,1995,5,1041,0,1041
Gold Coast,1995,6,1061,0,1061
Gold Coast,1995,7,1148,0,1148
Gold Coast,1995,8,1071,0,1071
Gold Coast,1995,9,1103,0,1103
Gold Coast,1995,10,1112,0,1112
Gold Coast,1995,11,1041,0,1041
Gold Coast,1995,12,1150,0,1150
Gold Coast,1996,1,1230,0,1230
Gold Coast,1996,2,1003,0,1003
Gold Coast,1996,3,1098,0,1098
Gold Coast,1996,4,1120,0,1120
Gold Coast,1996,5,1036,0,1036
Gold Coast,1996,6,1109,0,1109
Gold Coast,1996,7,1163,0,1163
Gold Coast,1996,8,1084,0,1084
Gold Coast,1996,9,1091,0,1091
Gold Coast,1996,10,1125,0,1125
Gold Coast,1996,11,1011,0,1011
Gold Coast,1996,12,1106,3,1109
Gold Coast,1997,1,1091,4,1095
Gold Coast,1997,2,866,0,866
Gold Coast,1997,3,933,2,935
Gold Coast,1997,4,898,4,902
Gold Coast,1997,5,851,5,856
Gold Coast,1997,6,862,5,867
Gold Coast,1997,7,949,8,957
Gold Coast,1997,8,926,9,935
Gold Coast,1997,9,956,9,965
Gold Coast,1997,10,976,8,984
Gold Coast,1997,11,894,9,903
Gold Coast,1997,12,995,9,1004
Gold Coast,1998,1,1056,9,1065
Gold Coast,1998,2,843,6,849
Gold Coast,1998,3,926,8,934
Gold Coast,1998,4,906,8,914
Gold Coast,1998,5,890,5,895
Gold Coast,1998,6,888,4,892
Gold Coast,1998,7,925,6,931
Gold Coast,1998,8,901,10,911
Gold Coast,1998,9,883,9,892
Gold Coast,1998,10,956,8,964
Gold Coast,1998,11,911,4,915
Gold Coast,1998,12,989,4,993
Gold Coast,1999,1,1093,5,1098
Gold Coast,1999,2,839,4,843
Gold Coast,1999,3,936,5,941
Gold Coast,1999,4,912,8,920
Gold Coast,1999,5,862,5,867
Gold Coast,1999,6,849,6,855
Gold Coast,1999,7,914,9,923
Gold Coast,1999,8,879,8,887
Gold Coast,1999,9,895,9,904
Gold Coast,1999,10,952,9,961
Gold Coast,1999,11,833,4,837
Gold Coast,1999,12,907,6,913
Gold Coast,2000,1,962,8,970
Gold Coast,2000,2,795,9,804
Gold Coast,2000,3,851,9,860
Gold Coast,2000,4,877,13,890
Gold Coast,2000,5,827,12,839
Gold Coast,2000,6,861,14,875
Gold Coast,2000,7,857,13,870
Gold Coast,2000,8,846,14,860
Gold Coast,2000,9,844,18,862
Gold Coast,2000,10,876,16,892
Gold Coast,2000,11,811,8,819
Gold Coast,2000,12,890,13,903
Gold Coast,2001,1,924,16,940
Gold Coast,2001,2,727,12,739
Gold Coast,2001,3,826,16,842
Gold Coast,2001,4,794,17,811
Gold Coast,2001,5,773,18,791
Gold Coast,2001,6,860,17,877
Gold Coast,2001,7,881,17,898
Gold Coast,2001,8,827,18,845
Gold Coast,2001,9,692,18,710
Gold Coast,2001,10,629,17,646
Gold Coast,2001,11,482,24,506
Gold Coast,2001,12,531,34,565
Gold Coast,2002,1,578,36,614
Gold Coast,2002,2,515,28,543
Gold Coast,2002,3,591,36,627
Gold Coast,2002,4,605,35,640
Gold Coast,2002,5,622,39,661
Gold Coast,2002,6,790,37,827
Gold Coast,2002,7,928,40,968
Gold Coast,2002,8,910,39,949
Gold Coast,2002,9,906,44,950
Gold Coast,2002,10,914,56,970
Gold Coast,2002,11,786,98,884
Gold Coast,2002,12,891,87,978
Gold Coast,2003,1,834,83,917
Gold Coast,2003,2,690,70,760
Gold Coast,2003,3,741,75,816
Gold Coast,2003,4,760,86,846
Gold Coast,2003,5,724,88,812
Gold Coast,2003,6,673,90,763
Gold Coast,2003,7,683,92,775
Gold Coast,2003,8,628,91,719
Gold Coast,2003,9,669,88,757
Gold Coast,2003,10,759,88,847
Gold Coast,2003,11,764,73,837
Gold Coast,2003,12,817,73,890
Gold Coast,2004,1,847,72,919
Gold Coast,2004,2,729,74,803
Gold Coast,2004,3,790,83,873
Gold Coast,2004,4,845,78,923
Gold Coast,2004,5,914,83,997
Gold Coast,2004,6,1012,81,1093
Gold Coast,2004,7,1079,82,1161
Gold Coast,2004,8,1055,86,1141
Gold Coast,2004,9,1029,79,1108
Gold Coast,2004,10,1061,83,1144
Gold Coast,2004,11,1007,76,1083
Gold Coast,2004,12,1126,85,1211
Gold Coast,2005,1,1177,93,1270
Gold Coast,2005,2,989,98,1087
Gold Coast,2005,3,1086,110,1196
Gold Coast,2005,4,1077,105,1182
Gold Coast,2005,5,1070,117,1187
Gold Coast,2005,6,987,112,1099
Gold Coast,2005,7,1059,120,1179
Gold Coast,2005,8,1038,119,1157
Gold Coast,2005,9,1044,117,1161
Gold Coast,2005,10,1066,119,1185
Gold Coast,2005,11,999,84,1083
Gold Coast,2005,12,1110,111,1221
Gold Coast,2006,1,1108,115,1223
Gold Coast,2006,2,929,99,1028
Gold Coast,2006,3,1033,106,1139
Gold Coast,2006,4,1037,91,1128
Gold Coast,2006,5,1040,83,1123
Gold Coast,2006,6,1034,81,1115
Gold Coast,2006,7,1060,91,1151
Gold Coast,2006,8,1033,86,1119
Gold Coast,2006,9,1044,85,1129
Gold Coast,2006,10,1095,67,1162
Gold Coast,2006,11,1044,71,1115
Gold Coast,2006,12,1105,77,1182
Gold Coast,2007,1,1116,76,1192
Gold Coast,2007,2,982,56,1038
Gold Coast,2007,3,1091,66,1157
Gold Coast,2007,4,1065,65,1130
Gold Coast,2007,5,1097,67,1164
Gold Coast,2007,6,1056,67,1123
Gold Coast,2007,7,1076,72,1148
Gold Coast,2007,8,1107,72,1179
Gold Coast,2007,9,1147,75,1222
Gold Coast,2007,10,1188,64,1252
Gold Coast,2007,11,1166,74,1240
Gold Coast,2007,12,1278,91,1369
Gold Coast,2008,1,1345,93,1438
Gold Coast,2008,2,1274,77,1351
Gold Coast,2008,3,1385,83,1468
Gold Coast,2008,4,1278,86,1364
Gold Coast,2008,5,1379,85,1464
Gold Coast,2008,6,1326,88,1414
Gold Coast,2008,7,1379,107,1486
Gold Coast,2008,8,1240,101,1341
Gold Coast,2008,9,1151,101,1252
Gold Coast,2008,10,1155,151,1306
Gold Coast,2008,11,1155,149,1304
Gold Coast,2008,12,1188,169,1357
Gold Coast,2009,1,1261,185,1446
Gold Coast,2009,2,1016,138,1154
Gold Coast,2009,3,1170,158,1328
Gold Coast,2009,4,1232,159,1391
Gold Coast,2009,5,1198,187,1385
Gold Coast,2009,6,1161,142,1303
Gold Coast,2009,7,1280,150,1430
Gold Coast,2009,8,1225,181,1406
Gold Coast,2009,9,1229,188,1417
Gold Coast,2009,10,1270,195,1465
Gold Coast,2009,11,1206,192,1398
Gold Coast,2009,12,1239,200,1439
Gold Coast,2010,1,1361,208,1569
Gold Coast,2010,2,1230,189,1419
Gold Coast,2010,3,1393,213,1606
Gold Coast,2010,4,1374,176,1550
Gold Coast,2010,5,1325,166,1491
Gold Coast,2010,6,1318,158,1476
Gold Coast,2010,7,1490,191,1681
Gold Coast,2010,8,1339,197,1536
Gold Coast,2010,9,1396,184,1580
Gold Coast,2010,10,1420,186,1606
Gold Coast,2010,11,1404,178,1582
Gold Coast,2010,12,1563,197,1760
Gold Coast,2011,1,1718,204,1922
Gold Coast,2011,2,1192,174,1366
Gold Coast,2011,3,1364,178,1542
Gold Coast,2011,4,1331,161,1492
Gold Coast,2011,5,1323,161,1484
Gold Coast,2011,6,1213,125,1338
Gold Coast,2011,7,1320,158,1478
Gold Coast,2011,8,1244,177,1421
Gold Coast,2011,9,1268,157,1425
Gold Coast,2011,10,1331,172,1503
Gold Coast,2011,11,1292,167,1459
Gold Coast,2011,12,1416,184,1600
Gold Coast,2012,1,1480,197,1677
Gold Coast,2012,2,1265,167,1432
Gold Coast,2012,3,1369,179,1548
Gold Coast,2012,4,1375,170,1545
Gold Coast,2012,5,1239,142,1381
Gold Coast,2012,6,1229,171,1400
Gold Coast,2012,7,1464,208,1672
Gold Coast,2012,8,1402,202,1604
Gold Coast,2012,9,1503,192,1695
Gold Coast,2012,10,1555,201,1756
Gold Coast,2012,11,1461,185,1646
Gold Coast,2012,12,1585,216,1801
Gold Coast,2013,1,1590,213,1803
Gold Coast,2013,2,1251,184,1435
Gold Coast,2013,3,1412,202,1614
Gold Coast,2013,4,1511,179,1690
Gold Coast,2013,5,1207,163,1370
Gold Coast,2013,6,1286,159,1445
Gold Coast,2013,7,1473,190,1663
Gold Coast,2013,8,1389,187,1576
Gold Coast,2013,9,1511,191,1702
Gold Coast,2013,10,1551,200,1751
Gold Coast,2013,11,1348,192,1540
Gold Coast,2013,12,1540,227,1767
Gold Coast,2014,1,1602,230,1832
Gold Coast,2014,2,1213,188,1401
Gold Coast,2014,3,1427,202,1629
Gold Coast,2014,4,1462,188,1650
Gold Coast,2014,5,1276,177,1453
Gold Coast,2014,6,1275,179,1454
Gold Coast,2014,7,1498,201,1699
Gold Coast,2014,8,1399,187,1586
Gold Coast,2014,9,1465,183,1648
Gold Coast,2014,10,1538,191,1729
Gold Coast,2014,11,1357,178,1535
Gold Coast,2014,12,1562,218,1780
Gold Coast,2015,1,1582,230,1812
Gold Coast,2015,2,1180,176,1356
Gold Coast,2015,3,1383,193,1576
Gold Coast,2015,4,1450,212,1662
Gold Coast,2015,5,1294,202,1496
Gold Coast,2015,6,1337,199,1536
Gold Coast,2015,7,1513,249,1762
Gold Coast,2015,8,1433,213,1646
Gold Coast,2015,9,1544,217,1761
Gold Coast,2015,10,1563,231,1794
Gold Coast,2015,11,1442,203,1645
Gold Coast,2015,12,1638,248,1886
Gold Coast,2016,1,1711,258,1969
Gold Coast,2016,2,1333,214,1547
Gold Coast,2016,3,1481,239,1720
Gold Coast,2016,4,1514,266,1780
Gold Coast,2016,5,1338,260,1598
Gold Coast,2016,6,1331,258,1589
Gold Coast,2016,7,1580,315,1895
Gold Coast,2016,8,1450,297,1747
Gold Coast,2016,9,1560,289,1849
Gold Coast,2016,10,1598,290,1888
Gold Coast,2016,11,1444,265,1709
Gold Coast,2016,12,1656,299,1955
Gold Coast,2017,1,1691,304,1995
Gold Coast,2017,2,1297,254,1551
Gold Coast,2017,3,1422,279,1701
Gold Coast,2017,4,1563,272,1835
Gold Coast,2017,5,1308,259,1567
Gold Coast,2017,6,1346,258,1604
Gold Coast,2017,7,1574,300,1874
Gold Coast,2017,8,1421,284,1705
Gold Coast,2017,9,1509,274,1783
Gold Coast,2017,10,1581,289,1870
Gold Coast,2017,11,1456,261,1717
Gold Coast,2017,12,1655,298,1953
Gold Coast,2018,1,1740,297,2037
Gold Coast,2018,2,1291,239,1530
Gold Coast,2018,3,1505,259,1764
Gold Coast,2018,4,1637,274,1911
Gold Coast,2018,5,1306,236,1542
Gold Coast,2018,6,1302,245,1547
Gold Coast,2018,7,1494,276,1770
Gold Coast,2018,8,1414,261,1675
Gold Coast,2018,9,1463,248,1711
Gold Coast,2018,10,1542,261,1803
Gold Coast,2018,11,1382,229,1611
Gold Coast,2018,12,1570,264,1834
Gold Coast,2019,1,1681,264,1945
Gold Coast,2019,2,1223,199,1422
Gold Coast,2019,3,1367,208,1575
Gold Coast,2019,4,1592,209,1801
Gold Coast,2019,5,1416,178,1594
Gold Coast,2019,6,1381,193,1574
Gold Coast,2019,7,1596,232,1828
Gold Coast,2019,8,1427,201,1628
Gold Coast,2019,9,1495,191,1686
Gold Coast,2019,10,1580,203,1783
Gold Coast,2019,11,1397,189,1586
Gold Coast,2019,12,1590,256,1846
Gold Coast,2020,1,1634,260,1894
Gold Coast,2020,2,1248,205,1453
Gold Coast,2020,3,1041,140,1181
Gold Coast,2020,4,22,0,22
Gold Coast,2020,5,13,0,13
Gold Coast,2020,6,22,0,22
Gold Coast,2020,7,157,0,157
Gold Coast,2020,8,65,0,65
Gold Coast,2020,9,100,1,101
Gold Coast,2020,10,156,0,156
Gold Coast,2020,11,169,0,169
Gold Coast,2020,12,728,0,728
Gold Coast,2021,1,748,0,748
Gold Coast,2021,2,638,0,638
Gold Coast,2021,3,988,0,988
Gold Coast,2021,4,1520,27,1547
Gold Coast,2021,5,1398,79,1477
Gold Coast,2021,6,1053,65,1118
Gold Coast,2021,7,571,55,626
Gold Coast,2021,8,169,0,169
Gold Coast,2021,9,186,0,186
Gold Coast,2021,10,193,0,193
Gold Coast,2021,11,200,0,200
Gold Coast,2021,12,1040,0,1040
Gold Coast,2022,1,1535,0,1535
Gold Coast,2022,2,1039,6,1045
Gold Coast,2022,3,1421,27,1448
Gold Coast,2022,4,1868,46,1914
Gold Coast,2022,5,1675,51,1726
Gold Coast,2022,6,1571,85,1656
Gold Coast,2022,7,1559,137,1696
Gold Coast,2022,8,1428,147,1575
Gold Coast,2022,9,1432,145,1577
Gold Coast,2022,10,1499,147,1646
Gold Coast,2022,11,1472,156,1628
Gold Coast,2022,12,1577,147,1724
Gold Coast,2023,1,1672,162,1834
Gold Coast,2023,2,1270,142,1412
Gold Coast,2023,3,1386,164,1550
Gold Coast,2023,4,1467,210,1677
Gold Coast,2023,5,1355,198,1553
Gold Coast,2023,6,1351,205,1556
Gold Coast,2023,7,1517,220,1737
Gold Coast,2023,8,1430,194,1624
Gold Coast,2023,9,1493,209,1702
Gold Coast,2023,10,1504,189,1693
Gold Coast,2023,11,1424,149,1573
Gold Coast,2023,12,1635,171,1806
Gold Coast,2024,1,1793,184,1977
Gold Coast,2024,2,1346,139,1485
Gold Coast,2024,3,1560,148,1708
Gold Coast,2024,4,1629,185,1814
Gold Coast,2024,5,1336,146,1482
Gold Coast,2024,6,1337,157,1494
Gold Coast,2024,7,1534,180,1714
Gold Coast,2024,8,1275,153,1428
Gold Coast,2024,9,1377,170,1547
Gold Coast,2024,10,1460,162,1622
Gold Coast,2024,11,1305,124,1429
Gold Coast,2024,12,1614,183,1797
Hamilton Island,1985,1,53,0,53
Hamilton Island,1985,2,49,0,49
Hamilton Island,1985,3,58,0,58
Hamilton Island,1985,4,61,0,61
Hamilton Island,1985,5,68,0,68
Hamilton Island,1985,6,54,0,54
Hamilton Island,1985,7,61,0,61
Hamilton Island,1985,8,68,0,68
Hamilton Island,1985,9,66,0,66
Hamilton Island,1985,10,62,0,62
Hamilton Island,1985,11,63,0,63
Hamilton Island,1985,12,55,0,55
Hamilton Island,1986,1,63,0,63
Hamilton Island,1986,2,58,0,58
Hamilton Island,1986,3,72,0,72
Hamilton Island,1986,4,69,0,69
Hamilton Island,1986,5,64,0,64
Hamilton Island,1986,6,55,0,55
Hamilton Island,1986,7,74,0,74
Hamilton Island,1986,8,112,0,112
Hamilton Island,1986,9,103,0,103
Hamilton Island,1986,10,114,0,114
Hamilton Island,1986,11,115,0,115
Hamilton Island,1986,12,122,0,122
Hamilton Island,1987,1,129,0,129
Hamilton Island,1987,2,104,0,104
Hamilton Island,1987,3,102,0,102
Hamilton Island,1987,4,113,0,113
Hamilton Island,1987,5,109,0,109
Hamilton Island,1987,6,106,0,106
Hamilton Island,1987,7,120,0,120
Hamilton Island,1987,8,120,0,120
Hamilton Island,1987,9,125,0,125
Hamilton Island,1987,10,143,0,143
Hamilton Island,1987,11,151,0,151
Hamilton Island,1987,12,128,0,128
Hamilton Island,1988,1,133,0,133
Hamilton Island,1988,2,115,0,115
Hamilton Island,1988,3,134,0,134
Hamilton Island,1988,4,131,0,131
Hamilton Island,1988,5,121,0,121
Hamilton Island,1988,6,126,0,126
Hamilton Island,1988,7,142,0,142
Hamilton Island,1988,8,133,0,133
Hamilton Island,1988,9,142,0,142
Hamilton Island,1988,10,161,0,161
Hamilton Island,1988,11,152,0,152
Hamilton Island,1988,12,147,0,147
Hamilton Island,1989,1,145,0,145
Hamilton Island,1989,2,123,0,123
Hamilton Island,1989,3,140,0,140
Hamilton Island,1989,4,140,0,140
Hamilton Island,1989,5,124,0,124
Hamilton Island,1989,6,119,0,119
Hamilton Island,1989,7,128,0,128
Hamilton Island,1989,8,70,0,70
Hamilton Island,1989,9,37,0,37
Hamilton Island,1989,10,51,0,51
Hamilton Island,1989,11,43,0,43
Hamilton Island,1989,12,49,0,49
Hamilton Island,1990,1,96,0,96
Hamilton Island,1990,2,71,0,71
Hamilton Island,1990,3,89,0,89
Hamilton Island,1990,4,100,0,100
Hamilton Island,1990,5,116,0,116
Hamilton Island,1990,6,111,0,111
Hamilton Island,1990,7,125,0,125
Hamilton Island,1990,8,118,0,118
Hamilton Island,1990,9,126,0,126
Hamilton Island,1990,10,117,0,117
Hamilton Island,1990,11,154,0,154
Hamilton Island,1990,12,141,0,141
Hamilton Island,1991,1,136,0,136
Hamilton Island,1991,2,109,0,109
Hamilton Island,1991,3,119,0,119
Hamilton Island,1991,4,119,0,119
Hamilton Island,1991,5,116,0,116
Hamilton Island,1991,6,129,0,129
Hamilton Island,1991,7,154,0,154
Hamilton Island,1991,8,125,0,125
Hamilton Island,1991,9,147,0,147
Hamilton Island,1991,10,161,0,161
Hamilton Island,1991,11,148,0,148
Hamilton Island,1991,12,155,0,155
Hamilton Island,1992,1,148,0,148
Hamilton Island,1992,2,108,0,108
Hamilton Island,1992,3,125,0,125
Hamilton Island,1992,4,115,0,115
Hamilton Island,1992,5,106,0,106
Hamilton Island,1992,6,104,0,104
Hamilton Island,1992,7,101,0,101
Hamilton Island,1992,8,107,0,107
Hamilton Island,1992,9,110,0,110
Hamilton Island,1992,10,130,0,130
Hamilton Island,1992,11,160,0,160
Hamilton Island,1992,12,161,0,161
Hamilton Island,1993,1,149,0,149
Hamilton Island,1993,2,124,0,124
Hamilton Island,1993,3,143,0,143
Hamilton Island,1993,4,150,0,150
Hamilton Island,1993,5,125,0,125
Hamilton Island,1993,6,118,0,118
Hamilton Island,1993,7,143,0,143
Hamilton Island,1993,8,155,0,155
Hamilton Island,1993,9,145,0,145
Hamilton Island,1993,10,184,0,184
Hamilton Island,1993,11,168,0,168
Hamilton Island,1993,12,178,0,178
Hamilton Island,1994,1,176,0,176
Hamilton Island,1994,2,152,0,152
Hamilton Island,1994,3,176,0,176
Hamilton Island,1994,4,171,0,171
Hamilton Island,1994,5,166,0,166
Hamilton Island,1994,6,157,0,157
Hamilton Island,1994,7,172,0,172
Hamilton Island,1994,8,172,0,172
Hamilton Island,1994,9,179,0,179
Hamilton Island,1994,10,211,0,211
Hamilton Island,1994,11,203,0,203
Hamilton Island,1994,12,213,0,213
Hamilton Island,1995,1,195,0,195
Hamilton Island,1995,2,154,0,154
Hamilton Island,1995,3,173,0,173
Hamilton Island,1995,4,185,0,185
Hamilton Island,1995,5,168,0,168
Hamilton Island,1995,6,152,0,152
Hamilton Island,1995,7,174,0,174
Hamilton Island,1995,8,180,0,180
Hamilton Island,1995,9,178,0,178
Hamilton Island,1995,10,212,0,212
Hamilton Island,1995,11,206,0,206
Hamilton Island,1995,12,207,0,207
Hamilton Island,1996,1,195,0,195
Hamilton Island,1996,2,159,0,159
Hamilton Island,1996,3,162,0,162
Hamilton Island,1996,4,173,0,173
Hamilton Island,1996,5,152,0,152
Hamilton Island,1996,6,150,0,150
Hamilton Island,1996,7,163,0,163
Hamilton Island,1996,8,150,0,150
Hamilton Island,1996,9,163,0,163
Hamilton Island,1996,10,187,0,187
Hamilton Island,1996,11,172,0,172
Hamilton Island,1996,12,183,0,183
Hamilton Island,1997,1,179,0,179
Hamilton Island,1997,2,144,0,144
Hamilton Island,1997,3,161,0,161
Hamilton Island,1997,4,154,0,154
Hamilton Island,1997,5,139,0,139
Hamilton Island,1997,6,145,0,145
Hamilton Island,1997,7,149,0,149
Hamilton Island,1997,8,150,0,150
Hamilton Island,1997,9,160,0,160
Hamilton Island,1997,10,174,0,174
Hamilton Island,1997,11,165,0,165
Hamilton Island,1997,12,173,0,173
Hamilton Island,1998,1,188,0,188
Hamilton Island,1998,2,128,0,128
Hamilton Island,1998,3,158,0,158
Hamilton Island,1998,4,167,0,167
Hamilton Island,1998,5,166,0,166
Hamilton Island,1998,6,138,0,138
Hamilton Island,1998,7,145,0,145
Hamilton Island,1998,8,144,0,144
Hamilton Island,1998,9,149,0,149
Hamilton Island,1998,10,161,0,161
Hamilton Island,1998,11,167,0,167
Hamilton Island,1998,12,174,0,174
Hamilton Island,1999,1,182,0,182
Hamilton Island,1999,2,143,0,143
Hamilton Island,1999,3,152,0,152
Hamilton Island,1999,4,147,0,147
Hamilton Island,1999,5,141,0,141
Hamilton Island,1999,6,136,0,136
Hamilton Island,1999,7,156,0,156
Hamilton Island,1999,8,159,0,159
Hamilton Island,1999,9,153,0,153
Hamilton Island,1999,10,167,0,167
Hamilton Island,1999,11,170,0,170
Hamilton Island,1999,12,178,0,178
Hamilton Island,2000,1,194,0,194
Hamilton Island,2000,2,177,0,177
Hamilton Island,2000,3,192,0,192
Hamilton Island,2000,4,207,0,207
Hamilton Island,2000,5,191,0,191
Hamilton Island,2000,6,197,0,197
Hamilton Island,2000,7,187,0,187
Hamilton Island,2000,8,197,0,197
Hamilton Island,2000,9,200,0,200
Hamilton Island,2000,10,210,0,210
Hamilton Island,2000,11,214,0,214
Hamilton Island,2000,12,228,0,228
Hamilton Island,2001,1,229,0,229
Hamilton Island,2001,2,191,0,191
Hamilton Island,2001,3,215,0,215
Hamilton Island,2001,4,205,0,205
Hamilton Island,2001,5,205,0,205
Hamilton Island,2001,6,203,0,203
Hamilton Island,2001,7,213,0,213
Hamilton Island,2001,8,211,0,211
Hamilton Island,2001,9,182,0,182
Hamilton Island,2001,10,157,0,157
Hamilton Island,2001,11,150,0,150
Hamilton Island,2001,12,164,0,164
Hamilton Island,2002,1,158,0,158
Hamilton Island,2002,2,133,0,133
Hamilton Island,2002,3,156,0,156
Hamilton Island,2002,4,150,0,150
Hamilton Island,2002,5,149,0,149
Hamilton Island,2002,6,129,0,129
Hamilton Island,2002,7,176,0,176
Hamilton Island,2002,8,181,0,181
Hamilton Island,2002,9,176,0,176
Hamilton Island,2002,10,180,0,180
Hamilton Island,2002,11,173,0,173
Hamilton Island,2002,12,188,0,188
Hamilton Island,2003,1,190,0,190
Hamilton Island,2003,2,167,0,167
Hamilton Island,2003,3,188,0,188
Hamilton Island,2003,4,166,0,166
Hamilton Island,2003,5,154,0,154
Hamilton Island,2003,6,148,0,148
Hamilton Island,2003,7,160,0,160
Hamilton Island,2003,8,203,0,203
Hamilton Island,2003,9,203,0,203
Hamilton Island,2003,10,228,0,228
Hamilton Island,2003,11,209,0,209
Hamilton Island,2003,12,227,0,227
Hamilton Island,2004,1,234,0,234
Hamilton Island,2004,2,194,0,194
Hamilton Island,2004,3,193,0,193
Hamilton Island,2004,4,196,0,196
Hamilton Island,2004,5,188,0,188
Hamilton Island,2004,6,165,0,165
Hamilton Island,2004,7,167,0,167
Hamilton Island,2004,8,180,0,180
Hamilton Island,2004,9,177,0,177
Hamilton Island,2004,10,191,0,191
Hamilton Island,2004,11,166,0,166
Hamilton Island,2004,12,185,0,185
Hamilton Island,2005,1,173,0,173
Hamilton Island,2005,2,146,0,146
Hamilton Island,2005,3,154,0,154
Hamilton Island,2005,4,152,0,152
Hamilton Island,2005,5,148,0,148
Hamilton Island,2005,6,151,0,151
Hamilton Island,2005,7,197,0,197
Hamilton Island,2005,8,199,0,199
Hamilton Island,2005,9,194,0,194
Hamilton Island,2005,10,206,0,206
Hamilton Island,2005,11,217,0,217
Hamilton Island,2005,12,225,0,225
Hamilton Island,2006,1,217,0,217
Hamilton Island,2006,2,167,0,167
Hamilton Island,2006,3,186,0,186
Hamilton Island,2006,4,189,0,189
Hamilton Island,2006,5,185,0,185
Hamilton Island,2006,6,177,0,177
Hamilton Island,2006,7,191,0,191
Hamilton Island,2006,8,181,0,181
Hamilton Island,2006,9,181,0,181
Hamilton Island,2006,10,196,0,196
Hamilton Island,2006,11,213,0,213
Hamilton Island,2006,12,215,0,215
Hamilton Island,2007,1,210,0,210
Hamilton Island,2007,2,162,0,162
Hamilton Island,2007,3,195,0,195
Hamilton Island,2007,4,186,0,186
Hamilton Island,2007,5,185,0,185
Hamilton Island,2007,6,187,0,187
Hamilton Island,2007,7,192,0,192
Hamilton Island,2007,8,187,0,187
Hamilton Island,2007,9,182,0,182
Hamilton Island,2007,10,189,0,189
Hamilton Island,2007,11,193,0,193
Hamilton Island,2007,12,195,0,195
Hamilton Island,2008,1,192,0,192
Hamilton Island,2008,2,153,0,153
Hamilton Island,2008,3,183,0,183
Hamilton Island,2008,4,180,0,180
Hamilton Island,2008,5,170,0,170
Hamilton Island,2008,6,169,0,169
Hamilton Island,2008,7,180,0,180
Hamilton Island,2008,8,162,0,162
Hamilton Island,2008,9,170,0,170
Hamilton Island,2008,10,183,0,183
Hamilton Island,2008,11,155,0,155
Hamilton Island,2008,12,158,0,158
Hamilton Island,2009,1,161,0,161
Hamilton Island,2009,2,133,0,133
Hamilton Island,2009,3,151,0,151
Hamilton Island,2009,4,150,0,150
Hamilton Island,2009,5,148,0,148
Hamilton Island,2009,6,147,0,147
Hamilton Island,2009,7,178,0,178
Hamilton Island,2009,8,186,0,186
Hamilton Island,2009,9,180,0,180
Hamilton Island,2009,10,186,0,186
Hamilton Island,2009,11,180,0,180
Hamilton Island,2009,12,186,0,186
Hamilton Island,2010,1,185,0,185
Hamilton Island,2010,2,166,0,166
Hamilton Island,2010,3,175,0,175
Hamilton Island,2010,4,180,0,180
Hamilton Island,2010,5,170,0,170
Hamilton Island,2010,6,164,0,164
Hamilton Island,2010,7,183,0,183
Hamilton Island,2010,8,184,0,184
Hamilton Island,2010,9,176,0,176
Hamilton Island,2010,10,186,0,186
Hamilton Island,2010,11,181,0,181
Hamilton Island,2010,12,184,0,184
Hamilton Island,2011,1,185,0,185
Hamilton Island,2011,2,142,0,142
Hamilton Island,2011,3,167,0,167
Hamilton Island,2011,4,178,0,178
Hamilton Island,2011,5,161,0,161
Hamilton Island,2011,6,145,0,145
Hamilton Island,2011,7,184,0,184
Hamilton Island,2011,8,184,0,184
Hamilton Island,2011,9,177,0,177
Hamilton Island,2011,10,186,0,186
Hamilton Island,2011,11,179,0,179
Hamilton Island,2011,12,182,0,182
Hamilton Island,2012,1,173,0,173
Hamilton Island,2012,2,149,0,149
Hamilton Island,2012,3,159,0,159
Hamilton Island,2012,4,159,0,159
Hamilton Island,2012,5,154,0,154
Hamilton Island,2012,6,153,0,153
Hamilton Island,2012,7,152,0,152
Hamilton Island,2012,8,163,0,163
Hamilton Island,2012,9,160,0,160
Hamilton Island,2012,10,161,0,161
Hamilton Island,2012,11,160,0,160
Hamilton Island,2012,12,166,0,166
Hamilton Island,2013,1,161,0,161
Hamilton Island,2013,2,136,0,136
Hamilton Island,2013,3,157,0,157
Hamilton Island,2013,4,157,0,157
Hamilton Island,2013,5,149,0,149
Hamilton Island,2013,6,155,0,155
Hamilton Island,2013,7,162,0,162
Hamilton Island,2013,8,174,0,174
Hamilton Island,2013,9,177,0,177
Hamilton Island,2013,10,182,0,182
Hamilton Island,2013,11,182,0,182
Hamilton Island,2013,12,186,0,186
Hamilton Island,2014,1,172,0,172
Hamilton Island,2014,2,145,0,145
Hamilton Island,2014,3,161,0,161
Hamilton Island,2014,4,164,0,164
Hamilton Island,2014,5,165,0,165
Hamilton Island,2014,6,163,0,163
Hamilton Island,2014,7,195,0,195
Hamilton Island,2014,8,196,0,196
Hamilton Island,2014,9,192,0,192
Hamilton Island,2014,10,188,0,188
Hamilton Island,2014,11,175,0,175
Hamilton Island,2014,12,192,0,192
Hamilton Island,2015,1,197,0,197
Hamilton Island,2015,2,150,0,150
Hamilton Island,2015,3,173,0,173
Hamilton Island,2015,4,173,0,173
Hamilton Island,2015,5,165,0,165
Hamilton Island,2015,6,169,0,169
Hamilton Island,2015,7,172,0,172
Hamilton Island,2015,8,185,0,185
Hamilton Island,2015,9,190,0,190
Hamilton Island,2015,10,199,0,199
Hamilton Island,2015,11,194,0,194
Hamilton Island,2015,12,202,0,202
Hamilton Island,2016,1,211,0,211
Hamilton Island,2016,2,179,0,179
Hamilton Island,2016,3,201,0,201
Hamilton Island,2016,4,205,0,205
Hamilton Island,2016,5,201,0,201
Hamilton Island,2016,6,190,0,190
Hamilton Island,2016,7,220,0,220
Hamilton Island,2016,8,219,0,219
Hamilton Island,2016,9,217,0,217
Hamilton Island,2016,10,224,0,224
Hamilton Island,2016,11,226,0,226
Hamilton Island,2016,12,244,0,244
Hamilton Island,2017,1,244,0,244
Hamilton Island,2017,2,187,0,187
Hamilton Island,2017,3,174,0,174
Hamilton Island,2017,4,141,0,141
Hamilton Island,2017,5,174,0,174
Hamilton Island,2017,6,172,0,172
Hamilton Island,2017,7,205,0,205
Hamilton Island,2017,8,211,0,211
Hamilton Island,2017,9,214,0,214
Hamilton Island,2017,10,210,0,210
Hamilton Island,2017,11,207,0,207
Hamilton Island,2017,12,204,0,204
Hamilton Island,2018,1,217,0,217
Hamilton Island,2018,2,160,0,160
Hamilton Island,2018,3,180,0,180
Hamilton Island,2018,4,193,0,193
Hamilton Island,2018,5,172,0,172
Hamilton Island,2018,6,167,0,167
Hamilton Island,2018,7,205,0,205
Hamilton Island,2018,8,199,0,199
Hamilton Island,2018,9,203,0,203
Hamilton Island,2018,10,212,0,212
Hamilton Island,2018,11,184,0,184
Hamilton Island,2018,12,212,0,212
Hamilton Island,2019,1,217,0,217
Hamilton Island,2019,2,168,0,168
Hamilton Island,2019,3,189,0,189
Hamilton Island,2019,4,198,0,198
Hamilton Island,2019,5,178,0,178
Hamilton Island,2019,6,181,0,181
Hamilton Island,2019,7,203,0,203
Hamilton Island,2019,8,192,0,192
Hamilton Island,2019,9,210,0,210
Hamilton Island,2019,10,212,0,212
Hamilton Island,2019,11,203,0,203
Hamilton Island,2019,12,217,0,217
Hamilton Island,2020,1,223,0,223
Hamilton Island,2020,2,163,0,163
Hamilton Island,2020,3,134,0,134
Hamilton Island,2020,4,0,0,0
Hamilton Island,2020,5,0,0,0
Hamilton Island,2020,6,0,0,0
Hamilton Island,2020,7,6,0,6
Hamilton Island,2020,8,66,0,66
Hamilton Island,2020,9,77,0,77
Hamilton Island,2020,10,80,0,80
Hamilton Island,2020,11,72,0,72
Hamilton Island,2020,12,150,0,150
Hamilton Island,2021,1,137,0,137
Hamilton Island,2021,2,103,0,103
Hamilton Island,2021,3,163,0,163
Hamilton Island,2021,4,202,0,202
Hamilton Island,2021,5,161,0,161
Hamilton Island,2021,6,172,0,172
Hamilton Island,2021,7,127,0,127
Hamilton Island,2021,8,63,0,63
Hamilton Island,2021,9,74,0,74
Hamilton Island,2021,10,93,0,93
Hamilton Island,2021,11,94,0,94
Hamilton Island,2021,12,168,0,168
Hamilton Island,2022,1,181,0,181
Hamilton Island,2022,2,138,0,138
Hamilton Island,2022,3,171,0,171
Hamilton Island,2022,4,244,0,244
Hamilton Island,2022,5,189,0,189
Hamilton Island,2022,6,178,0,178
Hamilton Island,2022,7,187,0,187
Hamilton Island,2022,8,162,0,162
Hamilton Island,2022,9,166,0,166
Hamilton Island,2022,10,183,0,183
Hamilton Island,2022,11,162,0,162
Hamilton Island,2022,12,178,0,178
Hamilton Island,2023,1,188,0,188
Hamilton Island,2023,2,133,0,133
Hamilton Island,2023,3,158,0,158
Hamilton Island,2023,4,178,0,178
Hamilton Island,2023,5,139,0,139
Hamilton Island,2023,6,154,0,154
Hamilton Island,2023,7,174,0,174
Hamilton Island,2023,8,165,0,165
Hamilton Island,2023,9,176,0,176
Hamilton Island,2023,10,172,0,172
Hamilton Island,2023,11,164,0,164
Hamilton Island,2023,12,194,0,194
Hamilton Island,2024,1,193,0,193
Hamilton Island,2024,2,146,0,146
Hamilton Island,2024,3,170,0,170
Hamilton Island,2024,4,160,0,160
Hamilton Island,2024,5,141,0,141
Hamilton Island,2024,6,143,0,143
Hamilton Island,2024,7,161,0,161
Hamilton Island,2024,8,158,0,158
Hamilton Island,2024,9,164,0,164
Hamilton Island,2024,10,163,0,163
Hamilton Island,2024,11,154,0,154
Hamilton Island,2024,12,186,0,186
Hobart,1985,1,467,8,475
Hobart,1985,2,385,8,393
Hobart,1985,3,419,9,428
Hobart,1985,4,415,8,423
Hobart,1985,5,434,8,442
Hobart,1985,6,401,8,409
Hobart,1985,7,386,6,392
Hobart,1985,8,502,7,509
Hobart,1985,9,536,8,544
Hobart,1985,10,517,7,524
Hobart,1985,11,506,8,514
Hobart,1985,12,528,12,540
Hobart,1986,1,562,12,574
Hobart,1986,2,440,11,451
Hobart,1986,3,501,14,515
Hobart,1986,4,472,12,484
Hobart,1986,5,501,14,515
Hobart,1986,6,459,11,470
Hobart,1986,7,431,11,442
Hobart,1986,8,451,9,460
Hobart,1986,9,480,12,492
Hobart,1986,10,484,12,496
Hobart,1986,11,454,13,467
Hobart,1986,12,493,12,505
Hobart,1987,1,559,14,573
Hobart,1987,2,461,12,473
Hobart,1987,3,505,12,517
Hobart,1987,4,458,8,466
Hobart,1987,5,450,9,459
Hobart,1987,6,459,9,468
Hobart,1987,7,478,8,486
Hobart,1987,8,475,10,485
Hobart,1987,9,491,8,499
Hobart,1987,10,516,9,525
Hobart,1987,11,488,9,497
Hobart,1987,12,531,12,543
Hobart,1988,1,552,14,566
Hobart,1988,2,475,13,488
Hobart,1988,3,453,11,464
Hobart,1988,4,410,9,419
Hobart,1988,5,387,9,396
Hobart,1988,6,380,8,388
Hobart,1988,7,389,9,398
Hobart,1988,8,408,9,417
Hobart,1988,9,418,8,426
Hobart,1988,10,408,10,418
Hobart,1988,11,387,12,399
Hobart,1988,12,423,12,435
Hobart,1989,1,448,14,462
Hobart,1989,2,376,15,391
Hobart,1989,3,429,16,445
Hobart,1989,4,399,13,412
Hobart,1989,5,405,14,419
Hobart,1989,6,391,9,400
Hobart,1989,7,399,14,413
Hobart,1989,8,333,13,346
Hobart,1989,9,256,16,272
Hobart,1989,10,248,21,269
Hobart,1989,11,312,16,328
Hobart,1989,12,306,18,324
Hobart,1990,1,353,18,371
Hobart,1990,2,332,16,348
Hobart,1990,3,384,15,399
Hobart,1990,4,385,13,398
Hobart,1990,5,371,13,384
Hobart,1990,6,360,13,373
Hobart,1990,7,363,13,376
Hobart,1990,8,385,13,398
Hobart,1990,9,397,13,410
Hobart,1990,10,401,15,416
Hobart,1990,11,401,13,414
Hobart,1990,12,441,13,454
Hobart,1991,1,490,13,503
Hobart,1991,2,428,12,440
Hobart,1991,3,448,13,461
Hobart,1991,4,438,4,442
Hobart,1991,5,460,4,464
Hobart,1991,6,461,5,466
Hobart,1991,7,429,4,433
Hobart,1991,8,432,5,437
Hobart,1991,9,429,4,433
Hobart,1991,10,447,4,451
Hobart,1991,11,426,5,431
Hobart,1991,12,470,6,476
Hobart,1992,1,535,6,541
Hobart,1992,2,408,5,413
Hobart,1992,3,435,4,439
Hobart,1992,4,440,4,444
Hobart,1992,5,430,5,435
Hobart,1992,6,401,4,405
Hobart,1992,7,401,4,405
Hobart,1992,8,387,6,393
Hobart,1992,9,390,5,395
Hobart,1992,10,402,5,407
Hobart,1992,11,413,4,417
Hobart,1992,12,455,4,459
Hobart,1993,1,505,6,511
Hobart,1993,2,466,8,474
Hobart,1993,3,462,5,467
Hobart,1993,4,549,4,553
Hobart,1993,5,527,5,532
Hobart,1993,6,434,4,438
Hobart,1993,7,527,5,532
Hobart,1993,8,442,4,446
Hobart,1993,9,434,4,438
Hobart,1993,10,450,5,455
Hobart,1993,11,442,4,446
Hobart,1993,12,470,4,474
Hobart,1994,1,489,5,494
Hobart,1994,2,419,4,423
Hobart,1994,3,484,4,488
Hobart,1994,4,455,5,460
Hobart,1994,5,501,4,505
Hobart,1994,6,494,4,498
Hobart,1994,7,511,4,515
Hobart,1994,8,516,4,520
Hobart,1994,9,501,4,505
Hobart,1994,10,510,5,515
Hobart,1994,11,493,4,497
Hobart,1994,12,543,5,548
Hobart,1995,1,645,4,649
Hobart,1995,2,485,3,488
Hobart,1995,3,518,4,522
Hobart,1995,4,480,5,485
Hobart,1995,5,492,4,496
Hobart,1995,6,447,4,451
Hobart,1995,7,442,5,447
Hobart,1995,8,434,4,438
Hobart,1995,9,436,5,441
Hobart,1995,10,469,4,473
Hobart,1995,11,473,4,477
Hobart,1995,12,498,5,503
Hobart,1996,1,575,4,579
Hobart,1996,2,457,4,461
Hobart,1996,3,481,5,486
Hobart,1996,4,447,4,451
Hobart,1996,5,438,4,442
Hobart,1996,6,413,2,415
Hobart,1996,7,426,0,426
Hobart,1996,8,422,0,422
Hobart,1996,9,445,0,445
Hobart,1996,10,419,2,421
Hobart,1996,11,392,5,397
Hobart,1996,12,432,4,436
Hobart,1997,1,471,4,475
Hobart,1997,2,364,4,368
Hobart,1997,3,359,5,364
Hobart,1997,4,328,4,332
Hobart,1997,5,326,0,326
Hobart,1997,6,320,0,320
Hobart,1997,7,329,0,329
Hobart,1997,8,326,0,326
Hobart,1997,9,334,0,334
Hobart,1997,10,342,0,342
Hobart,1997,11,355,5,360
Hobart,1997,12,391,4,395
Hobart,1998,1,433,5,438
Hobart,1998,2,327,4,331
Hobart,1998,3,393,4,397
Hobart,1998,4,412,4,416
Hobart,1998,5,412,0,412
Hobart,1998,6,403,0,403
Hobart,1998,7,406,0,406
Hobart,1998,8,404,0,404
Hobart,1998,9,416,0,416
Hobart,1998,10,425,0,425
Hobart,1998,11,379,0,379
Hobart,1998,12,433,0,433
Hobart,1999,1,477,0,477
Hobart,1999,2,372,0,372
Hobart,1999,3,404,0,404
Hobart,1999,4,386,0,386
Hobart,1999,5,378,0,378
Hobart,1999,6,371,0,371
Hobart,1999,7,378,0,378
Hobart,1999,8,396,0,396
Hobart,1999,9,414,0,414
Hobart,1999,10,419,0,419
Hobart,1999,11,399,0,399
Hobart,1999,12,446,0,446
Hobart,2000,1,459,0,459
Hobart,2000,2,420,0,420
Hobart,2000,3,414,0,414
Hobart,2000,4,515,0,515
Hobart,2000,5,551,0,551
Hobart,2000,6,580,0,580
Hobart,2000,7,597,0,597
Hobart,2000,8,590,0,590
Hobart,2000,9,581,0,581
Hobart,2000,10,629,0,629
Hobart,2000,11,587,0,587
Hobart,2000,12,643,0,643
Hobart,2001,1,713,0,713
Hobart,2001,2,562,0,562
Hobart,2001,3,597,0,597
Hobart,2001,4,670,0,670
Hobart,2001,5,709,0,709
Hobart,2001,6,726,0,726
Hobart,2001,7,765,0,765
Hobart,2001,8,750,0,750
Hobart,2001,9,532,0,532
Hobart,2001,10,394,0,394
Hobart,2001,11,462,0,462
Hobart,2001,12,480,0,480
Hobart,2002,1,496,0,496
Hobart,2002,2,486,0,486
Hobart,2002,3,474,0,474
Hobart,2002,4,431,0,431
Hobart,2002,5,428,0,428
Hobart,2002,6,437,0,437
Hobart,2002,7,451,0,451
Hobart,2002,8,448,0,448
Hobart,2002,9,467,0,467
Hobart,2002,10,482,0,482
Hobart,2002,11,454,0,454
Hobart,2002,12,493,0,493
Hobart,2003,1,535,0,535
Hobart,2003,2,485,0,485
Hobart,2003,3,507,0,507
Hobart,2003,4,488,0,488
Hobart,2003,5,476,0,476
Hobart,2003,6,436,0,436
Hobart,2003,7,456,0,456
Hobart,2003,8,443,0,443
Hobart,2003,9,464,0,464
Hobart,2003,10,503,0,503
Hobart,2003,11,516,0,516
Hobart,2003,12,537,0,537
Hobart,2004,1,582,0,582
Hobart,2004,2,536,0,536
Hobart,2004,3,577,0,577
Hobart,2004,4,556,0,556
Hobart,2004,5,586,0,586
Hobart,2004,6,608,0,608
Hobart,2004,7,607,0,607
Hobart,2004,8,632,0,632
Hobart,2004,9,651,0,651
Hobart,2004,10,655,0,655
Hobart,2004,11,655,0,655
Hobart,2004,12,748,0,748
Hobart,2005,1,739,0,739
Hobart,2005,2,630,0,630
Hobart,2005,3,707,0,707
Hobart,2005,4,661,0,661
Hobart,2005,5,665,0,665
Hobart,2005,6,614,0,614
Hobart,2005,7,638,0,638
Hobart,2005,8,604,0,604
Hobart,2005,9,584,0,584
Hobart,2005,10,601,0,601
Hobart,2005,11,614,0,614
Hobart,2005,12,646,0,646
Hobart,2006,1,647,0,647
Hobart,2006,2,567,0,567
Hobart,2006,3,620,0,620
Hobart,2006,4,551,0,551
Hobart,2006,5,566,0,566
Hobart,2006,6,544,0,544
Hobart,2006,7,549,0,549
Hobart,2006,8,554,0,554
Hobart,2006,9,537,0,537
Hobart,2006,10,572,0,572
Hobart,2006,11,568,0,568
Hobart,2006,12,597,0,597
Hobart,2007,1,583,0,583
Hobart,2007,2,525,0,525
Hobart,2007,3,578,0,578
Hobart,2007,4,566,0,566
Hobart,2007,5,581,0,581
Hobart,2007,6,554,0,554
Hobart,2007,7,560,0,560
Hobart,2007,8,584,0,584
Hobart,2007,9,560,0,560
Hobart,2007,10,580,0,580
Hobart,2007,11,589,0,589
Hobart,2007,12,634,0,634
Hobart,2008,1,667,0,667
Hobart,2008,2,583,0,583
Hobart,2008,3,626,0,626
Hobart,2008,4,615,0,615
Hobart,2008,5,646,0,646
Hobart,2008,6,618,0,618
Hobart,2008,7,628,0,628
Hobart,2008,8,618,0,618
Hobart,2008,9,643,0,643
Hobart,2008,10,658,0,658
Hobart,2008,11,642,0,642
Hobart,2008,12,672,0,672
Hobart,2009,1,651,0,651
Hobart,2009,2,565,0,565
Hobart,2009,3,630,0,630
Hobart,2009,4,633,0,633
Hobart,2009,5,585,0,585
Hobart,2009,6,588,0,588
Hobart,2009,7,631,0,631
Hobart,2009,8,602,0,602
Hobart,2009,9,599,0,599
Hobart,2009,10,618,0,618
Hobart,2009,11,587,0,587
Hobart,2009,12,619,0,619
Hobart,2010,1,655,0,655
Hobart,2010,2,602,0,602
Hobart,2010,3,697,0,697
Hobart,2010,4,682,0,682
Hobart,2010,5,668,0,668
Hobart,2010,6,660,0,660
Hobart,2010,7,694,0,694
Hobart,2010,8,645,0,645
Hobart,2010,9,643,0,643
Hobart,2010,10,674,0,674
Hobart,2010,11,660,0,660
Hobart,2010,12,773,0,773
Hobart,2011,1,837,0,837
Hobart,2011,2,702,0,702
Hobart,2011,3,736,0,736
Hobart,2011,4,614,0,614
Hobart,2011,5,610,0,610
Hobart,2011,6,526,0,526
Hobart,2011,7,613,0,613
Hobart,2011,8,591,0,591
Hobart,2011,9,592,0,592
Hobart,2011,10,608,0,608
Hobart,2011,11,604,0,604
Hobart,2011,12,658,0,658
Hobart,2012,1,714,0,714
Hobart,2012,2,613,0,613
Hobart,2012,3,644,0,644
Hobart,2012,4,588,0,588
Hobart,2012,5,590,0,590
Hobart,2012,6,571,0,571
Hobart,2012,7,610,0,610
Hobart,2012,8,606,0,606
Hobart,2012,9,630,0,630
Hobart,2012,10,670,0,670
Hobart,2012,11,745,0,745
Hobart,2012,12,831,0,831
Hobart,2013,1,834,0,834
Hobart,2013,2,679,0,679
Hobart,2013,3,780,0,780
Hobart,2013,4,687,0,687
Hobart,2013,5,616,0,616
Hobart,2013,6,602,0,602
Hobart,2013,7,676,0,676
Hobart,2013,8,650,0,650
Hobart,2013,9,676,0,676
Hobart,2013,10,702,0,702
Hobart,2013,11,689,0,689
Hobart,2013,12,779,0,779
Hobart,2014,1,790,0,790
Hobart,2014,2,618,0,618
Hobart,2014,3,735,0,735
Hobart,2014,4,683,0,683
Hobart,2014,5,624,0,624
Hobart,2014,6,646,0,646
Hobart,2014,7,722,0,722
Hobart,2014,8,700,0,700
Hobart,2014,9,703,0,703
Hobart,2014,10,743,0,743
Hobart,2014,11,716,0,716
Hobart,2014,12,838,0,838
Hobart,2015,1,868,0,868
Hobart,2015,2,667,0,667
Hobart,2015,3,743,0,743
Hobart,2015,4,710,0,710
Hobart,2015,5,691,0,691
Hobart,2015,6,679,0,679
Hobart,2015,7,724,0,724
Hobart,2015,8,705,0,705
Hobart,2015,9,707,0,707
Hobart,2015,10,758,0,758
Hobart,2015,11,750,0,750
Hobart,2015,12,873,0,873
Hobart,2016,1,889,0,889
Hobart,2016,2,713,0,713
Hobart,2016,3,809,0,809
Hobart,2016,4,771,0,771
Hobart,2016,5,736,0,736
Hobart,2016,6,733,0,733
Hobart,2016,7,792,0,792
Hobart,2016,8,751,0,751
Hobart,2016,9,767,0,767
Hobart,2016,10,815,0,815
Hobart,2016,11,795,0,795
Hobart,2016,12,925,0,925
Hobart,2017,1,945,0,945
Hobart,2017,2,755,0,755
Hobart,2017,3,835,0,835
Hobart,2017,4,791,0,791
Hobart,2017,5,723,0,723
Hobart,2017,6,730,0,730
Hobart,2017,7,778,0,778
Hobart,2017,8,722,0,722
Hobart,2017,9,740,0,740
Hobart,2017,10,797,0,797
Hobart,2017,11,787,0,787
Hobart,2017,12,961,0,961
Hobart,2018,1,1004,0,1004
Hobart,2018,2,799,0,799
Hobart,2018,3,873,0,873
Hobart,2018,4,816,0,816
Hobart,2018,5,705,0,705
Hobart,2018,6,704,0,704
Hobart,2018,7,780,0,780
Hobart,2018,8,725,0,725
Hobart,2018,9,755,0,755
Hobart,2018,10,845,0,845
Hobart,2018,11,838,0,838
Hobart,2018,12,959,0,959
Hobart,2019,1,996,0,996
Hobart,2019,2,814,0,814
Hobart,2019,3,879,0,879
Hobart,2019,4,839,0,839
Hobart,2019,5,762,0,762
Hobart,2019,6,767,0,767
Hobart,2019,7,830,0,830
Hobart,2019,8,764,0,764
Hobart,2019,9,787,0,787
Hobart,2019,10,857,0,857
Hobart,2019,11,861,0,861
Hobart,2019,12,1000,0,1000
Hobart,2020,1,977,0,977
Hobart,2020,2,842,0,842
Hobart,2020,3,678,0,678
Hobart,2020,4,68,1,69
Hobart,2020,5,68,0,68
Hobart,2020,6,66,0,66
Hobart,2020,7,84,0,84
Hobart,2020,8,107,0,107
Hobart,2020,9,109,0,109
Hobart,2020,10,121,0,121
Hobart,2020,11,272,0,272
Hobart,2020,12,674,4,678
Hobart,2021,1,658,13,671
Hobart,2021,2,515,4,519
Hobart,2021,3,746,0,746
Hobart,2021,4,856,3,859
Hobart,2021,5,734,9,743
Hobart,2021,6,557,7,564
Hobart,2021,7,519,8,527
Hobart,2021,8,296,0,296
Hobart,2021,9,328,0,328
Hobart,2021,10,399,0,399
Hobart,2021,11,451,1,452
Hobart,2021,12,829,4,833
Hobart,2022,1,878,0,878
Hobart,2022,2,599,0,599
Hobart,2022,3,822,0,822
Hobart,2022,4,989,0,989
Hobart,2022,5,883,0,883
Hobart,2022,6,872,0,872
Hobart,2022,7,838,7,845
Hobart,2022,8,731,7,738
Hobart,2022,9,744,8,752
Hobart,2022,10,809,9,818
Hobart,2022,11,871,13,884
Hobart,2022,12,1008,15,1023
Hobart,2023,1,1012,13,1025
Hobart,2023,2,853,10,863
Hobart,2023,3,923,12,935
Hobart,2023,4,863,13,876
Hobart,2023,5,791,8,799
Hobart,2023,6,783,9,792
Hobart,2023,7,778,9,787
Hobart,2023,8,750,8,758
Hobart,2023,9,795,7,802
Hobart,2023,10,886,9,895
Hobart,2023,11,847,13,860
Hobart,2023,12,1021,11,1032
Hobart,2024,1,1096,11,1107
Hobart,2024,2,873,13,886
Hobart,2024,3,931,13,944
Hobart,2024,4,901,2,903
Hobart,2024,5,778,0,778
Hobart,2024,6,759,0,759
Hobart,2024,7,842,0,842
Hobart,2024,8,755,0,755
Hobart,2024,9,775,0,775
Hobart,2024,10,820,3,823
Hobart,2024,11,805,12,817
Hobart,2024,12,954,13,967
Karratha,1985,1,258,0,258
Karratha,1985,2,233,0,233
Karratha,1985,3,243,0,243
Karratha,1985,4,252,0,252
Karratha,1985,5,274,0,274
Karratha,1985,6,253,0,253
Karratha,1985,7,264,0,264
Karratha,1985,8,271,0,271
Karratha,1985,9,256,0,256
Karratha,1985,10,256,0,256
Karratha,1985,11,262,0,262
Karratha,1985,12,266,0,266
Karratha,1986,1,231,0,231
Karratha,1986,2,208,0,208
Karratha,1986,3,223,0,223
Karratha,1986,4,218,0,218
Karratha,1986,5,239,0,239
Karratha,1986,6,229,0,229
Karratha,1986,7,240,0,240
Karratha,1986,8,241,0,241
Karratha,1986,9,228,0,228
Karratha,1986,10,240,0,240
Karratha,1986,11,216,0,216
Karratha,1986,12,249,0,249
Karratha,1987,1,222,0,222
Karratha,1987,2,201,0,201
Karratha,1987,3,222,0,222
Karratha,1987,4,212,0,212
Karratha,1987,5,214,0,214
Karratha,1987,6,208,0,208
Karratha,1987,7,235,0,235
Karratha,1987,8,226,0,226
Karratha,1987,9,224,0,224
Karratha,1987,10,223,0,223
Karratha,1987,11,213,0,213
Karratha,1987,12,198,0,198
Karratha,1988,1,204,0,204
Karratha,1988,2,183,0,183
Karratha,1988,3,195,0,195
Karratha,1988,4,185,0,185
Karratha,1988,5,185,0,185
Karratha,1988,6,186,0,186
Karratha,1988,7,208,0,208
Karratha,1988,8,200,0,200
Karratha,1988,9,192,0,192
Karratha,1988,10,187,0,187
Karratha,1988,11,163,0,163
Karratha,1988,12,161,0,161
Karratha,1989,1,171,0,171
Karratha,1989,2,144,0,144
Karratha,1989,3,168,0,168
Karratha,1989,4,163,0,163
Karratha,1989,5,177,0,177
Karratha,1989,6,157,0,157
Karratha,1989,7,181,0,181
Karratha,1989,8,115,0,115
Karratha,1989,9,31,0,31
Karratha,1989,10,91,0,91
Karratha,1989,11,97,0,97
Karratha,1989,12,110,0,110
Karratha,1990,1,121,0,121
Karratha,1990,2,107,0,107
Karratha,1990,3,137,0,137
Karratha,1990,4,135,0,135
Karratha,1990,5,139,0,139
Karratha,1990,6,122,0,122
Karratha,1990,7,157,0,157
Karratha,1990,8,150,0,150
Karratha,1990,9,138,0,138
Karratha,1990,10,163,0,163
Karratha,1990,11,151,0,151
Karratha,1990,12,136,0,136
Karratha,1991,1,152,0,152
Karratha,1991,2,131,0,131
Karratha,1991,3,141,0,141
Karratha,1991,4,150,0,150
Karratha,1991,5,154,0,154
Karratha,1991,6,142,0,142
Karratha,1991,7,156,0,156
Karratha,1991,8,137,0,137
Karratha,1991,9,153,0,153
Karratha,1991,10,164,0,164
Karratha,1991,11,151,0,151
Karratha,1991,12,141,0,141
Karratha,1992,1,158,0,158
Karratha,1992,2,142,0,142
Karratha,1992,3,156,0,156
Karratha,1992,4,159,0,159
Karratha,1992,5,157,0,157
Karratha,1992,6,160,0,160
Karratha,1992,7,164,0,164
Karratha,1992,8,152,0,152
Karratha,1992,9,157,0,157
Karratha,1992,10,155,0,155
Karratha,1992,11,151,0,151
Karratha,1992,12,149,0,149
Karratha,1993,1,142,0,142
Karratha,1993,2,132,0,132
Karratha,1993,3,152,0,152
Karratha,1993,4,151,0,151
Karratha,1993,5,151,0,151
Karratha,1993,6,150,0,150
Karratha,1993,7,175,0,175
Karratha,1993,8,168,0,168
Karratha,1993,9,180,0,180
Karratha,1993,10,168,0,168
Karratha,1993,11,176,0,176
Karratha,1993,12,164,0,164
Karratha,1994,1,156,0,156
Karratha,1994,2,159,0,159
Karratha,1994,3,165,0,165
Karratha,1994,4,161,0,161
Karratha,1994,5,173,0,173
Karratha,1994,6,178,0,178
Karratha,1994,7,184,0,184
Karratha,1994,8,195,0,195
Karratha,1994,9,184,0,184
Karratha,1994,10,190,0,190
Karratha,1994,11,210,0,210
Karratha,1994,12,223,0,223
Karratha,1995,1,209,0,209
Karratha,1995,2,183,0,183
Karratha,1995,3,215,0,215
Karratha,1995,4,199,0,199
Karratha,1995,5,208,0,208
Karratha,1995,6,203,0,203
Karratha,1995,7,201,0,201
Karratha,1995,8,218,0,218
Karratha,1995,9,207,0,207
Karratha,1995,10,197,0,197
Karratha,1995,11,187,0,187
Karratha,1995,12,177,0,177
Karratha,1996,1,191,0,191
Karratha,1996,2,196,0,196
Karratha,1996,3,202,0,202
Karratha,1996,4,219,0,219
Karratha,1996,5,230,0,230
Karratha,1996,6,217,0,217
Karratha,1996,7,243,0,243
Karratha,1996,8,237,0,237
Karratha,1996,9,227,0,227
Karratha,1996,10,245,0,245
Karratha,1996,11,212,0,212
Karratha,1996,12,202,0,202
Karratha,1997,1,211,0,211
Karratha,1997,2,203,0,203
Karratha,1997,3,199,0,199
Karratha,1997,4,201,0,201
Karratha,1997,5,216,0,216
Karratha,1997,6,202,0,202
Karratha,1997,7,218,0,218
Karratha,1997,8,207,0,207
Karratha,1997,9,201,0,201
Karratha,1997,10,210,0,210
Karratha,1997,11,197,0,197
Karratha,1997,12,187,0,187
Karratha,1998,1,202,0,202
Karratha,1998,2,179,0,179
Karratha,1998,3,205,0,205
Karratha,1998,4,187,0,187
Karratha,1998,5,200,0,200
Karratha,1998,6,200,0,200
Karratha,1998,7,207,0,207
Karratha,1998,8,203,0,203
Karratha,1998,9,191,0,191
Karratha,1998,10,199,0,199
Karratha,1998,11,198,0,198
Karratha,1998,12,198,0,198
Karratha,1999,1,199,0,199
Karratha,1999,2,177,0,177
Karratha,1999,3,189,0,189
Karratha,1999,4,187,0,187
Karratha,1999,5,190,0,190
Karratha,1999,6,193,0,193
Karratha,1999,7,152,0,152
Karratha,1999,8,144,0,144
Karratha,1999,9,142,0,142
Karratha,1999,10,144,0,144
Karratha,1999,11,140,0,140
Karratha,1999,12,140,0,140
Karratha,2000,1,141,0,141
Karratha,2000,2,147,0,147
Karratha,2000,3,151,0,151
Karratha,2000,4,193,0,193
Karratha,2000,5,209,0,209
Karratha,2000,6,195,0,195
Karratha,2000,7,199,0,199
Karratha,2000,8,203,0,203
Karratha,2000,9,190,0,190
Karratha,2000,10,201,0,201
Karratha,2000,11,200,0,200
Karratha,2000,12,193,0,193
Karratha,2001,1,206,0,206
Karratha,2001,2,187,0,187
Karratha,2001,3,203,0,203
Karratha,2001,4,197,0,197
Karratha,2001,5,189,0,189
Karratha,2001,6,177,0,177
Karratha,2001,7,187,0,187
Karratha,2001,8,188,0,188
Karratha,2001,9,140,0,140
Karratha,2001,10,112,0,112
Karratha,2001,11,144,0,144
Karratha,2001,12,145,0,145
Karratha,2002,1,129,0,129
Karratha,2002,2,116,0,116
Karratha,2002,3,132,0,132
Karratha,2002,4,141,0,141
Karratha,2002,5,138,0,138
Karratha,2002,6,131,0,131
Karratha,2002,7,140,0,140
Karratha,2002,8,135,0,135
Karratha,2002,9,126,0,126
Karratha,2002,10,131,0,131
Karratha,2002,11,115,0,115
Karratha,2002,12,123,0,123
Karratha,2003,1,121,0,121
Karratha,2003,2,110,0,110
Karratha,2003,3,119,0,119
Karratha,2003,4,112,0,112
Karratha,2003,5,109,0,109
Karratha,2003,6,103,0,103
Karratha,2003,7,118,0,118
Karratha,2003,8,121,0,121
Karratha,2003,9,118,0,118
Karratha,2003,10,117,0,117
Karratha,2003,11,116,0,116
Karratha,2003,12,118,0,118
Karratha,2004,1,105,0,105
Karratha,2004,2,111,0,111
Karratha,2004,3,117,0,117
Karratha,2004,4,116,0,116
Karratha,2004,5,145,0,145
Karratha,2004,6,152,0,152
Karratha,2004,7,150,0,150
Karratha,2004,8,140,0,140
Karratha,2004,9,142,0,142
Karratha,2004,10,148,0,148
Karratha,2004,11,146,0,146
Karratha,2004,12,149,0,149
Karratha,2005,1,151,0,151
Karratha,2005,2,136,0,136
Karratha,2005,3,145,0,145
Karratha,2005,4,140,0,140
Karratha,2005,5,147,0,147
Karratha,2005,6,144,0,144
Karratha,2005,7,152,0,152
Karratha,2005,8,154,0,154
Karratha,2005,9,145,0,145
Karratha,2005,10,147,0,147
Karratha,2005,11,146,0,146
Karratha,2005,12,145,0,145
Karratha,2006,1,140,0,140
Karratha,2006,2,127,0,127
Karratha,2006,3,147,0,147
Karratha,2006,4,133,0,133
Karratha,2006,5,147,0,147
Karratha,2006,6,138,0,138
Karratha,2006,7,153,0,153
Karratha,2006,8,132,0,132
Karratha,2006,9,123,0,123
Karratha,2006,10,119,0,119
Karratha,2006,11,123,0,123
Karratha,2006,12,117,0,117
Karratha,2007,1,125,0,125
Karratha,2007,2,129,0,129
Karratha,2007,3,122,0,122
Karratha,2007,4,121,0,121
Karratha,2007,5,126,0,126
Karratha,2007,6,119,0,119
Karratha,2007,7,124,0,124
Karratha,2007,8,131,0,131
Karratha,2007,9,131,0,131
Karratha,2007,10,142,0,142
Karratha,2007,11,156,0,156
Karratha,2007,12,157,0,157
Karratha,2008,1,167,0,167
Karratha,2008,2,159,0,159
Karratha,2008,3,176,0,176
Karratha,2008,4,179,0,179
Karratha,2008,5,180,0,180
Karratha,2008,6,180,0,180
Karratha,2008,7,202,0,202
Karratha,2008,8,193,0,193
Karratha,2008,9,188,0,188
Karratha,2008,10,222,0,222
Karratha,2008,11,238,0,238
Karratha,2008,12,246,0,246
Karratha,2009,1,261,0,261
Karratha,2009,2,238,0,238
Karratha,2009,3,252,0,252
Karratha,2009,4,257,0,257
Karratha,2009,5,267,0,267
Karratha,2009,6,270,0,270
Karratha,2009,7,280,0,280
Karratha,2009,8,267,0,267
Karratha,2009,9,269,0,269
Karratha,2009,10,271,0,271
Karratha,2009,11,274,0,274
Karratha,2009,12,269,0,269
Karratha,2010,1,270,0,270
Karratha,2010,2,250,0,250
Karratha,2010,3,292,0,292
Karratha,2010,4,299,0,299
Karratha,2010,5,308,0,308
Karratha,2010,6,304,0,304
Karratha,2010,7,313,0,313
Karratha,2010,8,319,0,319
Karratha,2010,9,309,0,309
Karratha,2010,10,310,0,310
Karratha,2010,11,313,0,313
Karratha,2010,12,302,0,302
Karratha,2011,1,317,0,317
Karratha,2011,2,277,0,277
Karratha,2011,3,328,0,328
Karratha,2011,4,309,0,309
Karratha,2011,5,332,0,332
Karratha,2011,6,324,0,324
Karratha,2011,7,346,0,346
Karratha,2011,8,368,0,368
Karratha,2011,9,364,0,364
Karratha,2011,10,346,0,346
Karratha,2011,11,363,0,363
Karratha,2011,12,359,0,359
Karratha,2012,1,394,0,394
Karratha,2012,2,363,0,363
Karratha,2012,3,380,0,380
Karratha,2012,4,356,0,356
Karratha,2012,5,382,0,382
Karratha,2012,6,354,0,354
Karratha,2012,7,368,0,368
Karratha,2012,8,382,0,382
Karratha,2012,9,361,0,361
Karratha,2012,10,395,0,395
Karratha,2012,11,375,0,375
Karratha,2012,12,353,0,353
Karratha,2013,1,369,0,369
Karratha,2013,2,300,0,300
Karratha,2013,3,359,0,359
Karratha,2013,4,366,0,366
Karratha,2013,5,382,0,382
Karratha,2013,6,343,0,343
Karratha,2013,7,400,0,400
Karratha,2013,8,386,0,386
Karratha,2013,9,380,0,380
Karratha,2013,10,409,0,409
Karratha,2013,11,392,0,392
Karratha,2013,12,362,0,362
Karratha,2014,1,401,0,401
Karratha,2014,2,361,0,361
Karratha,2014,3,376,0,376
Karratha,2014,4,375,0,375
Karratha,2014,5,380,0,380
Karratha,2014,6,344,0,344
Karratha,2014,7,338,0,338
Karratha,2014,8,328,0,328
Karratha,2014,9,340,0,340
Karratha,2014,10,365,0,365
Karratha,2014,11,317,0,317
Karratha,2014,12,328,0,328
Karratha,2015,1,325,0,325
Karratha,2015,2,311,0,311
Karratha,2015,3,342,0,342
Karratha,2015,4,341,0,341
Karratha,2015,5,331,0,331
Karratha,2015,6,334,0,334
Karratha,2015,7,363,0,363
Karratha,2015,8,328,0,328
Karratha,2015,9,334,0,334
Karratha,2015,10,340,0,340
Karratha,2015,11,328,0,328
Karratha,2015,12,333,0,333
Karratha,2016,1,310,0,310
Karratha,2016,2,308,0,308
Karratha,2016,3,327,0,327
Karratha,2016,4,293,0,293
Karratha,2016,5,322,0,322
Karratha,2016,6,275,0,275
Karratha,2016,7,289,0,289
Karratha,2016,8,309,0,309
Karratha,2016,9,302,0,302
Karratha,2016,10,293,0,293
Karratha,2016,11,296,0,296
Karratha,2016,12,276,0,276
Karratha,2017,1,280,0,280
Karratha,2017,2,250,0,250
Karratha,2017,3,281,0,281
Karratha,2017,4,251,0,251
Karratha,2017,5,280,0,280
Karratha,2017,6,265,0,265
Karratha,2017,7,255,0,255
Karratha,2017,8,266,0,266
Karratha,2017,9,245,0,245
Karratha,2017,10,257,0,257
Karratha,2017,11,255,0,255
Karratha,2017,12,243,0,243
Karratha,2018,1,260,0,260
Karratha,2018,2,235,0,235
Karratha,2018,3,259,0,259
Karratha,2018,4,239,0,239
Karratha,2018,5,259,0,259
Karratha,2018,6,241,0,241
Karratha,2018,7,249,0,249
Karratha,2018,8,259,0,259
Karratha,2018,9,240,0,240
Karratha,2018,10,260,0,260
Karratha,2018,11,259,0,259
Karratha,2018,12,235,0,235
Karratha,2019,1,266,0,266
Karratha,2019,2,238,0,238
Karratha,2019,3,247,0,247
Karratha,2019,4,250,0,250
Karratha,2019,5,262,0,262
Karratha,2019,6,237,0,237
Karratha,2019,7,257,0,257
Karratha,2019,8,251,0,251
Karratha,2019,9,245,0,245
Karratha,2019,10,260,0,260
Karratha,2019,11,246,0,246
Karratha,2019,12,237,0,237
Karratha,2020,1,256,0,256
Karratha,2020,2,220,0,220
Karratha,2020,3,205,0,205
Karratha,2020,4,47,0,47
Karratha,2020,5,29,0,29
Karratha,2020,6,49,0,49
Karratha,2020,7,81,0,81
Karratha,2020,8,110,0,110
Karratha,2020,9,174,0,174
Karratha,2020,10,189,0,189
Karratha,2020,11,183,0,183
Karratha,2020,12,193,0,193
Karratha,2021,1,186,0,186
Karratha,2021,2,168,0,168
Karratha,2021,3,195,0,195
Karratha,2021,4,185,0,185
Karratha,2021,5,189,0,189
Karratha,2021,6,194,0,194
Karratha,2021,7,193,0,193
Karratha,2021,8,195,0,195
Karratha,2021,9,193,0,193
Karratha,2021,10,189,0,189
Karratha,2021,11,196,0,196
Karratha,2021,12,191,0,191
Karratha,2022,1,201,0,201
Karratha,2022,2,186,0,186
Karratha,2022,3,206,0,206
Karratha,2022,4,187,0,187
Karratha,2022,5,192,0,192
Karratha,2022,6,196,0,196
Karratha,2022,7,189,0,189
Karratha,2022,8,199,0,199
Karratha,2022,9,194,0,194
Karratha,2022,10,191,0,191
Karratha,2022,11,193,0,193
Karratha,2022,12,180,0,180
Karratha,2023,1,195,0,195
Karratha,2023,2,178,0,178
Karratha,2023,3,199,0,199
Karratha,2023,4,182,0,182
Karratha,2023,5,204,0,204
Karratha,2023,6,195,0,195
Karratha,2023,7,207,0,207
Karratha,2023,8,235,0,235
Karratha,2023,9,218,0,218
Karratha,2023,10,234,0,234
Karratha,2023,11,243,0,243
Karratha,2023,12,217,0,217
Karratha,2024,1,242,0,242
Karratha,2024,2,222,0,222
Karratha,2024,3,239,0,239
Karratha,2024,4,249,0,249
Karratha,2024,5,263,0,263
Karratha,2024,6,239,0,239
Karratha,2024,7,269,0,269
Karratha,2024,8,262,0,262
Karratha,2024,9,253,0,253
Karratha,2024,10,268,0,268
Karratha,2024,11,251,0,251
Karratha,2024,12,233,0,233
Launceston,1985,1,653,0,653
Launceston,1985,2,570,0,570
Launceston,1985,3,680,0,680
Launceston,1985,4,620,0,620
Launceston,1985,5,639,0,639
Launceston,1985,6,599,0,599
Launceston,1985,7,587,0,587
Launceston,1985,8,609,0,609
Launceston,1985,9,648,0,648
Launceston,1985,10,678,0,678
Launceston,1985,11,579,0,579
Launceston,1985,12,652,0,652
Launceston,1986,1,688,0,688
Launceston,1986,2,589,0,589
Launceston,1986,3,641,0,641
Launceston,1986,4,641,0,641
Launceston,1986,5,661,0,661
Launceston,1986,6,599,0,599
Launceston,1986,7,578,0,578
Launceston,1986,8,626,0,626
Launceston,1986,9,642,0,642
Launceston,1986,10,659,0,659
Launceston,1986,11,620,0,620
Launceston,1986,12,687,0,687
Launceston,1987,1,712,0,712
Launceston,1987,2,617,0,617
Launceston,1987,3,689,0,689
Launceston,1987,4,624,0,624
Launceston,1987,5,639,0,639
Launceston,1987,6,589,0,589
Launceston,1987,7,590,0,590
Launceston,1987,8,588,0,588
Launceston,1987,9,614,0,614
Launceston,1987,10,682,0,682
Launceston,1987,11,637,0,637
Launceston,1987,12,689,0,689
Launceston,1988,1,725,0,725
Launceston,1988,2,679,0,679
Launceston,1988,3,688,0,688
Launceston,1988,4,685,0,685
Launceston,1988,5,633,0,633
Launceston,1988,6,619,0,619
Launceston,1988,7,604,0,604
Launceston,1988,8,648,0,648
Launceston,1988,9,680,0,680
Launceston,1988,10,635,0,635
Launceston,1988,11,702,0,702
Launceston,1988,12,699,0,699
Launceston,1989,1,632,0,632
Launceston,1989,2,543,0,543
Launceston,1989,3,614,0,614
Launceston,1989,4,542,0,542
Launceston,1989,5,566,0,566
Launceston,1989,6,558,0,558
Launceston,1989,7,529,0,529
Launceston,1989,8,493,0,493
Launceston,1989,9,365,0,365
Launceston,1989,10,422,0,422
Launceston,1989,11,468,0,468
Launceston,1989,12,514,0,514
Launceston,1990,1,595,0,595
Launceston,1990,2,570,0,570
Launceston,1990,3,620,0,620
Launceston,1990,4,601,0,601
Launceston,1990,5,583,0,583
Launceston,1990,6,579,0,579
Launceston,1990,7,631,0,631
Launceston,1990,8,609,0,609
Launceston,1990,9,684,0,684
Launceston,1990,10,643,0,643
Launceston,1990,11,672,0,672
Launceston,1990,12,663,0,663
Launceston,1991,1,691,0,691
Launceston,1991,2,575,0,575
Launceston,1991,3,655,0,655
Launceston,1991,4,555,0,555
Launceston,1991,5,577,0,577
Launceston,1991,6,522,0,522
Launceston,1991,7,530,0,530
Launceston,1991,8,552,0,552
Launceston,1991,9,590,0,590
Launceston,1991,10,606,0,606
Launceston,1991,11,594,0,594
Launceston,1991,12,679,0,679
Launceston,1992,1,740,0,740
Launceston,1992,2,588,0,588
Launceston,1992,3,610,0,610
Launceston,1992,4,622,0,622
Launceston,1992,5,597,0,597
Launceston,1992,6,544,0,544
Launceston,1992,7,569,0,569
Launceston,1992,8,548,0,548
Launceston,1992,9,586,0,586
Launceston,1992,10,608,0,608
Launceston,1992,11,574,0,574
Launceston,1992,12,671,0,671
Launceston,1993,1,710,0,710
Launceston,1993,2,504,0,504
Launceston,1993,3,562,0,562
Launceston,1993,4,586,0,586
Launceston,1993,5,541,0,541
Launceston,1993,6,517,0,517
Launceston,1993,7,521,0,521
Launceston,1993,8,533,0,533
Launceston,1993,9,543,0,543
Launceston,1993,10,550,0,550
Launceston,1993,11,513,0,513
Launceston,1993,12,640,0,640
Launceston,1994,1,718,0,718
Launceston,1994,2,532,0,532
Launceston,1994,3,568,0,568
Launceston,1994,4,541,0,541
Launceston,1994,5,569,0,569
Launceston,1994,6,552,0,552
Launceston,1994,7,551,0,551
Launceston,1994,8,556,0,556
Launceston,1994,9,545,0,545
Launceston,1994,10,577,0,577
Launceston,1994,11,527,0,527
Launceston,1994,12,621,0,621
Launceston,1995,1,717,0,717
Launceston,1995,2,519,0,519
Launceston,1995,3,550,0,550
Launceston,1995,4,536,0,536
Launceston,1995,5,522,0,522
Launceston,1995,6,475,0,475
Launceston,1995,7,486,0,486
Launceston,1995,8,482,0,482
Launceston,1995,9,493,0,493
Launceston,1995,10,497,0,497
Launceston,1995,11,475,0,475
Launceston,1995,12,546,0,546
Launceston,1996,1,662,0,662
Launceston,1996,2,511,0,511
Launceston,1996,3,542,0,542
Launceston,1996,4,502,0,502
Launceston,1996,5,475,0,475
Launceston,1996,6,461,0,461
Launceston,1996,7,470,0,470
Launceston,1996,8,461,0,461
Launceston,1996,9,476,0,476
Launceston,1996,10,492,0,492
Launceston,1996,11,468,0,468
Launceston,1996,12,536,0,536
Launceston,1997,1,631,0,631
Launceston,1997,2,479,0,479
Launceston,1997,3,535,0,535
Launceston,1997,4,499,0,499
Launceston,1997,5,497,0,497
Launceston,1997,6,480,0,480
Launceston,1997,7,494,0,494
Launceston,1997,8,461,0,461
Launceston,1997,9,477,0,477
Launceston,1997,10,476,0,476
Launceston,1997,11,444,0,444
Launceston,1997,12,488,0,488
Launceston,1998,1,577,0,577
Launceston,1998,2,467,0,467
Launceston,1998,3,514,0,514
Launceston,1998,4,483,0,483
Launceston,1998,5,462,0,462
Launceston,1998,6,448,0,448
Launceston,1998,7,463,0,463
Launceston,1998,8,452,0,452
Launceston,1998,9,466,0,466
Launceston,1998,10,468,0,468
Launceston,1998,11,445,0,445
Launceston,1998,12,485,0,485
Launceston,1999,1,563,0,563
Launceston,1999,2,452,0,452
Launceston,1999,3,503,0,503
Launceston,1999,4,459,0,459
Launceston,1999,5,438,0,438
Launceston,1999,6,428,0,428
Launceston,1999,7,376,0,376
Launceston,1999,8,419,0,419
Launceston,1999,9,445,0,445
Launceston,1999,10,436,0,436
Launceston,1999,11,426,0,426
Launceston,1999,12,503,0,503
Launceston,2000,1,562,0,562
Launceston,2000,2,511,0,511
Launceston,2000,3,565,0,565
Launceston,2000,4,554,0,554
Launceston,2000,5,545,0,545
Launceston,2000,6,528,0,528
Launceston,2000,7,535,0,535
Launceston,2000,8,537,0,537
Launceston,2000,9,454,0,454
Launceston,2000,10,457,0,457
Launceston,2000,11,440,0,440
Launceston,2000,12,520,0,520
Launceston,2001,1,655,0,655
Launceston,2001,2,490,0,490
Launceston,2001,3,535,0,535
Launceston,2001,4,540,0,540
Launceston,2001,5,494,0,494
Launceston,2001,6,475,0,475
Launceston,2001,7,458,0,458
Launceston,2001,8,457,0,457
Launceston,2001,9,367,0,367
Launceston,2001,10,288,0,288
Launceston,2001,11,343,0,343
Launceston,2001,12,477,0,477
Launceston,2002,1,367,0,367
Launceston,2002,2,291,0,291
Launceston,2002,3,319,0,319
Launceston,2002,4,309,0,309
Launceston,2002,5,321,0,321
Launceston,2002,6,309,0,309
Launceston,2002,7,321,0,321
Launceston,2002,8,321,0,321
Launceston,2002,9,314,0,314
Launceston,2002,10,320,0,320
Launceston,2002,11,299,0,299
Launceston,2002,12,351,0,351
Launceston,2003,1,384,0,384
Launceston,2003,2,333,0,333
Launceston,2003,3,337,0,337
Launceston,2003,4,251,0,251
Launceston,2003,5,314,0,314
Launceston,2003,6,281,0,281
Launceston,2003,7,281,0,281
Launceston,2003,8,311,0,311
Launceston,2003,9,305,0,305
Launceston,2003,10,317,0,317
Launceston,2003,11,332,0,332
Launceston,2003,12,390,0,390
Launceston,2004,1,462,0,462
Launceston,2004,2,397,0,397
Launceston,2004,3,414,0,414
Launceston,2004,4,371,0,371
Launceston,2004,5,366,0,366
Launceston,2004,6,364,0,364
Launceston,2004,7,367,0,367
Launceston,2004,8,394,0,394
Launceston,2004,9,459,0,459
Launceston,2004,10,478,0,478
Launceston,2004,11,466,0,466
Launceston,2004,12,496,0,496
Launceston,2005,1,522,0,522
Launceston,2005,2,444,0,444
Launceston,2005,3,492,0,492
Launceston,2005,4,470,0,470
Launceston,2005,5,474,0,474
Launceston,2005,6,463,0,463
Launceston,2005,7,474,0,474
Launceston,2005,8,461,0,461
Launceston,2005,9,482,0,482
Launceston,2005,10,485,0,485
Launceston,2005,11,482,0,482
Launceston,2005,12,508,0,508
Launceston,2006,1,529,0,529
Launceston,2006,2,455,0,455
Launceston,2006,3,500,0,500
Launceston,2006,4,437,0,437
Launceston,2006,5,460,0,460
Launceston,2006,6,435,0,435
Launceston,2006,7,451,0,451
Launceston,2006,8,478,0,478
Launceston,2006,9,467,0,467
Launceston,2006,10,471,0,471
Launceston,2006,11,484,0,484
Launceston,2006,12,577,0,577
Launceston,2007,1,581,0,581
Launceston,2007,2,489,0,489
Launceston,2007,3,537,0,537
Launceston,2007,4,534,0,534
Launceston,2007,5,534,0,534
Launceston,2007,6,487,0,487
Launceston,2007,7,498,0,498
Launceston,2007,8,509,0,509
Launceston,2007,9,506,0,506
Launceston,2007,10,529,0,529
Launceston,2007,11,519,0,519
Launceston,2007,12,592,0,592
Launceston,2008,1,589,0,589
Launceston,2008,2,521,0,521
Launceston,2008,3,573,0,573
Launceston,2008,4,536,0,536
Launceston,2008,5,563,0,563
Launceston,2008,6,517,0,517
Launceston,2008,7,530,0,530
Launceston,2008,8,530,0,530
Launceston,2008,9,519,0,519
Launceston,2008,10,540,0,540
Launceston,2008,11,527,0,527
Launceston,2008,12,572,0,572
Launceston,2009,1,588,0,588
Launceston,2009,2,510,0,510
Launceston,2009,3,559,0,559
Launceston,2009,4,548,0,548
Launceston,2009,5,515,0,515
Launceston,2009,6,509,0,509
Launceston,2009,7,532,0,532
Launceston,2009,8,532,0,532
Launceston,2009,9,517,0,517
Launceston,2009,10,536,0,536
Launceston,2009,11,511,0,511
Launceston,2009,12,548,0,548
Launceston,2010,1,597,0,597
Launceston,2010,2,528,0,528
Launceston,2010,3,607,0,607
Launceston,2010,4,595,0,595
Launceston,2010,5,579,0,579
Launceston,2010,6,560,0,560
Launceston,2010,7,593,0,593
Launceston,2010,8,550,0,550
Launceston,2010,9,548,0,548
Launceston,2010,10,522,0,522
Launceston,2010,11,524,0,524
Launceston,2010,12,646,0,646
Launceston,2011,1,639,0,639
Launceston,2011,2,548,0,548
Launceston,2011,3,587,0,587
Launceston,2011,4,500,0,500
Launceston,2011,5,481,0,481
Launceston,2011,6,429,0,429
Launceston,2011,7,513,0,513
Launceston,2011,8,512,0,512
Launceston,2011,9,511,0,511
Launceston,2011,10,526,0,526
Launceston,2011,11,540,0,540
Launceston,2011,12,600,0,600
Launceston,2012,1,638,0,638
Launceston,2012,2,521,0,521
Launceston,2012,3,548,0,548
Launceston,2012,4,517,0,517
Launceston,2012,5,523,0,523
Launceston,2012,6,498,0,498
Launceston,2012,7,556,0,556
Launceston,2012,8,552,0,552
Launceston,2012,9,545,0,545
Launceston,2012,10,577,0,577
Launceston,2012,11,643,0,643
Launceston,2012,12,672,0,672
Launceston,2013,1,700,0,700
Launceston,2013,2,585,0,585
Launceston,2013,3,664,0,664
Launceston,2013,4,631,0,631
Launceston,2013,5,587,0,587
Launceston,2013,6,559,0,559
Launceston,2013,7,607,0,607
Launceston,2013,8,587,0,587
Launceston,2013,9,595,0,595
Launceston,2013,10,641,0,641
Launceston,2013,11,638,0,638
Launceston,2013,12,696,0,696
Launceston,2014,1,706,0,706
Launceston,2014,2,570,0,570
Launceston,2014,3,626,0,626
Launceston,2014,4,617,0,617
Launceston,2014,5,601,0,601
Launceston,2014,6,593,0,593
Launceston,2014,7,598,0,598
Launceston,2014,8,573,0,573
Launceston,2014,9,581,0,581
Launceston,2014,10,617,0,617
Launceston,2014,11,617,0,617
Launceston,2014,12,662,0,662
Launceston,2015,1,683,0,683
Launceston,2015,2,557,0,557
Launceston,2015,3,626,0,626
Launceston,2015,4,579,0,579
Launceston,2015,5,577,0,577
Launceston,2015,6,550,0,550
Launceston,2015,7,588,0,588
Launceston,2015,8,560,0,560
Launceston,2015,9,577,0,577
Launceston,2015,10,616,0,616
Launceston,2015,11,651,0,651
Launceston,2015,12,716,0,716
Launceston,2016,1,711,0,711
Launceston,2016,2,601,0,601
Launceston,2016,3,633,0,633
Launceston,2016,4,597,0,597
Launceston,2016,5,560,0,560
Launceston,2016,6,543,0,543
Launceston,2016,7,592,0,592
Launceston,2016,8,555,0,555
Launceston,2016,9,597,0,597
Launceston,2016,10,596,0,596
Launceston,2016,11,635,0,635
Launceston,2016,12,726,0,726
Launceston,2017,1,740,0,740
Launceston,2017,2,607,0,607
Launceston,2017,3,668,0,668
Launceston,2017,4,620,0,620
Launceston,2017,5,581,0,581
Launceston,2017,6,562,0,562
Launceston,2017,7,589,0,589
Launceston,2017,8,539,0,539
Launceston,2017,9,578,0,578
Launceston,2017,10,617,0,617
Launceston,2017,11,644,0,644
Launceston,2017,12,722,0,722
Launceston,2018,1,775,0,775
Launceston,2018,2,619,0,619
Launceston,2018,3,681,0,681
Launceston,2018,4,629,0,629
Launceston,2018,5,563,0,563
Launceston,2018,6,536,0,536
Launceston,2018,7,633,0,633
Launceston,2018,8,569,0,569
Launceston,2018,9,581,0,581
Launceston,2018,10,646,0,646
Launceston,2018,11,660,0,660
Launceston,2018,12,729,0,729
Launceston,2019,1,801,0,801
Launceston,2019,2,643,0,643
Launceston,2019,3,713,0,713
Launceston,2019,4,697,0,697
Launceston,2019,5,609,0,609
Launceston,2019,6,575,0,575
Launceston,2019,7,646,0,646
Launceston,2019,8,553,0,553
Launceston,2019,9,589,0,589
Launceston,2019,10,658,0,658
Launceston,2019,11,639,0,639
Launceston,2019,12,735,0,735
Launceston,2020,1,728,0,728
Launceston,2020,2,625,0,625
Launceston,2020,3,551,0,551
Launceston,2020,4,163,0,163
Launceston,2020,5,147,0,147
Launceston,2020,6,166,0,166
Launceston,2020,7,193,0,193
Launceston,2020,8,212,0,212
Launceston,2020,9,233,0,233
Launceston,2020,10,259,0,259
Launceston,2020,11,307,0,307
Launceston,2020,12,544,0,544
Launceston,2021,1,521,0,521
Launceston,2021,2,441,0,441
Launceston,2021,3,586,0,586
Launceston,2021,4,648,0,648
Launceston,2021,5,537,0,537
Launceston,2021,6,414,0,414
Launceston,2021,7,445,0,445
Launceston,2021,8,331,0,331
Launceston,2021,9,315,0,315
Launceston,2021,10,318,0,318
Launceston,2021,11,357,0,357
Launceston,2021,12,590,0,590
Launceston,2022,1,618,0,618
Launceston,2022,2,418,0,418
Launceston,2022,3,555,0,555
Launceston,2022,4,672,0,672
Launceston,2022,5,576,0,576
Launceston,2022,6,595,0,595
Launceston,2022,7,575,0,575
Launceston,2022,8,505,0,505
Launceston,2022,9,535,0,535
Launceston,2022,10,605,0,605
Launceston,2022,11,662,0,662
Launceston,2022,12,736,0,736
Launceston,2023,1,770,0,770
Launceston,2023,2,631,0,631
Launceston,2023,3,713,0,713
Launceston,2023,4,664,0,664
Launceston,2023,5,609,0,609
Launceston,2023,6,582,0,582
Launceston,2023,7,630,0,630
Launceston,2023,8,615,0,615
Launceston,2023,9,618,0,618
Launceston,2023,10,682,0,682
Launceston,2023,11,675,0,675
Launceston,2023,12,753,0,753
Launceston,2024,1,768,0,768
Launceston,2024,2,675,0,675
Launceston,2024,3,726,0,726
Launceston,2024,4,657,0,657
Launceston,2024,5,563,0,563
Launceston,2024,6,522,0,522
Launceston,2024,7,595,0,595
Launceston,2024,8,562,0,562
Launceston,2024,9,587,0,587
Launceston,2024,10,599,0,599
Launceston,2024,11,542,0,542
Launceston,2024,12,634,0,634
Mackay,1985,1,304,0,304
Mackay,1985,2,278,0,278
Mackay,1985,3,328,0,328
Mackay,1985,4,320,0,320
Mackay,1985,5,357,0,357
Mackay,1985,6,339,0,339
Mackay,1985,7,396,0,396
Mackay,1985,8,335,0,335
Mackay,1985,9,311,0,311
Mackay,1985,10,318,0,318
Mackay,1985,11,330,0,330
Mackay,1985,12,323,0,323
Mackay,1986,1,319,0,319
Mackay,1986,2,289,0,289
Mackay,1986,3,337,0,337
Mackay,1986,4,359,0,359
Mackay,1986,5,402,0,402
Mackay,1986,6,356,0,356
Mackay,1986,7,357,0,357
Mackay,1986,8,393,0,393
Mackay,1986,9,395,0,395
Mackay,1986,10,386,0,386
Mackay,1986,11,364,0,364
Mackay,1986,12,354,0,354
Mackay,1987,1,331,0,331
Mackay,1987,2,293,0,293
Mackay,1987,3,352,0,352
Mackay,1987,4,341,0,341
Mackay,1987,5,349,0,349
Mackay,1987,6,340,0,340
Mackay,1987,7,386,0,386
Mackay,1987,8,373,0,373
Mackay,1987,9,361,0,361
Mackay,1987,10,363,0,363
Mackay,1987,11,370,0,370
Mackay,1987,12,362,0,362
Mackay,1988,1,363,0,363
Mackay,1988,2,332,0,332
Mackay,1988,3,417,0,417
Mackay,1988,4,473,0,473
Mackay,1988,5,428,0,428
Mackay,1988,6,429,0,429
Mackay,1988,7,451,0,451
Mackay,1988,8,428,0,428
Mackay,1988,9,465,0,465
Mackay,1988,10,471,0,471
Mackay,1988,11,418,0,418
Mackay,1988,12,411,0,411
Mackay,1989,1,397,0,397
Mackay,1989,2,368,0,368
Mackay,1989,3,424,0,424
Mackay,1989,4,407,0,407
Mackay,1989,5,435,0,435
Mackay,1989,6,463,0,463
Mackay,1989,7,437,0,437
Mackay,1989,8,391,0,391
Mackay,1989,9,256,0,256
Mackay,1989,10,291,0,291
Mackay,1989,11,302,0,302
Mackay,1989,12,303,0,303
Mackay,1990,1,293,0,293
Mackay,1990,2,281,0,281
Mackay,1990,3,283,0,283
Mackay,1990,4,264,0,264
Mackay,1990,5,305,0,305
Mackay,1990,6,316,0,316
Mackay,1990,7,327,0,327
Mackay,1990,8,341,0,341
Mackay,1990,9,346,0,346
Mackay,1990,10,392,0,392
Mackay,1990,11,389,0,389
Mackay,1990,12,324,0,324
Mackay,1991,1,411,0,411
Mackay,1991,2,375,0,375
Mackay,1991,3,421,0,421
Mackay,1991,4,396,0,396
Mackay,1991,5,403,0,403
Mackay,1991,6,388,0,388
Mackay,1991,7,420,0,420
Mackay,1991,8,436,0,436
Mackay,1991,9,427,0,427
Mackay,1991,10,446,0,446
Mackay,1991,11,422,0,422
Mackay,1991,12,426,0,426
Mackay,1992,1,425,0,425
Mackay,1992,2,393,0,393
Mackay,1992,3,375,0,375
Mackay,1992,4,388,0,388
Mackay,1992,5,392,0,392
Mackay,1992,6,382,0,382
Mackay,1992,7,443,0,443
Mackay,1992,8,438,0,438
Mackay,1992,9,443,0,443
Mackay,1992,10,441,0,441
Mackay,1992,11,422,0,422
Mackay,1992,12,442,0,442
Mackay,1993,1,441,0,441
Mackay,1993,2,391,0,391
Mackay,1993,3,453,0,453
Mackay,1993,4,456,0,456
Mackay,1993,5,451,0,451
Mackay,1993,6,454,0,454
Mackay,1993,7,466,0,466
Mackay,1993,8,478,0,478
Mackay,1993,9,479,0,479
Mackay,1993,10,487,0,487
Mackay,1993,11,455,0,455
Mackay,1993,12,470,0,470
Mackay,1994,1,472,0,472
Mackay,1994,2,428,0,428
Mackay,1994,3,477,0,477
Mackay,1994,4,457,0,457
Mackay,1994,5,475,0,475
Mackay,1994,6,454,0,454
Mackay,1994,7,493,0,493
Mackay,1994,8,494,0,494
Mackay,1994,9,479,0,479
Mackay,1994,10,508,0,508
Mackay,1994,11,482,0,482
Mackay,1994,12,486,0,486
Mackay,1995,1,495,0,495
Mackay,1995,2,438,0,438
Mackay,1995,3,517,0,517
Mackay,1995,4,519,0,519
Mackay,1995,5,523,0,523
Mackay,1995,6,515,0,515
Mackay,1995,7,538,0,538
Mackay,1995,8,523,0,523
Mackay,1995,9,527,0,527
Mackay,1995,10,535,0,535
Mackay,1995,11,526,0,526
Mackay,1995,12,522,0,522
Mackay,1996,1,529,0,529
Mackay,1996,2,497,0,497
Mackay,1996,3,534,0,534
Mackay,1996,4,511,0,511
Mackay,1996,5,506,0,506
Mackay,1996,6,483,0,483
Mackay,1996,7,523,0,523
Mackay,1996,8,532,0,532
Mackay,1996,9,529,0,529
Mackay,1996,10,555,0,555
Mackay,1996,11,541,0,541
Mackay,1996,12,530,0,530
Mackay,1997,1,531,0,531
Mackay,1997,2,482,0,482
Mackay,1997,3,520,0,520
Mackay,1997,4,497,0,497
Mackay,1997,5,521,0,521
Mackay,1997,6,515,0,515
Mackay,1997,7,526,0,526
Mackay,1997,8,491,0,491
Mackay,1997,9,520,0,520
Mackay,1997,10,509,0,509
Mackay,1997,11,508,0,508
Mackay,1997,12,525,0,525
Mackay,1998,1,513,0,513
Mackay,1998,2,426,0,426
Mackay,1998,3,480,0,480
Mackay,1998,4,505,0,505
Mackay,1998,5,503,0,503
Mackay,1998,6,491,0,491
Mackay,1998,7,523,0,523
Mackay,1998,8,515,0,515
Mackay,1998,9,520,0,520
Mackay,1998,10,541,0,541
Mackay,1998,11,528,0,528
Mackay,1998,12,521,0,521
Mackay,1999,1,484,0,484
Mackay,1999,2,440,0,440
Mackay,1999,3,502,0,502
Mackay,1999,4,515,0,515
Mackay,1999,5,532,0,532
Mackay,1999,6,523,0,523
Mackay,1999,7,535,0,535
Mackay,1999,8,530,0,530
Mackay,1999,9,519,0,519
Mackay,1999,10,530,0,530
Mackay,1999,11,520,0,520
Mackay,1999,12,514,0,514
Mackay,2000,1,458,0,458
Mackay,2000,2,472,0,472
Mackay,2000,3,552,0,552
Mackay,2000,4,495,0,495
Mackay,2000,5,554,0,554
Mackay,2000,6,548,0,548
Mackay,2000,7,559,0,559
Mackay,2000,8,565,0,565
Mackay,2000,9,542,0,542
Mackay,2000,10,592,0,592
Mackay,2000,11,553,0,553
Mackay,2000,12,538,0,538
Mackay,2001,1,516,0,516
Mackay,2001,2,527,0,527
Mackay,2001,3,608,0,608
Mackay,2001,4,588,0,588
Mackay,2001,5,639,0,639
Mackay,2001,6,556,0,556
Mackay,2001,7,494,0,494
Mackay,2001,8,473,0,473
Mackay,2001,9,439,0,439
Mackay,2001,10,442,0,442
Mackay,2001,11,459,0,459
Mackay,2001,12,433,0,433
Mackay,2002,1,426,0,426
Mackay,2002,2,398,0,398
Mackay,2002,3,416,0,416
Mackay,2002,4,407,0,407
Mackay,2002,5,422,0,422
Mackay,2002,6,400,0,400
Mackay,2002,7,429,0,429
Mackay,2002,8,430,0,430
Mackay,2002,9,417,0,417
Mackay,2002,10,436,0,436
Mackay,2002,11,372,0,372
Mackay,2002,12,381,0,381
Mackay,2003,1,381,0,381
Mackay,2003,2,342,0,342
Mackay,2003,3,313,0,313
Mackay,2003,4,318,0,318
Mackay,2003,5,337,0,337
Mackay,2003,6,324,0,324
Mackay,2003,7,334,0,334
Mackay,2003,8,306,0,306
Mackay,2003,9,296,0,296
Mackay,2003,10,305,0,305
Mackay,2003,11,294,0,294
Mackay,2003,12,300,0,300
Mackay,2004,1,339,0,339
Mackay,2004,2,316,0,316
Mackay,2004,3,343,0,343
Mackay,2004,4,323,0,323
Mackay,2004,5,342,0,342
Mackay,2004,6,344,0,344
Mackay,2004,7,366,0,366
Mackay,2004,8,375,0,375
Mackay,2004,9,366,0,366
Mackay,2004,10,376,0,376
Mackay,2004,11,369,0,369
Mackay,2004,12,401,0,401
Mackay,2005,1,380,0,380
Mackay,2005,2,357,0,357
Mackay,2005,3,391,0,391
Mackay,2005,4,382,0,382
Mackay,2005,5,403,0,403
Mackay,2005,6,390,0,390
Mackay,2005,7,404,0,404
Mackay,2005,8,404,0,404
Mackay,2005,9,395,0,395
Mackay,2005,10,402,0,402
Mackay,2005,11,387,0,387
Mackay,2005,12,392,0,392
Mackay,2006,1,386,0,386
Mackay,2006,2,348,0,348
Mackay,2006,3,389,0,389
Mackay,2006,4,389,0,389
Mackay,2006,5,435,0,435
Mackay,2006,6,417,0,417
Mackay,2006,7,433,0,433
Mackay,2006,8,437,0,437
Mackay,2006,9,420,0,420
Mackay,2006,10,431,0,431
Mackay,2006,11,422,0,422
Mackay,2006,12,418,0,418
Mackay,2007,1,422,0,422
Mackay,2007,2,393,0,393
Mackay,2007,3,432,0,432
Mackay,2007,4,415,0,415
Mackay,2007,5,444,0,444
Mackay,2007,6,428,0,428
Mackay,2007,7,442,0,442
Mackay,2007,8,450,0,450
Mackay,2007,9,426,0,426
Mackay,2007,10,444,0,444
Mackay,2007,11,452,0,452
Mackay,2007,12,468,0,468
Mackay,2008,1,472,0,472
Mackay,2008,2,435,0,435
Mackay,2008,3,443,0,443
Mackay,2008,4,455,0,455
Mackay,2008,5,491,0,491
Mackay,2008,6,489,0,489
Mackay,2008,7,539,0,539
Mackay,2008,8,534,0,534
Mackay,2008,9,512,0,512
Mackay,2008,10,531,0,531
Mackay,2008,11,511,0,511
Mackay,2008,12,517,0,517
Mackay,2009,1,502,0,502
Mackay,2009,2,460,0,460
Mackay,2009,3,494,0,494
Mackay,2009,4,497,0,497
Mackay,2009,5,502,0,502
Mackay,2009,6,494,0,494
Mackay,2009,7,522,0,522
Mackay,2009,8,493,0,493
Mackay,2009,9,499,0,499
Mackay,2009,10,585,0,585
Mackay,2009,11,583,0,583
Mackay,2009,12,579,0,579
Mackay,2010,1,578,0,578
Mackay,2010,2,532,0,532
Mackay,2010,3,578,0,578
Mackay,2010,4,593,0,593
Mackay,2010,5,631,0,631
Mackay,2010,6,620,0,620
Mackay,2010,7,665,0,665
Mackay,2010,8,622,0,622
Mackay,2010,9,620,0,620
Mackay,2010,10,658,0,658
Mackay,2010,11,644,0,644
Mackay,2010,12,630,0,630
Mackay,2011,1,604,0,604
Mackay,2011,2,560,0,560
Mackay,2011,3,633,0,633
Mackay,2011,4,602,0,602
Mackay,2011,5,630,0,630
Mackay,2011,6,612,0,612
Mackay,2011,7,652,0,652
Mackay,2011,8,660,0,660
Mackay,2011,9,631,0,631
Mackay,2011,10,624,0,624
Mackay,2011,11,589,0,589
Mackay,2011,12,586,0,586
Mackay,2012,1,576,0,576
Mackay,2012,2,572,0,572
Mackay,2012,3,612,0,612
Mackay,2012,4,592,0,592
Mackay,2012,5,628,0,628
Mackay,2012,6,602,0,602
Mackay,2012,7,617,0,617
Mackay,2012,8,631,0,631
Mackay,2012,9,599,0,599
Mackay,2012,10,631,0,631
Mackay,2012,11,599,0,599
Mackay,2012,12,606,0,606
Mackay,2013,1,640,0,640
Mackay,2013,2,586,0,586
Mackay,2013,3,637,0,637
Mackay,2013,4,636,0,636
Mackay,2013,5,648,0,648
Mackay,2013,6,616,0,616
Mackay,2013,7,663,0,663
Mackay,2013,8,652,0,652
Mackay,2013,9,634,0,634
Mackay,2013,10,662,0,662
Mackay,2013,11,594,0,594
Mackay,2013,12,598,0,598
Mackay,2014,1,575,0,575
Mackay,2014,2,515,0,515
Mackay,2014,3,582,0,582
Mackay,2014,4,545,0,545
Mackay,2014,5,545,0,545
Mackay,2014,6,545,0,545
Mackay,2014,7,600,0,600
Mackay,2014,8,600,0,600
Mackay,2014,9,579,0,579
Mackay,2014,10,610,0,610
Mackay,2014,11,573,0,573
Mackay,2014,12,576,0,576
Mackay,2015,1,564,0,564
Mackay,2015,2,524,0,524
Mackay,2015,3,585,0,585
Mackay,2015,4,526,0,526
Mackay,2015,5,544,0,544
Mackay,2015,6,517,0,517
Mackay,2015,7,549,0,549
Mackay,2015,8,531,0,531
Mackay,2015,9,489,0,489
Mackay,2015,10,498,0,498
Mackay,2015,11,492,0,492
Mackay,2015,12,478,0,478
Mackay,2016,1,477,0,477
Mackay,2016,2,461,0,461
Mackay,2016,3,493,0,493
Mackay,2016,4,475,0,475
Mackay,2016,5,487,0,487
Mackay,2016,6,468,0,468
Mackay,2016,7,495,0,495
Mackay,2016,8,504,0,504
Mackay,2016,9,482,0,482
Mackay,2016,10,484,0,484
Mackay,2016,11,451,0,451
Mackay,2016,12,447,0,447
Mackay,2017,1,427,0,427
Mackay,2017,2,403,0,403
Mackay,2017,3,399,0,399
Mackay,2017,4,409,0,409
Mackay,2017,5,434,0,434
Mackay,2017,6,423,0,423
Mackay,2017,7,432,0,432
Mackay,2017,8,444,0,444
Mackay,2017,9,433,0,433
Mackay,2017,10,440,0,440
Mackay,2017,11,418,0,418
Mackay,2017,12,410,0,410
Mackay,2018,1,424,0,424
Mackay,2018,2,381,0,381
Mackay,2018,3,428,0,428
Mackay,2018,4,417,0,417
Mackay,2018,5,444,0,444
Mackay,2018,6,421,0,421
Mackay,2018,7,470,0,470
Mackay,2018,8,448,0,448
Mackay,2018,9,423,0,423
Mackay,2018,10,443,0,443
Mackay,2018,11,440,0,440
Mackay,2018,12,436,0,436
Mackay,2019,1,455,0,455
Mackay,2019,2,417,0,417
Mackay,2019,3,451,0,451
Mackay,2019,4,453,0,453
Mackay,2019,5,489,0,489
Mackay,2019,6,459,0,459
Mackay,2019,7,483,0,483
Mackay,2019,8,468,0,468
Mackay,2019,9,475,0,475
Mackay,2019,10,493,0,493
Mackay,2019,11,462,0,462
Mackay,2019,12,462,0,462
Mackay,2020,1,454,0,454
Mackay,2020,2,442,0,442
Mackay,2020,3,421,0,421
Mackay,2020,4,155,0,155
Mackay,2020,5,109,0,109
Mackay,2020,6,157,0,157
Mackay,2020,7,227,0,227
Mackay,2020,8,260,0,260
Mackay,2020,9,280,0,280
Mackay,2020,10,308,0,308
Mackay,2020,11,336,0,336
Mackay,2020,12,364,0,364
Mackay,2021,1,357,0,357
Mackay,2021,2,341,0,341
Mackay,2021,3,402,0,402
Mackay,2021,4,378,0,378
Mackay,2021,5,380,0,380
Mackay,2021,6,393,0,393
Mackay,2021,7,400,0,400
Mackay,2021,8,302,0,302
Mackay,2021,9,386,0,386
Mackay,2021,10,392,0,392
Mackay,2021,11,408,0,408
Mackay,2021,12,435,0,435
Mackay,2022,1,372,0,372
Mackay,2022,2,318,0,318
Mackay,2022,3,431,0,431
Mackay,2022,4,413,0,413
Mackay,2022,5,456,0,456
Mackay,2022,6,440,0,440
Mackay,2022,7,420,0,420
Mackay,2022,8,428,0,428
Mackay,2022,9,411,0,411
Mackay,2022,10,427,0,427
Mackay,2022,11,432,0,432
Mackay,2022,12,438,0,438
Mackay,2023,1,435,0,435
Mackay,2023,2,414,0,414
Mackay,2023,3,470,0,470
Mackay,2023,4,433,0,433
Mackay,2023,5,464,0,464
Mackay,2023,6,446,0,446
Mackay,2023,7,458,0,458
Mackay,2023,8,470,0,470
Mackay,2023,9,439,0,439
Mackay,2023,10,471,0,471
Mackay,2023,11,507,0,507
Mackay,2023,12,494,0,494
Mackay,2024,1,452,0,452
Mackay,2024,2,447,0,447
Mackay,2024,3,502,0,502
Mackay,2024,4,436,0,436
Mackay,2024,5,452,0,452
Mackay,2024,6,416,0,416
Mackay,2024,7,452,0,452
Mackay,2024,8,434,0,434
Mackay,2024,9,438,0,438
Mackay,2024,10,477,0,477
Mackay,2024,11,430,0,430
Mackay,2024,12,416,0,416
Melbourne,1985,1,2998,478,3476
Melbourne,1985,2,2653,453,3106
Melbourne,1985,3,2981,475,3456
Melbourne,1985,4,2885,467,3352
Melbourne,1985,5,3168,485,3653
Melbourne,1985,6,2856,466,3322
Melbourne,1985,7,2924,480,3404
Melbourne,1985,8,3228,495,3723
Melbourne,1985,9,3267,469,3736
Melbourne,1985,10,3280,475,3755
Melbourne,1985,11,3093,487,3580
Melbourne,1985,12,3204,508,3712
Melbourne,1986,1,3108,515,3623
Melbourne,1986,2,2822,437,3259
Melbourne,1986,3,3049,478,3527
Melbourne,1986,4,3108,508,3616
Melbourne,1986,5,3252,532,3784
Melbourne,1986,6,2969,543,3512
Melbourne,1986,7,2936,549,3485
Melbourne,1986,8,3185,571,3756
Melbourne,1986,9,3180,488,3668
Melbourne,1986,10,3119,564,3683
Melbourne,1986,11,3112,583,3695
Melbourne,1986,12,3231,591,3822
Melbourne,1987,1,3220,588,3808
Melbourne,1987,2,2870,542,3412
Melbourne,1987,3,3238,591,3829
Melbourne,1987,4,3195,550,3745
Melbourne,1987,5,3077,570,3647
Melbourne,1987,6,3009,551,3560
Melbourne,1987,7,3295,584,3879
Melbourne,1987,8,3184,585,3769
Melbourne,1987,9,3377,562,3939
Melbourne,1987,10,3437,570,4007
Melbourne,1987,11,3238,563,3801
Melbourne,1987,12,3414,591,4005
Melbourne,1988,1,3228,603,3831
Melbourne,1988,2,3041,552,3593
Melbourne,1988,3,3463,570,4033
Melbourne,1988,4,3197,574,3771
Melbourne,1988,5,3312,574,3886
Melbourne,1988,6,3239,550,3789
Melbourne,1988,7,3286,570,3856
Melbourne,1988,8,3484,578,4062
Melbourne,1988,9,3530,561,4091
Melbourne,1988,10,3468,615,4083
Melbourne,1988,11,3453,611,4064
Melbourne,1988,12,3342,647,3989
Melbourne,1989,1,3230,659,3889
Melbourne,1989,2,3108,595,3703
Melbourne,1989,3,3564,622,4186
Melbourne,1989,4,3293,594,3887
Melbourne,1989,5,3510,596,4106
Melbourne,1989,6,3471,573,4044
Melbourne,1989,7,3583,579,4162
Melbourne,1989,8,2619,608,3227
Melbourne,1989,9,1126,609,1735
Melbourne,1989,10,1676,640,2316
Melbourne,1989,11,2267,657,2924
Melbourne,1989,12,2474,678,3152
Melbourne,1990,1,2936,679,3615
Melbourne,1990,2,2808,619,3427
Melbourne,1990,3,3166,678,3844
Melbourne,1990,4,3138,652,3790
Melbourne,1990,5,3355,665,4020
Melbourne,1990,6,3190,657,3847
Melbourne,1990,7,3468,693,4161
Melbourne,1990,8,3429,692,4121
Melbourne,1990,9,3341,664,4005
Melbourne,1990,10,3649,684,4333
Melbourne,1990,11,3638,677,4315
Melbourne,1990,12,3793,707,4500
Melbourne,1991,1,3665,693,4358
Melbourne,1991,2,3397,631,4028
Melbourne,1991,3,3781,703,4484
Melbourne,1991,4,3709,606,4315
Melbourne,1991,5,3756,604,4360
Melbourne,1991,6,3689,604,4293
Melbourne,1991,7,4128,623,4751
Melbourne,1991,8,4073,609,4682
Melbourne,1991,9,3858,589,4447
Melbourne,1991,10,4115,626,4741
Melbourne,1991,11,4081,623,4704
Melbourne,1991,12,4119,651,4770
Melbourne,1992,1,3988,651,4639
Melbourne,1992,2,3609,617,4226
Melbourne,1992,3,3935,679,4614
Melbourne,1992,4,3927,622,4549
Melbourne,1992,5,3969,660,4629
Melbourne,1992,6,3867,623,4490
Melbourne,1992,7,4177,620,4797
Melbourne,1992,8,4099,660,4759
Melbourne,1992,9,4488,636,5124
Melbourne,1992,10,4625,685,5310
Melbourne,1992,11,4441,661,5102
Melbourne,1992,12,4519,708,5227
Melbourne,1993,1,4435,696,5131
Melbourne,1993,2,4137,658,4795
Melbourne,1993,3,4343,712,5055
Melbourne,1993,4,4232,668,4900
Melbourne,1993,5,4242,678,4920
Melbourne,1993,6,4105,656,4761
Melbourne,1993,7,4402,690,5092
Melbourne,1993,8,4287,678,4965
Melbourne,1993,9,4277,669,4946
Melbourne,1993,10,4331,702,5033
Melbourne,1993,11,4182,655,4837
Melbourne,1993,12,4261,678,4939
Melbourne,1994,1,4169,673,4842
Melbourne,1994,2,3927,592,4519
Melbourne,1994,3,4491,645,5136
Melbourne,1994,4,4323,594,4917
Melbourne,1994,5,4478,614,5092
Melbourne,1994,6,4404,595,4999
Melbourne,1994,7,4690,630,5320
Melbourne,1994,8,4651,617,5268
Melbourne,1994,9,4606,600,5206
Melbourne,1994,10,4671,618,5289
Melbourne,1994,11,4589,619,5208
Melbourne,1994,12,4772,640,5412
Melbourne,1995,1,4590,640,5230
Melbourne,1995,2,4370,586,4956
Melbourne,1995,3,4860,649,5509
Melbourne,1995,4,4746,628,5374
Melbourne,1995,5,4887,641,5528
Melbourne,1995,6,4748,628,5376
Melbourne,1995,7,4895,659,5554
Melbourne,1995,8,4817,663,5480
Melbourne,1995,9,4779,638,5417
Melbourne,1995,10,5006,660,5666
Melbourne,1995,11,4857,648,5505
Melbourne,1995,12,4852,666,5518
Melbourne,1996,1,4917,671,5588
Melbourne,1996,2,4750,645,5395
Melbourne,1996,3,5053,673,5726
Melbourne,1996,4,4765,649,5414
Melbourne,1996,5,4984,677,5661
Melbourne,1996,6,4778,660,5438
Melbourne,1996,7,5092,704,5796
Melbourne,1996,8,5091,711,5802
Melbourne,1996,9,5036,713,5749
Melbourne,1996,10,5172,733,5905
Melbourne,1996,11,4892,730,5622
Melbourne,1996,12,4935,755,5690
Melbourne,1997,1,4971,748,5719
Melbourne,1997,2,4627,672,5299
Melbourne,1997,3,5093,760,5853
Melbourne,1997,4,5013,712,5725
Melbourne,1997,5,4961,718,5679
Melbourne,1997,6,4822,715,5537
Melbourne,1997,7,5280,753,6033
Melbourne,1997,8,5124,731,5855
Melbourne,1997,9,5112,697,5809
Melbourne,1997,10,5308,727,6035
Melbourne,1997,11,4949,717,5666
Melbourne,1997,12,4952,750,5702
Melbourne,1998,1,4969,744,5713
Melbourne,1998,2,4641,673,5314
Melbourne,1998,3,5220,739,5959
Melbourne,1998,4,4993,707,5700
Melbourne,1998,5,5090,747,5837
Melbourne,1998,6,4983,710,5693
Melbourne,1998,7,5316,738,6054
Melbourne,1998,8,5196,737,5933
Melbourne,1998,9,5240,725,5965
Melbourne,1998,10,5376,769,6145
Melbourne,1998,11,5083,742,5825
Melbourne,1998,12,5132,749,5881
Melbourne,1999,1,5032,740,5772
Melbourne,1999,2,4759,688,5447
Melbourne,1999,3,5346,768,6114
Melbourne,1999,4,5180,758,5938
Melbourne,1999,5,5262,776,6038
Melbourne,1999,6,5104,755,5859
Melbourne,1999,7,5457,786,6243
Melbourne,1999,8,5407,789,6196
Melbourne,1999,9,5395,773,6168
Melbourne,1999,10,5518,804,6322
Melbourne,1999,11,5241,835,6076
Melbourne,1999,12,5369,877,6246
Melbourne,2000,1,5261,897,6158
Melbourne,2000,2,5120,861,5981
Melbourne,2000,3,5680,902,6582
Melbourne,2000,4,5467,869,6336
Melbourne,2000,5,5685,870,6555
Melbourne,2000,6,5800,835,6635
Melbourne,2000,7,6055,894,6949
Melbourne,2000,8,6195,890,7085
Melbourne,2000,9,6156,879,7035
Melbourne,2000,10,6426,903,7329
Melbourne,2000,11,6207,937,7144
Melbourne,2000,12,6287,1003,7290
Melbourne,2001,1,6388,1023,7411
Melbourne,2001,2,6081,933,7014
Melbourne,2001,3,6899,1028,7927
Melbourne,2001,4,6567,986,7553
Melbourne,2001,5,6568,978,7546
Melbourne,2001,6,6165,950,7115
Melbourne,2001,7,6498,974,7472
Melbourne,2001,8,6528,979,7507
Melbourne,2001,9,4789,936,5725
Melbourne,2001,10,4814,962,5776
Melbourne,2001,11,5044,914,5958
Melbourne,2001,12,5320,993,6313
Melbourne,2002,1,5192,985,6177
Melbourne,2002,2,4818,875,5693
Melbourne,2002,3,4821,971,5792
Melbourne,2002,4,4800,831,5631
Melbourne,2002,5,5041,835,5876
Melbourne,2002,6,4901,808,5709
Melbourne,2002,7,5291,906,6197
Melbourne,2002,8,5225,902,6127
Melbourne,2002,9,5369,878,6247
Melbourne,2002,10,5624,895,6519
Melbourne,2002,11,5220,888,6108
Melbourne,2002,12,5322,942,6264
Melbourne,2003,1,5264,931,6195
Melbourne,2003,2,4800,841,5641
Melbourne,2003,3,5277,919,6196
Melbourne,2003,4,5103,853,5956
Melbourne,2003,5,5317,806,6123
Melbourne,2003,6,5059,767,5826
Melbourne,2003,7,5233,836,6069
Melbourne,2003,8,5164,884,6048
Melbourne,2003,9,5420,895,6315
Melbourne,2003,10,5540,952,6492
Melbourne,2003,11,5415,968,6383
Melbourne,2003,12,5621,1022,6643
Melbourne,2004,1,5713,1046,6759
Melbourne,2004,2,5425,969,6394
Melbourne,2004,3,5895,1052,6947
Melbourne,2004,4,5649,1057,6706
Melbourne,2004,5,5900,1082,6982
Melbourne,2004,6,5925,1051,6976
Melbourne,2004,7,6169,1155,7324
Melbourne,2004,8,6244,1168,7412
Melbourne,2004,9,6202,1163,7365
Melbourne,2004,10,6279,1206,7485
Melbourne,2004,11,6240,1156,7396
Melbourne,2004,12,6332,1230,7562
Melbourne,2005,1,6122,1217,7339
Melbourne,2005,2,5702,1094,6796
Melbourne,2005,3,6315,1165,7480
Melbourne,2005,4,6115,1104,7219
Melbourne,2005,5,6272,1121,7393
Melbourne,2005,6,6140,1081,7221
Melbourne,2005,7,6296,1137,7433
Melbourne,2005,8,6397,1103,7500
Melbourne,2005,9,6351,1075,7426
Melbourne,2005,10,6348,1109,7457
Melbourne,2005,11,6195,1059,7254
Melbourne,2005,12,6349,1105,7454
Melbourne,2006,1,6129,1099,7228
Melbourne,2006,2,5857,994,6851
Melbourne,2006,3,6559,1066,7625
Melbourne,2006,4,6057,949,7006
Melbourne,2006,5,6382,963,7345
Melbourne,2006,6,6165,942,7107
Melbourne,2006,7,6374,986,7360
Melbourne,2006,8,6411,984,7395
Melbourne,2006,9,6361,968,7329
Melbourne,2006,10,6568,969,7537
Melbourne,2006,11,6386,1009,7395
Melbourne,2006,12,6413,1056,7469
Melbourne,2007,1,6217,1055,7272
Melbourne,2007,2,5882,972,6854
Melbourne,2007,3,6546,1053,7599
Melbourne,2007,4,6152,974,7126
Melbourne,2007,5,6451,982,7433
Melbourne,2007,6,6179,959,7138
Melbourne,2007,7,6425,997,7422
Melbourne,2007,8,6538,999,7537
Melbourne,2007,9,6382,980,7362
Melbourne,2007,10,6667,1030,7697
Melbourne,2007,11,6577,1051,7628
Melbourne,2007,12,6766,1077,7843
Melbourne,2008,1,6845,1078,7923
Melbourne,2008,2,6666,1007,7673
Melbourne,2008,3,7083,1064,8147
Melbourne,2008,4,6939,1050,7989
Melbourne,2008,5,7073,1084,8157
Melbourne,2008,6,6678,1040,7718
Melbourne,2008,7,6988,1094,8082
Melbourne,2008,8,6854,1064,7918
Melbourne,2008,9,6921,1047,7968
Melbourne,2008,10,7263,1100,8363
Melbourne,2008,11,6925,1096,8021
Melbourne,2008,12,6901,1218,8119
Melbourne,2009,1,6716,1222,7938
Melbourne,2009,2,6050,1086,7136
Melbourne,2009,3,6820,1206,8026
Melbourne,2009,4,6662,1159,7821
Melbourne,2009,5,6452,1151,7603
Melbourne,2009,6,6288,1187,7475
Melbourne,2009,7,6712,1261,7973
Melbourne,2009,8,6494,1251,7745
Melbourne,2009,9,6489,1202,7691
Melbourne,2009,10,6859,1253,8112
Melbourne,2009,11,6698,1236,7934
Melbourne,2009,12,6735,1342,8077
Melbourne,2010,1,6737,1371,8108
Melbourne,2010,2,6394,1236,7630
Melbourne,2010,3,7292,1340,8632
Melbourne,2010,4,7174,1238,8412
Melbourne,2010,5,7224,1272,8496
Melbourne,2010,6,6977,1277,8254
Melbourne,2010,7,7515,1366,8881
Melbourne,2010,8,7318,1349,8667
Melbourne,2010,9,7279,1332,8611
Melbourne,2010,10,7477,1369,8846
Melbourne,2010,11,7216,1337,8553
Melbourne,2010,12,7598,1482,9080
Melbourne,2011,1,7429,1515,8944
Melbourne,2011,2,6490,1326,7816
Melbourne,2011,3,7426,1413,8839
Melbourne,2011,4,7150,1384,8534
Melbourne,2011,5,7233,1391,8624
Melbourne,2011,6,6605,1270,7875
Melbourne,2011,7,6996,1440,8436
Melbourne,2011,8,7078,1408,8486
Melbourne,2011,9,6985,1372,8357
Melbourne,2011,10,7114,1410,8524
Melbourne,2011,11,7055,1431,8486
Melbourne,2011,12,7275,1545,8820
Melbourne,2012,1,7163,1581,8744
Melbourne,2012,2,6935,1384,8319
Melbourne,2012,3,7523,1474,8997
Melbourne,2012,4,7253,1439,8692
Melbourne,2012,5,7228,1409,8637
Melbourne,2012,6,6871,1400,8271
Melbourne,2012,7,7710,1506,9216
Melbourne,2012,8,7628,1507,9135
Melbourne,2012,9,7497,1463,8960
Melbourne,2012,10,7753,1512,9265
Melbourne,2012,11,7655,1466,9121
Melbourne,2012,12,7545,1583,9128
Melbourne,2013,1,7465,1599,9064
Melbourne,2013,2,6774,1354,8128
Melbourne,2013,3,7623,1537,9160
Melbourne,2013,4,7485,1501,8986
Melbourne,2013,5,7408,1499,8907
Melbourne,2013,6,7109,1466,8575
Melbourne,2013,7,7902,1620,9522
Melbourne,2013,8,7701,1604,9305
Melbourne,2013,9,7667,1577,9244
Melbourne,2013,10,7965,1661,9626
Melbourne,2013,11,7616,1586,9202
Melbourne,2013,12,7765,1769,9534
Melbourne,2014,1,7618,1797,9415
Melbourne,2014,2,6941,1503,8444
Melbourne,2014,3,7756,1657,9413
Melbourne,2014,4,7609,1641,9250
Melbourne,2014,5,7687,1633,9320
Melbourne,2014,6,7461,1636,9097
Melbourne,2014,7,7961,1780,9741
Melbourne,2014,8,7778,1717,9495
Melbourne,2014,9,7818,1675,9493
Melbourne,2014,10,8179,1706,9885
Melbourne,2014,11,7636,1641,9277
Melbourne,2014,12,7915,1854,9769
Melbourne,2015,1,7761,1901,9662
Melbourne,2015,2,7099,1604,8703
Melbourne,2015,3,8034,1746,9780
Melbourne,2015,4,7830,1714,9544
Melbourne,2015,5,7789,1648,9437
Melbourne,2015,6,7721,1660,9381
Melbourne,2015,7,8306,1815,10121
Melbourne,2015,8,8054,1763,9817
Melbourne,2015,9,8052,1724,9776
Melbourne,2015,10,8304,1822,10126
Melbourne,2015,11,7931,1760,9691
Melbourne,2015,12,8127,2006,10133
Melbourne,2016,1,7858,2056,9914
Melbourne,2016,2,7552,1791,9343
Melbourne,2016,3,8130,1866,9996
Melbourne,2016,4,7868,1796,9664
Melbourne,2016,5,7712,1767,9479
Melbourne,2016,6,7531,1757,9288
Melbourne,2016,7,8284,1914,10198
Melbourne,2016,8,8159,1821,9980
Melbourne,2016,9,8198,1784,9982
Melbourne,2016,10,8254,1873,10127
Melbourne,2016,11,7973,1818,9791
Melbourne,2016,12,8139,2105,10244
Melbourne,2017,1,7996,2137,10133
Melbourne,2017,2,7281,1788,9069
Melbourne,2017,3,8172,1882,10054
Melbourne,2017,4,7793,1882,9675
Melbourne,2017,5,7833,1775,9608
Melbourne,2017,6,7634,1825,9459
Melbourne,2017,7,8281,2042,10323
Melbourne,2017,8,8092,1914,10006
Melbourne,2017,9,8055,1930,9985
Melbourne,2017,10,8327,2018,10345
Melbourne,2017,11,8115,1982,10097
Melbourne,2017,12,8196,2268,10464
Melbourne,2018,1,8094,2303,10397
Melbourne,2018,2,7337,1976,9313
Melbourne,2018,3,8260,2124,10384
Melbourne,2018,4,7961,2077,10038
Melbourne,2018,5,7814,2006,9820
Melbourne,2018,6,7480,2074,9554
Melbourne,2018,7,8197,2272,10469
Melbourne,2018,8,7928,2184,10112
Melbourne,2018,9,7891,2147,10038
Melbourne,2018,10,8426,2224,10650
Melbourne,2018,11,7967,2192,10159
Melbourne,2018,12,7974,2350,10324
Melbourne,2019,1,8105,2384,10489
Melbourne,2019,2,7303,2068,9371
Melbourne,2019,3,8118,2180,10298
Melbourne,2019,4,8007,2130,10137
Melbourne,2019,5,7866,2031,9897
Melbourne,2019,6,7511,2078,9589
Melbourne,2019,7,8327,2249,10576
Melbourne,2019,8,7901,2133,10034
Melbourne,2019,9,7929,2074,10003
Melbourne,2019,10,8396,2143,10539
Melbourne,2019,11,7842,2164,10006
Melbourne,2019,12,8050,2403,10453
Melbourne,2020,1,7760,2454,10214
Melbourne,2020,2,7249,1899,9148
Melbourne,2020,3,6188,1466,7654
Melbourne,2020,4,790,295,1085
Melbourne,2020,5,713,389,1102
Melbourne,2020,6,985,326,1311
Melbourne,2020,7,898,367,1265
Melbourne,2020,8,554,372,926
Melbourne,2020,9,648,383,1031
Melbourne,2020,10,648,400,1048
Melbourne,2020,11,979,429,1408
Melbourne,2020,12,3571,469,4040
Melbourne,2021,1,3195,437,3632
Melbourne,2021,2,2587,368,2955
Melbourne,2021,3,4547,426,4973
Melbourne,2021,4,6238,516,6754
Melbourne,2021,5,6127,622,6749
Melbourne,2021,6,2879,521,3400
Melbourne,2021,7,2964,630,3594
Melbourne,2021,8,1184,508,1692
Melbourne,2021,9,981,507,1488
Melbourne,2021,10,980,540,1520
Melbourne,2021,11,2142,576,2718
Melbourne,2021,12,5360,727,6087
Melbourne,2022,1,5429,729,6158
Melbourne,2022,2,4490,722,5212
Melbourne,2022,3,6453,867,7320
Melbourne,2022,4,7693,976,8669
Melbourne,2022,5,7552,1066,8618
Melbourne,2022,6,7305,1178,8483
Melbourne,2022,7,7122,1401,8523
Melbourne,2022,8,6964,1373,8337
Melbourne,2022,9,7026,1382,8408
Melbourne,2022,10,7190,1464,8654
Melbourne,2022,11,7149,1620,8769
Melbourne,2022,12,7430,1917,9347
Melbourne,2023,1,7499,2022,9521
Melbourne,2023,2,6671,1760,8431
Melbourne,2023,3,7673,1930,9603
Melbourne,2023,4,7555,2035,9590
Melbourne,2023,5,7790,1962,9752
Melbourne,2023,6,7389,2023,9412
Melbourne,2023,7,7699,2234,9933
Melbourne,2023,8,7838,2171,10009
Melbourne,2023,9,7665,2170,9835
Melbourne,2023,10,7912,2198,10110
Melbourne,2023,11,7628,2187,9815
Melbourne,2023,12,7722,2537,10259
Melbourne,2024,1,8014,2603,10617
Melbourne,2024,2,7468,2267,9735
Melbourne,2024,3,7993,2344,10337
Melbourne,2024,4,7956,2208,10164
Melbourne,2024,5,7686,2136,9822
Melbourne,2024,6,7341,2172,9513
Melbourne,2024,7,7892,2365,10257
Melbourne,2024,8,7264,2308,9572
Melbourne,2024,9,7480,2246,9726
Melbourne,2024,10,7685,2295,9980
Melbourne,2024,11,7178,2315,9493
Melbourne,2024,12,7423,2743,10166
Newcastle,1985,1,412,0,412
Newcastle,1985,2,417,0,417
Newcastle,1985,3,447,0,447
Newcastle,1985,4,419,0,419
Newcastle,1985,5,458,0,458
Newcastle,1985,6,418,0,418
Newcastle,1985,7,415,0,415
Newcastle,1985,8,436,0,436
Newcastle,1985,9,444,0,444
Newcastle,1985,10,475,0,475
Newcastle,1985,11,450,0,450
Newcastle,1985,12,432,0,432
Newcastle,1986,1,380,0,380
Newcastle,1986,2,428,0,428
Newcastle,1986,3,458,0,458
Newcastle,1986,4,391,0,391
Newcastle,1986,5,432,0,432
Newcastle,1986,6,384,0,384
Newcastle,1986,7,399,0,399
Newcastle,1986,8,389,0,389
Newcastle,1986,9,396,0,396
Newcastle,1986,10,390,0,390
Newcastle,1986,11,385,0,385
Newcastle,1986,12,372,0,372
Newcastle,1987,1,327,0,327
Newcastle,1987,2,346,0,346
Newcastle,1987,3,357,0,357
Newcastle,1987,4,334,0,334
Newcastle,1987,5,349,0,349
Newcastle,1987,6,354,0,354
Newcastle,1987,7,366,0,366
Newcastle,1987,8,362,0,362
Newcastle,1987,9,347,0,347
Newcastle,1987,10,344,0,344
Newcastle,1987,11,364,0,364
Newcastle,1987,12,350,0,350
Newcastle,1988,1,295,0,295
Newcastle,1988,2,287,0,287
Newcastle,1988,3,315,0,315
Newcastle,1988,4,285,0,285
Newcastle,1988,5,309,0,309
Newcastle,1988,6,295,0,295
Newcastle,1988,7,313,0,313
Newcastle,1988,8,399,0,399
Newcastle,1988,9,389,0,389
Newcastle,1988,10,393,0,393
Newcastle,1988,11,389,0,389
Newcastle,1988,12,312,0,312
Newcastle,1989,1,258,0,258
Newcastle,1989,2,238,0,238
Newcastle,1989,3,255,0,255
Newcastle,1989,4,197,0,197
Newcastle,1989,5,210,0,210
Newcastle,1989,6,213,0,213
Newcastle,1989,7,74,0,74
Newcastle,1989,8,45,0,45
Newcastle,1989,9,215,0,215
Newcastle,1989,10,274,0,274
Newcastle,1989,11,281,0,281
Newcastle,1989,12,258,0,258
Newcastle,1990,1,255,0,255
Newcastle,1990,2,208,0,208
Newcastle,1990,3,274,0,274
Newcastle,1990,4,291,0,291
Newcastle,1990,5,418,0,418
Newcastle,1990,6,402,0,402
Newcastle,1990,7,415,0,415
Newcastle,1990,8,383,0,383
Newcastle,1990,9,453,0,453
Newcastle,1990,10,514,0,514
Newcastle,1990,11,422,0,422
Newcastle,1990,12,397,0,397
Newcastle,1991,1,442,0,442
Newcastle,1991,2,413,0,413
Newcastle,1991,3,463,0,463
Newcastle,1991,4,488,0,488
Newcastle,1991,5,462,0,462
Newcastle,1991,6,421,0,421
Newcastle,1991,7,456,0,456
Newcastle,1991,8,446,0,446
Newcastle,1991,9,438,0,438
Newcastle,1991,10,415,0,415
Newcastle,1991,11,411,0,411
Newcastle,1991,12,361,0,361
Newcastle,1992,1,372,0,372
Newcastle,1992,2,278,0,278
Newcastle,1992,3,332,0,332
Newcastle,1992,4,319,0,319
Newcastle,1992,5,432,0,432
Newcastle,1992,6,421,0,421
Newcastle,1992,7,442,0,442
Newcastle,1992,8,409,0,409
Newcastle,1992,9,413,0,413
Newcastle,1992,10,424,0,424
Newcastle,1992,11,422,0,422
Newcastle,1992,12,407,0,407
Newcastle,1993,1,371,0,371
Newcastle,1993,2,356,0,356
Newcastle,1993,3,390,0,390
Newcastle,1993,4,372,0,372
Newcastle,1993,5,377,0,377
Newcastle,1993,6,359,0,359
Newcastle,1993,7,365,0,365
Newcastle,1993,8,382,0,382
Newcastle,1993,9,391,0,391
Newcastle,1993,10,385,0,385
Newcastle,1993,11,421,0,421
Newcastle,1993,12,465,0,465
Newcastle,1994,1,470,0,470
Newcastle,1994,2,443,0,443
Newcastle,1994,3,492,0,492
Newcastle,1994,4,455,0,455
Newcastle,1994,5,468,0,468
Newcastle,1994,6,460,0,460
Newcastle,1994,7,468,0,468
Newcastle,1994,8,447,0,447
Newcastle,1994,9,437,0,437
Newcastle,1994,10,468,0,468
Newcastle,1994,11,439,0,439
Newcastle,1994,12,472,0,472
Newcastle,1995,1,487,0,487
Newcastle,1995,2,491,0,491
Newcastle,1995,3,539,0,539
Newcastle,1995,4,519,0,519
Newcastle,1995,5,530,0,530
Newcastle,1995,6,497,0,497
Newcastle,1995,7,457,0,457
Newcastle,1995,8,419,0,419
Newcastle,1995,9,400,0,400
Newcastle,1995,10,479,0,479
Newcastle,1995,11,520,0,520
Newcastle,1995,12,533,0,533
Newcastle,1996,1,520,0,520
Newcastle,1996,2,502,0,502
Newcastle,1996,3,518,0,518
Newcastle,1996,4,545,0,545
Newcastle,1996,5,573,0,573
Newcastle,1996,6,552,0,552
Newcastle,1996,7,519,0,519
Newcastle,1996,8,467,0,467
Newcastle,1996,9,464,0,464
Newcastle,1996,10,481,0,481
Newcastle,1996,11,491,0,491
Newcastle,1996,12,476,0,476
Newcastle,1997,1,352,0,352
Newcastle,1997,2,458,0,458
Newcastle,1997,3,524,0,524
Newcastle,1997,4,526,0,526
Newcastle,1997,5,595,0,595
Newcastle,1997,6,629,0,629
Newcastle,1997,7,823,0,823
Newcastle,1997,8,739,0,739
Newcastle,1997,9,731,0,731
Newcastle,1997,10,740,0,740
Newcastle,1997,11,680,0,680
Newcastle,1997,12,715,0,715
Newcastle,1998,1,682,0,682
Newcastle,1998,2,628,0,628
Newcastle,1998,3,700,0,700
Newcastle,1998,4,683,0,683
Newcastle,1998,5,685,0,685
Newcastle,1998,6,690,0,690
Newcastle,1998,7,757,0,757
Newcastle,1998,8,751,0,751
Newcastle,1998,9,750,0,750
Newcastle,1998,10,757,0,757
Newcastle,1998,11,687,0,687
Newcastle,1998,12,758,0,758
Newcastle,1999,1,721,0,721
Newcastle,1999,2,681,0,681
Newcastle,1999,3,762,0,762
Newcastle,1999,4,723,0,723
Newcastle,1999,5,727,0,727
Newcastle,1999,6,719,0,719
Newcastle,1999,7,740,0,740
Newcastle,1999,8,742,0,742
Newcastle,1999,9,732,0,732
Newcastle,1999,10,731,0,731
Newcastle,1999,11,669,0,669
Newcastle,1999,12,714,0,714
Newcastle,2000,1,649,0,649
Newcastle,2000,2,628,0,628
Newcastle,2000,3,711,0,711
Newcastle,2000,4,689,0,689
Newcastle,2000,5,688,0,688
Newcastle,2000,6,686,0,686
Newcastle,2000,7,701,0,701
Newcastle,2000,8,757,0,757
Newcastle,2000,9,688,0,688
Newcastle,2000,10,741,0,741
Newcastle,2000,11,721,0,721
Newcastle,2000,12,695,0,695
Newcastle,2001,1,694,0,694
Newcastle,2001,2,618,0,618
Newcastle,2001,3,734,0,734
Newcastle,2001,4,684,0,684
Newcastle,2001,5,649,0,649
Newcastle,2001,6,494,0,494
Newcastle,2001,7,512,0,512
Newcastle,2001,8,548,0,548
Newcastle,2001,9,531,0,531
Newcastle,2001,10,619,0,619
Newcastle,2001,11,554,0,554
Newcastle,2001,12,505,5,510
Newcastle,2002,1,519,9,528
Newcastle,2002,2,518,9,527
Newcastle,2002,3,559,8,567
Newcastle,2002,4,541,9,550
Newcastle,2002,5,560,7,567
Newcastle,2002,6,466,8,474
Newcastle,2002,7,459,9,468
Newcastle,2002,8,372,8,380
Newcastle,2002,9,385,1,386
Newcastle,2002,10,359,0,359
Newcastle,2002,11,341,0,341
Newcastle,2002,12,410,0,410
Newcastle,2003,1,427,0,427
Newcastle,2003,2,390,0,390
Newcastle,2003,3,427,0,427
Newcastle,2003,4,423,0,423
Newcastle,2003,5,477,0,477
Newcastle,2003,6,453,0,453
Newcastle,2003,7,491,0,491
Newcastle,2003,8,496,0,496
Newcastle,2003,9,482,0,482
Newcastle,2003,10,508,0,508
Newcastle,2003,11,500,0,500
Newcastle,2003,12,393,0,393
Newcastle,2004,1,398,0,398
Newcastle,2004,2,401,0,401
Newcastle,2004,3,427,0,427
Newcastle,2004,4,400,0,400
Newcastle,2004,5,439,0,439
Newcastle,2004,6,490,0,490
Newcastle,2004,7,478,0,478
Newcastle,2004,8,488,0,488
Newcastle,2004,9,533,0,533
Newcastle,2004,10,508,0,508
Newcastle,2004,11,543,0,543
Newcastle,2004,12,568,0,568
Newcastle,2005,1,502,0,502
Newcastle,2005,2,561,0,561
Newcastle,2005,3,623,0,623
Newcastle,2005,4,627,0,627
Newcastle,2005,5,697,0,697
Newcastle,2005,6,609,0,609
Newcastle,2005,7,625,0,625
Newcastle,2005,8,643,0,643
Newcastle,2005,9,676,0,676
Newcastle,2005,10,642,0,642
Newcastle,2005,11,636,0,636
Newcastle,2005,12,627,0,627
Newcastle,2006,1,530,0,530
Newcastle,2006,2,562,0,562
Newcastle,2006,3,639,0,639
Newcastle,2006,4,628,0,628
Newcastle,2006,5,703,0,703
Newcastle,2006,6,631,0,631
Newcastle,2006,7,558,0,558
Newcastle,2006,8,646,0,646
Newcastle,2006,9,687,0,687
Newcastle,2006,10,706,0,706
Newcastle,2006,11,729,0,729
Newcastle,2006,12,636,0,636
Newcastle,2007,1,663,0,663
Newcastle,2007,2,646,0,646
Newcastle,2007,3,674,0,674
Newcastle,2007,4,622,0,622
Newcastle,2007,5,704,0,704
Newcastle,2007,6,649,0,649
Newcastle,2007,7,669,0,669
Newcastle,2007,8,748,0,748
Newcastle,2007,9,660,0,660
Newcastle,2007,10,709,0,709
Newcastle,2007,11,654,0,654
Newcastle,2007,12,652,0,652
Newcastle,2008,1,610,0,610
Newcastle,2008,2,627,0,627
Newcastle,2008,3,599,0,599
Newcastle,2008,4,619,0,619
Newcastle,2008,5,591,0,591
Newcastle,2008,6,640,0,640
Newcastle,2008,7,679,0,679
Newcastle,2008,8,718,0,718
Newcastle,2008,9,670,0,670
Newcastle,2008,10,720,0,720
Newcastle,2008,11,636,0,636
Newcastle,2008,12,619,0,619
Newcastle,2009,1,604,0,604
Newcastle,2009,2,592,0,592
Newcastle,2009,3,642,0,642
Newcastle,2009,4,594,0,594
Newcastle,2009,5,603,0,603
Newcastle,2009,6,588,0,588
Newcastle,2009,7,632,0,632
Newcastle,2009,8,594,0,594
Newcastle,2009,9,623,0,623
Newcastle,2009,10,546,0,546
Newcastle,2009,11,560,0,560
Newcastle,2009,12,550,0,550
Newcastle,2010,1,465,0,465
Newcastle,2010,2,520,0,520
Newcastle,2010,3,612,0,612
Newcastle,2010,4,607,0,607
Newcastle,2010,5,603,0,603
Newcastle,2010,6,583,0,583
Newcastle,2010,7,634,0,634
Newcastle,2010,8,613,0,613
Newcastle,2010,9,614,0,614
Newcastle,2010,10,645,0,645
Newcastle,2010,11,631,0,631
Newcastle,2010,12,629,0,629
Newcastle,2011,1,549,0,549
Newcastle,2011,2,549,0,549
Newcastle,2011,3,640,0,640
Newcastle,2011,4,612,0,612
Newcastle,2011,5,613,0,613
Newcastle,2011,6,590,0,590
Newcastle,2011,7,663,0,663
Newcastle,2011,8,656,0,656
Newcastle,2011,9,641,0,641
Newcastle,2011,10,631,0,631
Newcastle,2011,11,716,0,716
Newcastle,2011,12,678,0,678
Newcastle,2012,1,643,0,643
Newcastle,2012,2,663,0,663
Newcastle,2012,3,727,0,727
Newcastle,2012,4,711,0,711
Newcastle,2012,5,741,0,741
Newcastle,2012,6,695,0,695
Newcastle,2012,7,738,0,738
Newcastle,2012,8,753,0,753
Newcastle,2012,9,713,0,713
Newcastle,2012,10,754,0,754
Newcastle,2012,11,752,0,752
Newcastle,2012,12,710,0,710
Newcastle,2013,1,654,0,654
Newcastle,2013,2,653,0,653
Newcastle,2013,3,733,0,733
Newcastle,2013,4,703,0,703
Newcastle,2013,5,701,0,701
Newcastle,2013,6,669,0,669
Newcastle,2013,7,730,0,730
Newcastle,2013,8,729,0,729
Newcastle,2013,9,728,0,728
Newcastle,2013,10,724,0,724
Newcastle,2013,11,691,0,691
Newcastle,2013,12,633,0,633
Newcastle,2014,1,555,0,555
Newcastle,2014,2,498,0,498
Newcastle,2014,3,562,0,562
Newcastle,2014,4,543,0,543
Newcastle,2014,5,531,0,531
Newcastle,2014,6,509,0,509
Newcastle,2014,7,564,0,564
Newcastle,2014,8,548,0,548
Newcastle,2014,9,535,0,535
Newcastle,2014,10,560,0,560
Newcastle,2014,11,550,0,550
Newcastle,2014,12,534,0,534
Newcastle,2015,1,485,0,485
Newcastle,2015,2,476,0,476
Newcastle,2015,3,542,0,542
Newcastle,2015,4,532,0,532
Newcastle,2015,5,546,0,546
Newcastle,2015,6,592,0,592
Newcastle,2015,7,677,0,677
Newcastle,2015,8,670,0,670
Newcastle,2015,9,662,0,662
Newcastle,2015,10,687,0,687
Newcastle,2015,11,643,0,643
Newcastle,2015,12,637,0,637
Newcastle,2016,1,565,0,565
Newcastle,2016,2,658,0,658
Newcastle,2016,3,725,0,725
Newcastle,2016,4,655,0,655
Newcastle,2016,5,719,0,719
Newcastle,2016,6,708,0,708
Newcastle,2016,7,765,0,765
Newcastle,2016,8,792,0,792
Newcastle,2016,9,777,0,777
Newcastle,2016,10,774,0,774
Newcastle,2016,11,760,0,760
Newcastle,2016,12,744,0,744
Newcastle,2017,1,689,0,689
Newcastle,2017,2,686,0,686
Newcastle,2017,3,795,0,795
Newcastle,2017,4,729,0,729
Newcastle,2017,5,772,0,772
Newcastle,2017,6,739,0,739
Newcastle,2017,7,762,0,762
Newcastle,2017,8,773,0,773
Newcastle,2017,9,704,0,704
Newcastle,2017,10,743,0,743
Newcastle,2017,11,733,0,733
Newcastle,2017,12,678,0,678
Newcastle,2018,1,559,0,559
Newcastle,2018,2,591,0,591
Newcastle,2018,3,599,0,599
Newcastle,2018,4,562,0,562
Newcastle,2018,5,605,0,605
Newcastle,2018,6,563,0,563
Newcastle,2018,7,595,0,595
Newcastle,2018,8,616,0,616
Newcastle,2018,9,575,0,575
Newcastle,2018,10,591,0,591
Newcastle,2018,11,616,4,620
Newcastle,2018,12,573,13,586
Newcastle,2019,1,532,13,545
Newcastle,2019,2,560,6,566
Newcastle,2019,3,608,0,608
Newcastle,2019,4,590,0,590
Newcastle,2019,5,621,0,621
Newcastle,2019,6,580,0,580
Newcastle,2019,7,636,0,636
Newcastle,2019,8,593,0,593
Newcastle,2019,9,606,0,606
Newcastle,2019,10,632,0,632
Newcastle,2019,11,602,4,606
Newcastle,2019,12,554,14,568
Newcastle,2020,1,527,13,540
Newcastle,2020,2,552,5,557
Newcastle,2020,3,450,0,450
Newcastle,2020,4,42,0,42
Newcastle,2020,5,44,0,44
Newcastle,2020,6,58,0,58
Newcastle,2020,7,131,0,131
Newcastle,2020,8,85,0,85
Newcastle,2020,9,71,0,71
Newcastle,2020,10,85,0,85
Newcastle,2020,11,220,0,220
Newcastle,2020,12,416,0,416
Newcastle,2021,1,313,0,313
Newcastle,2021,2,393,0,393
Newcastle,2021,3,477,0,477
Newcastle,2021,4,545,0,545
Newcastle,2021,5,554,0,554
Newcastle,2021,6,492,0,492
Newcastle,2021,7,332,0,332
Newcastle,2021,8,140,0,140
Newcastle,2021,9,100,0,100
Newcastle,2021,10,116,0,116
Newcastle,2021,11,209,0,209
Newcastle,2021,12,424,0,424
Newcastle,2022,1,407,0,407
Newcastle,2022,2,360,0,360
Newcastle,2022,3,501,0,501
Newcastle,2022,4,628,0,628
Newcastle,2022,5,603,0,603
Newcastle,2022,6,573,0,573
Newcastle,2022,7,555,0,555
Newcastle,2022,8,558,0,558
Newcastle,2022,9,580,0,580
Newcastle,2022,10,581,0,581
Newcastle,2022,11,606,0,606
Newcastle,2022,12,554,0,554
Newcastle,2023,1,533,0,533
Newcastle,2023,2,534,0,534
Newcastle,2023,3,602,0,602
Newcastle,2023,4,579,0,579
Newcastle,2023,5,622,0,622
Newcastle,2023,6,588,0,588
Newcastle,2023,7,592,0,592
Newcastle,2023,8,607,0,607
Newcastle,2023,9,597,0,597
Newcastle,2023,10,616,0,616
Newcastle,2023,11,577,0,577
Newcastle,2023,12,557,0,557
Newcastle,2024,1,524,0,524
Newcastle,2024,2,556,0,556
Newcastle,2024,3,574,0,574
Newcastle,2024,4,550,0,550
Newcastle,2024,5,544,0,544
Newcastle,2024,6,503,0,503
Newcastle,2024,7,567,0,567
Newcastle,2024,8,541,0,541
Newcastle,2024,9,532,0,532
Newcastle,2024,10,542,0,542
Newcastle,2024,11,504,0,504
Newcastle,2024,12,501,0,501
Perth,1985,1,1176,124,1300
Perth,1985,2,1028,113,1141
Perth,1985,3,1587,124,1711
Perth,1985,4,1514,118,1632
Perth,1985,5,2002,125,2127
Perth,1985,6,1897,118,2015
Perth,1985,7,1853,118,1971
Perth,1985,8,2025,125,2150
Perth,1985,9,1705,124,1829
Perth,1985,10,1715,126,1841
Perth,1985,11,1742,132,1874
Perth,1985,12,2045,129,2174
Perth,1986,1,2099,141,2240
Perth,1986,2,1629,118,1747
Perth,1986,3,1705,131,1836
Perth,1986,4,1635,129,1764
Perth,1986,5,1502,134,1636
Perth,1986,6,1404,122,1526
Perth,1986,7,1458,133,1591
Perth,1986,8,1418,135,1553
Perth,1986,9,1574,129,1703
Perth,1986,10,1674,156,1830
Perth,1986,11,1680,149,1829
Perth,1986,12,1862,165,2027
Perth,1987,1,1129,175,1304
Perth,1987,2,1036,146,1182
Perth,1987,3,1091,132,1223
Perth,1987,4,1232,132,1364
Perth,1987,5,1183,134,1317
Perth,1987,6,1113,126,1239
Perth,1987,7,1267,134,1401
Perth,1987,8,1231,134,1365
Perth,1987,9,1261,124,1385
Perth,1987,10,1274,143,1417
Perth,1987,11,1205,124,1329
Perth,1987,12,1295,151,1446
Perth,1988,1,1224,151,1375
Perth,1988,2,1113,131,1244
Perth,1988,3,1218,129,1347
Perth,1988,4,1115,120,1235
Perth,1988,5,1165,128,1293
Perth,1988,6,1132,131,1263
Perth,1988,7,1266,134,1400
Perth,1988,8,1239,132,1371
Perth,1988,9,1244,131,1375
Perth,1988,10,1239,134,1373
Perth,1988,11,1185,162,1347
Perth,1988,12,1201,184,1385
Perth,1989,1,1134,185,1319
Perth,1989,2,1023,162,1185
Perth,1989,3,1217,170,1387
Perth,1989,4,1108,165,1273
Perth,1989,5,1179,170,1349
Perth,1989,6,1027,166,1193
Perth,1989,7,1260,174,1434
Perth,1989,8,975,171,1146
Perth,1989,9,516,168,684
Perth,1989,10,641,180,821
Perth,1989,11,774,191,965
Perth,1989,12,988,211,1199
Perth,1990,1,992,217,1209
Perth,1990,2,1020,182,1202
Perth,1990,3,1171,198,1369
Perth,1990,4,1134,192,1326
Perth,1990,5,1207,197,1404
Perth,1990,6,1159,196,1355
Perth,1990,7,1215,197,1412
Perth,1990,8,1156,203,1359
Perth,1990,9,1148,192,1340
Perth,1990,10,1328,206,1534
Perth,1990,11,1299,212,1511
Perth,1990,12,1344,232,1576
Perth,1991,1,1299,231,1530
Perth,1991,2,1180,205,1385
Perth,1991,3,1308,212,1520
Perth,1991,4,1274,219,1493
Perth,1991,5,1321,230,1551
Perth,1991,6,1249,224,1473
Perth,1991,7,1456,227,1683
Perth,1991,8,1416,225,1641
Perth,1991,9,1463,223,1686
Perth,1991,10,1534,229,1763
Perth,1991,11,1442,220,1662
Perth,1991,12,1503,232,1735
Perth,1992,1,1439,237,1676
Perth,1992,2,1302,222,1524
Perth,1992,3,1373,239,1612
Perth,1992,4,1344,235,1579
Perth,1992,5,1318,227,1545
Perth,1992,6,1307,233,1540
Perth,1992,7,1450,251,1701
Perth,1992,8,1346,249,1595
Perth,1992,9,1377,242,1619
Perth,1992,10,1422,261,1683
Perth,1992,11,1359,272,1631
Perth,1992,12,1399,286,1685
Perth,1993,1,1327,290,1617
Perth,1993,2,1202,258,1460
Perth,1993,3,1367,281,1648
Perth,1993,4,1370,291,1661
Perth,1993,5,1467,303,1770
Perth,1993,6,1448,292,1740
Perth,1993,7,1558,310,1868
Perth,1993,8,1516,302,1818
Perth,1993,9,1561,309,1870
Perth,1993,10,1588,323,1911
Perth,1993,11,1562,285,1847
Perth,1993,12,1603,316,1919
Perth,1994,1,1574,316,1890
Perth,1994,2,1425,283,1708
Perth,1994,3,1648,317,1965
Perth,1994,4,1548,296,1844
Perth,1994,5,1631,301,1932
Perth,1994,6,1597,299,1896
Perth,1994,7,1684,312,1996
Perth,1994,8,1681,299,1980
Perth,1994,9,1669,298,1967
Perth,1994,10,1726,313,2039
Perth,1994,11,1710,309,2019
Perth,1994,12,1798,338,2136
Perth,1995,1,1781,327,2108
Perth,1995,2,1620,300,1920
Perth,1995,3,1882,340,2222
Perth,1995,4,1840,324,2164
Perth,1995,5,1911,329,2240
Perth,1995,6,1852,353,2205
Perth,1995,7,1947,343,2290
Perth,1995,8,1896,343,2239
Perth,1995,9,1857,341,2198
Perth,1995,10,1927,347,2274
Perth,1995,11,1920,349,2269
Perth,1995,12,1860,376,2236
Perth,1996,1,1898,381,2279
Perth,1996,2,1774,365,2139
Perth,1996,3,1907,369,2276
Perth,1996,4,1896,364,2260
Perth,1996,5,1964,370,2334
Perth,1996,6,1918,364,2282
Perth,1996,7,2116,375,2491
Perth,1996,8,2083,377,2460
Perth,1996,9,2020,371,2391
Perth,1996,10,2112,371,2483
Perth,1996,11,2014,365,2379
Perth,1996,12,2014,387,2401
Perth,1997,1,2018,391,2409
Perth,1997,2,1856,337,2193
Perth,1997,3,2018,369,2387
Perth,1997,4,1963,353,2316
Perth,1997,5,2029,366,2395
Perth,1997,6,1967,353,2320
Perth,1997,7,2068,373,2441
Perth,1997,8,2073,377,2450
Perth,1997,9,2022,362,2384
Perth,1997,10,2064,366,2430
Perth,1997,11,1942,349,2291
Perth,1997,12,1956,370,2326
Perth,1998,1,1922,382,2304
Perth,1998,2,1774,336,2110
Perth,1998,3,1958,362,2320
Perth,1998,4,1910,378,2288
Perth,1998,5,1935,393,2328
Perth,1998,6,1870,380,2250
Perth,1998,7,1981,401,2382
Perth,1998,8,1903,403,2306
Perth,1998,9,1860,389,2249
Perth,1998,10,1901,398,2299
Perth,1998,11,1810,373,2183
Perth,1998,12,1832,385,2217
Perth,1999,1,1788,401,2189
Perth,1999,2,1661,358,2019
Perth,1999,3,1863,389,2252
Perth,1999,4,1805,397,2202
Perth,1999,5,1870,407,2277
Perth,1999,6,1833,375,2208
Perth,1999,7,1954,417,2371
Perth,1999,8,1956,418,2374
Perth,1999,9,1938,404,2342
Perth,1999,10,1955,421,2376
Perth,1999,11,1920,400,2320
Perth,1999,12,1924,413,2337
Perth,2000,1,1878,432,2310
Perth,2000,2,1765,392,2157
Perth,2000,3,1894,409,2303
Perth,2000,4,1857,413,2270
Perth,2000,5,2002,403,2405
Perth,2000,6,1921,403,2324
Perth,2000,7,1968,434,2402
Perth,2000,8,2001,425,2426
Perth,2000,9,1960,420,2380
Perth,2000,10,2009,427,2436
Perth,2000,11,1934,430,2364
Perth,2000,12,1906,463,2369
Perth,2001,1,1926,428,2354
Perth,2001,2,1742,348,2090
Perth,2001,3,1959,403,2362
Perth,2001,4,1902,390,2292
Perth,2001,5,1954,389,2343
Perth,2001,6,1877,387,2264
Perth,2001,7,1962,381,2343
Perth,2001,8,1972,381,2353
Perth,2001,9,1326,369,1695
Perth,2001,10,1291,363,1654
Perth,2001,11,1423,360,1783
Perth,2001,12,1535,378,1913
Perth,2002,1,1598,358,1956
Perth,2002,2,1479,320,1799
Perth,2002,3,1379,350,1729
Perth,2002,4,1416,332,1748
Perth,2002,5,1459,347,1806
Perth,2002,6,1414,339,1753
Perth,2002,7,1567,348,1915
Perth,2002,8,1570,365,1935
Perth,2002,9,1556,354,1910
Perth,2002,10,1633,365,1998
Perth,2002,11,1633,336,1969
Perth,2002,12,1684,356,2040
Perth,2003,1,1717,349,2066
Perth,2003,2,1575,324,1899
Perth,2003,3,1725,362,2087
Perth,2003,4,1674,353,2027
Perth,2003,5,1728,348,2076
Perth,2003,6,1645,336,1981
Perth,2003,7,1726,370,2096
Perth,2003,8,1638,374,2012
Perth,2003,9,1695,371,2066
Perth,2003,10,1807,389,2196
Perth,2003,11,1707,389,2096
Perth,2003,12,1750,409,2159
Perth,2004,1,1744,406,2150
Perth,2004,2,1599,360,1959
Perth,2004,3,1825,381,2206
Perth,2004,4,1811,372,2183
Perth,2004,5,1896,381,2277
Perth,2004,6,1850,376,2226
Perth,2004,7,1999,407,2406
Perth,2004,8,1971,389,2360
Perth,2004,9,1934,370,2304
Perth,2004,10,1987,402,2389
Perth,2004,11,1897,423,2320
Perth,2004,12,1929,470,2399
Perth,2005,1,1932,469,2401
Perth,2005,2,1720,422,2142
Perth,2005,3,1909,463,2372
Perth,2005,4,1889,450,2339
Perth,2005,5,1957,457,2414
Perth,2005,6,1911,466,2377
Perth,2005,7,1982,478,2460
Perth,2005,8,2038,477,2515
Perth,2005,9,1993,431,2424
Perth,2005,10,1983,434,2417
Perth,2005,11,1986,393,2379
Perth,2005,12,2006,428,2434
Perth,2006,1,1955,430,2385
Perth,2006,2,1850,374,2224
Perth,2006,3,2095,419,2514
Perth,2006,4,1956,409,2365
Perth,2006,5,2051,423,2474
Perth,2006,6,1980,409,2389
Perth,2006,7,2030,428,2458
Perth,2006,8,2094,427,2521
Perth,2006,9,2097,440,2537
Perth,2006,10,2155,453,2608
Perth,2006,11,2106,447,2553
Perth,2006,12,2106,490,2596
Perth,2007,1,2080,493,2573
Perth,2007,2,1919,441,2360
Perth,2007,3,2176,489,2665
Perth,2007,4,2116,482,2598
Perth,2007,5,2212,499,2711
Perth,2007,6,2164,490,2654
Perth,2007,7,2272,515,2787
Perth,2007,8,2322,506,2828
Perth,2007,9,2228,494,2722
Perth,2007,10,2351,513,2864
Perth,2007,11,2315,515,2830
Perth,2007,12,2345,559,2904
Perth,2008,1,2367,558,2925
Perth,2008,2,2261,506,2767
Perth,2008,3,2414,533,2947
Perth,2008,4,2403,510,2913
Perth,2008,5,2477,518,2995
Perth,2008,6,2476,549,3025
Perth,2008,7,2633,566,3199
Perth,2008,8,2586,555,3141
Perth,2008,9,2610,569,3179
Perth,2008,10,2797,593,3390
Perth,2008,11,2719,590,3309
Perth,2008,12,2762,669,3431
Perth,2009,1,2702,696,3398
Perth,2009,2,2460,564,3024
Perth,2009,3,2736,626,3362
Perth,2009,4,2653,621,3274
Perth,2009,5,2735,603,3338
Perth,2009,6,2689,610,3299
Perth,2009,7,2786,663,3449
Perth,2009,8,2702,678,3380
Perth,2009,9,2693,691,3384
Perth,2009,10,2737,714,3451
Perth,2009,11,2631,717,3348
Perth,2009,12,2689,761,3450
Perth,2010,1,2695,763,3458
Perth,2010,2,2465,663,3128
Perth,2010,3,2849,724,3573
Perth,2010,4,2777,718,3495
Perth,2010,5,2821,735,3556
Perth,2010,6,2755,744,3499
Perth,2010,7,2908,791,3699
Perth,2010,8,2932,744,3676
Perth,2010,9,2878,732,3610
Perth,2010,10,2912,755,3667
Perth,2010,11,2875,734,3609
Perth,2010,12,2947,817,3764
Perth,2011,1,2801,854,3655
Perth,2011,2,2587,699,3286
Perth,2011,3,2968,771,3739
Perth,2011,4,2951,800,3751
Perth,2011,5,3068,792,3860
Perth,2011,6,2843,781,3624
Perth,2011,7,3054,836,3890
Perth,2011,8,3116,819,3935
Perth,2011,9,3014,786,3800
Perth,2011,10,2957,794,3751
Perth,2011,11,2948,770,3718
Perth,2011,12,3028,855,3883
Perth,2012,1,3143,887,4030
Perth,2012,2,2968,764,3732
Perth,2012,3,3228,793,4021
Perth,2012,4,3187,804,3991
Perth,2012,5,3250,792,4042
Perth,2012,6,3126,775,3901
Perth,2012,7,3439,867,4306
Perth,2012,8,3407,848,4255
Perth,2012,9,3288,826,4114
Perth,2012,10,3460,840,4300
Perth,2012,11,3270,829,4099
Perth,2012,12,3237,938,4175
Perth,2013,1,3203,940,4143
Perth,2013,2,2839,817,3656
Perth,2013,3,3191,889,4080
Perth,2013,4,3284,864,4148
Perth,2013,5,3346,847,4193
Perth,2013,6,3105,882,3987
Perth,2013,7,3440,1012,4452
Perth,2013,8,3310,992,4302
Perth,2013,9,3289,954,4243
Perth,2013,10,3384,1002,4386
Perth,2013,11,3159,953,4112
Perth,2013,12,3183,1102,4285
Perth,2014,1,3256,1158,4414
Perth,2014,2,2922,942,3864
Perth,2014,3,3218,1019,4237
Perth,2014,4,3230,1037,4267
Perth,2014,5,3210,921,4131
Perth,2014,6,3058,892,3950
Perth,2014,7,3226,1033,4259
Perth,2014,8,3082,966,4048
Perth,2014,9,3154,965,4119
Perth,2014,10,3267,990,4257
Perth,2014,11,3006,896,3902
Perth,2014,12,3153,1020,4173
Perth,2015,1,3039,1066,4105
Perth,2015,2,2827,852,3679
Perth,2015,3,3147,871,4018
Perth,2015,4,3111,909,4020
Perth,2015,5,3085,886,3971
Perth,2015,6,3056,883,3939
Perth,2015,7,3255,921,4176
Perth,2015,8,3079,872,3951
Perth,2015,9,3081,870,3951
Perth,2015,10,3150,899,4049
Perth,2015,11,2999,835,3834
Perth,2015,12,3044,1005,4049
Perth,2016,1,2905,1048,3953
Perth,2016,2,2855,897,3752
Perth,2016,3,3122,941,4063
Perth,2016,4,2987,952,3939
Perth,2016,5,2934,904,3838
Perth,2016,6,2881,906,3787
Perth,2016,7,3019,971,3990
Perth,2016,8,3088,941,4029
Perth,2016,9,3068,939,4007
Perth,2016,10,3090,965,4055
Perth,2016,11,2974,914,3888
Perth,2016,12,2972,989,3961
Perth,2017,1,2896,981,3877
Perth,2017,2,2667,843,3510
Perth,2017,3,3008,914,3922
Perth,2017,4,2838,908,3746
Perth,2017,5,2902,880,3782
Perth,2017,6,2844,888,3732
Perth,2017,7,2951,979,3930
Perth,2017,8,3009,944,3953
Perth,2017,9,2911,942,3853
Perth,2017,10,3023,976,3999
Perth,2017,11,2906,905,3811
Perth,2017,12,2924,1005,3929
Perth,2018,1,2927,1016,3943
Perth,2018,2,2682,834,3516
Perth,2018,3,2922,920,3842
Perth,2018,4,2853,960,3813
Perth,2018,5,2953,913,3866
Perth,2018,6,2801,947,3748
Perth,2018,7,3016,1015,4031
Perth,2018,8,2990,972,3962
Perth,2018,9,2898,948,3846
Perth,2018,10,3088,952,4040
Perth,2018,11,2935,908,3843
Perth,2018,12,2957,1005,3962
Perth,2019,1,2978,991,3969
Perth,2019,2,2698,848,3546
Perth,2019,3,2944,920,3864
Perth,2019,4,2976,863,3839
Perth,2019,5,3052,856,3908
Perth,2019,6,2862,839,3701
Perth,2019,7,3128,903,4031
Perth,2019,8,2968,876,3844
Perth,2019,9,2935,875,3810
Perth,2019,10,3072,918,3990
Perth,2019,11,2839,913,3752
Perth,2019,12,2917,1034,3951
Perth,2020,1,2907,1045,3952
Perth,2020,2,2697,875,3572
Perth,2020,3,2554,598,3152
Perth,2020,4,562,91,653
Perth,2020,5,392,105,497
Perth,2020,6,529,96,625
Perth,2020,7,820,107,927
Perth,2020,8,878,119,997
Perth,2020,9,1155,144,1299
Perth,2020,10,1321,138,1459
Perth,2020,11,1495,118,1613
Perth,2020,12,1944,141,2085
Perth,2021,1,1698,112,1810
Perth,2021,2,1500,105,1605
Perth,2021,3,2149,127,2276
Perth,2021,4,2270,132,2402
Perth,2021,5,2456,168,2624
Perth,2021,6,2241,175,2416
Perth,2021,7,1901,193,2094
Perth,2021,8,1812,178,1990
Perth,2021,9,1931,179,2110
Perth,2021,10,1918,181,2099
Perth,2021,11,1998,175,2173
Perth,2021,12,1824,173,1997
Perth,2022,1,1385,166,1551
Perth,2022,2,1516,173,1689
Perth,2022,3,2051,228,2279
Perth,2022,4,2374,274,2648
Perth,2022,5,2640,332,2972
Perth,2022,6,2688,418,3106
Perth,2022,7,2675,538,3213
Perth,2022,8,2748,518,3266
Perth,2022,9,2694,538,3232
Perth,2022,10,2711,579,3290
Perth,2022,11,2699,646,3345
Perth,2022,12,2814,716,3530
Perth,2023,1,2863,748,3611
Perth,2023,2,2540,659,3199
Perth,2023,3,2897,709,3606
Perth,2023,4,2778,705,3483
Perth,2023,5,2937,711,3648
Perth,2023,6,2831,735,3566
Perth,2023,7,2879,815,3694
Perth,2023,8,3014,836,3850
Perth,2023,9,2939,832,3771
Perth,2023,10,3086,846,3932
Perth,2023,11,3030,829,3859
Perth,2023,12,3006,997,4003
Perth,2024,1,3135,1037,4172
Perth,2024,2,2749,933,3682
Perth,2024,3,2994,955,3949
Perth,2024,4,3203,991,4194
Perth,2024,5,3215,1002,4217
Perth,2024,6,2989,1040,4029
Perth,2024,7,3350,1106,4456
Perth,2024,8,3225,1076,4301
Perth,2024,9,3185,1106,4291
Perth,2024,10,3287,1107,4394
Perth,2024,11,3100,1020,4120
Perth,2024,12,3197,1186,4383
Proserpine,2009,1,62,0,62
Proserpine,2009,2,53,0,53
Proserpine,2009,3,62,0,62
Proserpine,2009,4,60,0,60
Proserpine,2009,5,62,0,62
Proserpine,2009,6,60,0,60
Proserpine,2009,7,62,0,62
Proserpine,2009,8,62,0,62
Proserpine,2009,9,60,0,60
Proserpine,2009,10,63,0,63
Proserpine,2009,11,60,0,60
Proserpine,2009,12,62,0,62
Proserpine,2010,1,61,0,61
Proserpine,2010,2,56,0,56
Proserpine,2010,3,59,0,59
Proserpine,2010,4,60,0,60
Proserpine,2010,5,63,0,63
Proserpine,2010,6,60,0,60
Proserpine,2010,7,62,0,62
Proserpine,2010,8,62,0,62
Proserpine,2010,9,58,0,58
Proserpine,2010,10,62,0,62
Proserpine,2010,11,60,0,60
Proserpine,2010,12,61,0,61
Proserpine,2011,1,61,0,61
Proserpine,2011,2,53,0,53
Proserpine,2011,3,57,0,57
Proserpine,2011,4,60,0,60
Proserpine,2011,5,57,0,57
Proserpine,2011,6,56,0,56
Proserpine,2011,7,62,0,62
Proserpine,2011,8,65,0,65
Proserpine,2011,9,60,0,60
Proserpine,2011,10,62,0,62
Proserpine,2011,11,60,0,60
Proserpine,2011,12,62,0,62
Proserpine,2012,1,61,0,61
Proserpine,2012,2,61,0,61
Proserpine,2012,3,82,0,82
Proserpine,2012,4,79,0,79
Proserpine,2012,5,76,0,76
Proserpine,2012,6,77,0,77
Proserpine,2012,7,85,0,85
Proserpine,2012,8,85,0,85
Proserpine,2012,9,80,0,80
Proserpine,2012,10,85,0,85
Proserpine,2012,11,82,0,82
Proserpine,2012,12,83,0,83
Proserpine,2013,1,84,0,84
Proserpine,2013,2,72,0,72
Proserpine,2013,3,81,0,81
Proserpine,2013,4,80,0,80
Proserpine,2013,5,76,0,76
Proserpine,2013,6,70,0,70
Proserpine,2013,7,85,0,85
Proserpine,2013,8,84,0,84
Proserpine,2013,9,81,0,81
Proserpine,2013,10,83,0,83
Proserpine,2013,11,77,0,77
Proserpine,2013,12,83,0,83
Proserpine,2014,1,79,0,79
Proserpine,2014,2,71,0,71
Proserpine,2014,3,79,0,79
Proserpine,2014,4,94,0,94
Proserpine,2014,5,94,0,94
Proserpine,2014,6,89,0,89
Proserpine,2014,7,97,0,97
Proserpine,2014,8,97,0,97
Proserpine,2014,9,94,0,94
Proserpine,2014,10,98,0,98
Proserpine,2014,11,93,0,93
Proserpine,2014,12,99,0,99
Proserpine,2015,1,98,0,98
Proserpine,2015,2,84,0,84
Proserpine,2015,3,93,0,93
Proserpine,2015,4,96,0,96
Proserpine,2015,5,92,0,92
Proserpine,2015,6,95,0,95
Proserpine,2015,7,118,0,118
Proserpine,2015,8,114,0,114
Proserpine,2015,9,112,0,112
Proserpine,2015,10,115,0,115
Proserpine,2015,11,112,0,112
Proserpine,2015,12,117,0,117
Proserpine,2016,1,115,0,115
Proserpine,2016,2,104,0,104
Proserpine,2016,3,107,0,107
Proserpine,2016,4,89,0,89
Proserpine,2016,5,84,0,84
Proserpine,2016,6,83,0,83
Proserpine,2016,7,93,0,93
Proserpine,2016,8,93,0,93
Proserpine,2016,9,93,0,93
Proserpine,2016,10,98,0,98
Proserpine,2016,11,89,0,89
Proserpine,2016,12,113,0,113
Proserpine,2017,1,106,0,106
Proserpine,2017,2,80,0,80
Proserpine,2017,3,78,0,78
Proserpine,2017,4,134,0,134
Proserpine,2017,5,124,0,124
Proserpine,2017,6,127,0,127
Proserpine,2017,7,140,0,140
Proserpine,2017,8,136,0,136
Proserpine,2017,9,140,0,140
Proserpine,2017,10,142,0,142
Proserpine,2017,11,141,0,141
Proserpine,2017,12,148,0,148
Proserpine,2018,1,152,0,152
Proserpine,2018,2,123,0,123
Proserpine,2018,3,123,0,123
Proserpine,2018,4,123,0,123
Proserpine,2018,5,105,0,105
Proserpine,2018,6,109,0,109
Proserpine,2018,7,129,0,129
Proserpine,2018,8,118,0,118
Proserpine,2018,9,127,0,127
Proserpine,2018,10,141,0,141
Proserpine,2018,11,122,0,122
Proserpine,2018,12,136,0,136
Proserpine,2019,1,138,0,138
Proserpine,2019,2,106,0,106
Proserpine,2019,3,119,0,119
Proserpine,2019,4,133,0,133
Proserpine,2019,5,117,0,117
Proserpine,2019,6,107,0,107
Proserpine,2019,7,130,0,130
Proserpine,2019,8,120,0,120
Proserpine,2019,9,125,0,125
Proserpine,2019,10,129,0,129
Proserpine,2019,11,119,0,119
Proserpine,2019,12,132,0,132
Proserpine,2020,1,137,0,137
Proserpine,2020,2,92,0,92
Proserpine,2020,3,86,0,86
Proserpine,2020,4,0,0,0
Proserpine,2020,5,0,0,0
Proserpine,2020,6,12,0,12
Proserpine,2020,7,75,0,75
Proserpine,2020,8,64,0,64
Proserpine,2020,9,69,0,69
Proserpine,2020,10,81,0,81
Proserpine,2020,11,73,0,73
Proserpine,2020,12,118,0,118
Proserpine,2021,1,113,0,113
Proserpine,2021,2,81,0,81
Proserpine,2021,3,103,0,103
Proserpine,2021,4,117,0,117
Proserpine,2021,5,85,0,85
Proserpine,2021,6,86,0,86
Proserpine,2021,7,100,0,100
Proserpine,2021,8,74,0,74
Proserpine,2021,9,122,0,122
Proserpine,2021,10,169,0,169
Proserpine,2021,11,178,0,178
Proserpine,2021,12,210,0,210
Proserpine,2022,1,205,0,205
Proserpine,2022,2,125,0,125
Proserpine,2022,3,150,0,150
Proserpine,2022,4,183,0,183
Proserpine,2022,5,137,0,137
Proserpine,2022,6,136,0,136
Proserpine,2022,7,154,0,154
Proserpine,2022,8,144,0,144
Proserpine,2022,9,158,0,158
Proserpine,2022,10,158,0,158
Proserpine,2022,11,141,0,141
Proserpine,2022,12,169,0,169
Proserpine,2023,1,156,0,156
Proserpine,2023,2,132,0,132
Proserpine,2023,3,161,0,161
Proserpine,2023,4,213,0,213
Proserpine,2023,5,177,0,177
Proserpine,2023,6,178,0,178
Proserpine,2023,7,189,0,189
Proserpine,2023,8,171,0,171
Proserpine,2023,9,169,0,169
Proserpine,2023,10,181,0,181
Proserpine,2023,11,159,0,159
Proserpine,2023,12,198,0,198
Proserpine,2024,1,197,0,197
Proserpine,2024,2,140,0,140
Proserpine,2024,3,159,0,159
Proserpine,2024,4,176,0,176
Proserpine,2024,5,129,0,129
Proserpine,2024,6,133,0,133
Proserpine,2024,7,154,0,154
Proserpine,2024,8,148,0,148
Proserpine,2024,9,165,0,165
Proserpine,2024,10,170,0,170
Proserpine,2024,11,161,0,161
Proserpine,2024,12,179,0,179
Rockhampton,1985,1,475,0,475
Rockhampton,1985,2,422,0,422
Rockhampton,1985,3,469,0,469
Rockhampton,1985,4,425,0,425
Rockhampton,1985,5,488,0,488
Rockhampton,1985,6,428,0,428
Rockhampton,1985,7,426,0,426
Rockhampton,1985,8,417,0,417
Rockhampton,1985,9,423,0,423
Rockhampton,1985,10,485,0,485
Rockhampton,1985,11,425,0,425
Rockhampton,1985,12,428,0,428
Rockhampton,1986,1,451,0,451
Rockhampton,1986,2,363,0,363
Rockhampton,1986,3,414,0,414
Rockhampton,1986,4,410,0,410
Rockhampton,1986,5,489,0,489
Rockhampton,1986,6,469,0,469
Rockhampton,1986,7,487,0,487
Rockhampton,1986,8,484,0,484
Rockhampton,1986,9,525,0,525
Rockhampton,1986,10,514,0,514
Rockhampton,1986,11,497,0,497
Rockhampton,1986,12,488,0,488
Rockhampton,1987,1,461,0,461
Rockhampton,1987,2,412,0,412
Rockhampton,1987,3,459,0,459
Rockhampton,1987,4,478,0,478
Rockhampton,1987,5,438,0,438
Rockhampton,1987,6,426,0,426
Rockhampton,1987,7,522,0,522
Rockhampton,1987,8,474,0,474
Rockhampton,1987,9,448,0,448
Rockhampton,1987,10,446,0,446
Rockhampton,1987,11,484,0,484
Rockhampton,1987,12,469,0,469
Rockhampton,1988,1,466,0,466
Rockhampton,1988,2,406,0,406
Rockhampton,1988,3,456,0,456
Rockhampton,1988,4,488,0,488
Rockhampton,1988,5,473,0,473
Rockhampton,1988,6,473,0,473
Rockhampton,1988,7,486,0,486
Rockhampton,1988,8,452,0,452
Rockhampton,1988,9,480,0,480
Rockhampton,1988,10,487,0,487
Rockhampton,1988,11,459,0,459
Rockhampton,1988,12,472,0,472
Rockhampton,1989,1,460,0,460
Rockhampton,1989,2,406,0,406
Rockhampton,1989,3,476,0,476
Rockhampton,1989,4,467,0,467
Rockhampton,1989,5,595,0,595
Rockhampton,1989,6,478,0,478
Rockhampton,1989,7,490,0,490
Rockhampton,1989,8,440,0,440
Rockhampton,1989,9,332,0,332
Rockhampton,1989,10,378,0,378
Rockhampton,1989,11,336,0,336
Rockhampton,1989,12,348,0,348
Rockhampton,1990,1,369,0,369
Rockhampton,1990,2,375,0,375
Rockhampton,1990,3,395,0,395
Rockhampton,1990,4,371,0,371
Rockhampton,1990,5,343,0,343
Rockhampton,1990,6,346,0,346
Rockhampton,1990,7,360,0,360
Rockhampton,1990,8,364,0,364
Rockhampton,1990,9,389,0,389
Rockhampton,1990,10,433,0,433
Rockhampton,1990,11,424,0,424
Rockhampton,1990,12,425,0,425
Rockhampton,1991,1,342,0,342
Rockhampton,1991,2,442,0,442
Rockhampton,1991,3,494,0,494
Rockhampton,1991,4,480,0,480
Rockhampton,1991,5,494,0,494
Rockhampton,1991,6,465,0,465
Rockhampton,1991,7,508,0,508
Rockhampton,1991,8,534,0,534
Rockhampton,1991,9,521,0,521
Rockhampton,1991,10,552,0,552
Rockhampton,1991,11,512,0,512
Rockhampton,1991,12,530,0,530
Rockhampton,1992,1,548,0,548
Rockhampton,1992,2,498,0,498
Rockhampton,1992,3,466,0,466
Rockhampton,1992,4,481,0,481
Rockhampton,1992,5,477,0,477
Rockhampton,1992,6,477,0,477
Rockhampton,1992,7,526,0,526
Rockhampton,1992,8,504,0,504
Rockhampton,1992,9,521,0,521
Rockhampton,1992,10,527,0,527
Rockhampton,1992,11,472,0,472
Rockhampton,1992,12,510,0,510
Rockhampton,1993,1,536,0,536
Rockhampton,1993,2,462,0,462
Rockhampton,1993,3,491,0,491
Rockhampton,1993,4,492,0,492
Rockhampton,1993,5,497,0,497
Rockhampton,1993,6,485,0,485
Rockhampton,1993,7,497,0,497
Rockhampton,1993,8,512,0,512
Rockhampton,1993,9,517,0,517
Rockhampton,1993,10,545,0,545
Rockhampton,1993,11,534,0,534
Rockhampton,1993,12,534,0,534
Rockhampton,1994,1,483,0,483
Rockhampton,1994,2,434,0,434
Rockhampton,1994,3,469,0,469
Rockhampton,1994,4,460,0,460
Rockhampton,1994,5,486,0,486
Rockhampton,1994,6,469,0,469
Rockhampton,1994,7,550,0,550
Rockhampton,1994,8,545,0,545
Rockhampton,1994,9,552,0,552
Rockhampton,1994,10,580,0,580
Rockhampton,1994,11,570,0,570
Rockhampton,1994,12,565,0,565
Rockhampton,1995,1,585,0,585
Rockhampton,1995,2,514,0,514
Rockhampton,1995,3,592,0,592
Rockhampton,1995,4,581,0,581
Rockhampton,1995,5,575,0,575
Rockhampton,1995,6,571,0,571
Rockhampton,1995,7,580,0,580
Rockhampton,1995,8,587,0,587
Rockhampton,1995,9,587,0,587
Rockhampton,1995,10,595,0,595
Rockhampton,1995,11,582,0,582
Rockhampton,1995,12,578,0,578
Rockhampton,1996,1,599,0,599
Rockhampton,1996,2,554,0,554
Rockhampton,1996,3,581,0,581
Rockhampton,1996,4,575,0,575
Rockhampton,1996,5,575,0,575
Rockhampton,1996,6,559,0,559
Rockhampton,1996,7,583,0,583
Rockhampton,1996,8,548,0,548
Rockhampton,1996,9,547,0,547
Rockhampton,1996,10,588,0,588
Rockhampton,1996,11,562,0,562
Rockhampton,1996,12,572,0,572
Rockhampton,1997,1,586,0,586
Rockhampton,1997,2,520,0,520
Rockhampton,1997,3,553,0,553
Rockhampton,1997,4,534,0,534
Rockhampton,1997,5,552,0,552
Rockhampton,1997,6,538,0,538
Rockhampton,1997,7,558,0,558
Rockhampton,1997,8,540,0,540
Rockhampton,1997,9,556,0,556
Rockhampton,1997,10,567,0,567
Rockhampton,1997,11,562,0,562
Rockhampton,1997,12,594,0,594
Rockhampton,1998,1,583,0,583
Rockhampton,1998,2,477,0,477
Rockhampton,1998,3,533,0,533
Rockhampton,1998,4,553,0,553
Rockhampton,1998,5,550,0,550
Rockhampton,1998,6,519,0,519
Rockhampton,1998,7,489,0,489
Rockhampton,1998,8,475,0,475
Rockhampton,1998,9,469,0,469
Rockhampton,1998,10,483,0,483
Rockhampton,1998,11,461,0,461
Rockhampton,1998,12,464,0,464
Rockhampton,1999,1,410,0,410
Rockhampton,1999,2,368,0,368
Rockhampton,1999,3,422,0,422
Rockhampton,1999,4,453,0,453
Rockhampton,1999,5,462,0,462
Rockhampton,1999,6,447,0,447
Rockhampton,1999,7,483,0,483
Rockhampton,1999,8,473,0,473
Rockhampton,1999,9,475,0,475
Rockhampton,1999,10,474,0,474
Rockhampton,1999,11,466,0,466
Rockhampton,1999,12,454,0,454
Rockhampton,2000,1,404,0,404
Rockhampton,2000,2,430,0,430
Rockhampton,2000,3,485,0,485
Rockhampton,2000,4,410,0,410
Rockhampton,2000,5,455,0,455
Rockhampton,2000,6,435,0,435
Rockhampton,2000,7,440,0,440
Rockhampton,2000,8,461,0,461
Rockhampton,2000,9,439,0,439
Rockhampton,2000,10,459,0,459
Rockhampton,2000,11,413,0,413
Rockhampton,2000,12,418,0,418
Rockhampton,2001,1,422,0,422
Rockhampton,2001,2,402,0,402
Rockhampton,2001,3,447,0,447
Rockhampton,2001,4,430,0,430
Rockhampton,2001,5,468,0,468
Rockhampton,2001,6,418,0,418
Rockhampton,2001,7,381,0,381
Rockhampton,2001,8,385,0,385
Rockhampton,2001,9,306,0,306
Rockhampton,2001,10,286,0,286
Rockhampton,2001,11,294,0,294
Rockhampton,2001,12,283,0,283
Rockhampton,2002,1,274,0,274
Rockhampton,2002,2,252,0,252
Rockhampton,2002,3,269,0,269
Rockhampton,2002,4,271,0,271
Rockhampton,2002,5,277,0,277
Rockhampton,2002,6,267,0,267
Rockhampton,2002,7,268,0,268
Rockhampton,2002,8,285,0,285
Rockhampton,2002,9,311,0,311
Rockhampton,2002,10,323,0,323
Rockhampton,2002,11,273,0,273
Rockhampton,2002,12,313,0,313
Rockhampton,2003,1,314,0,314
Rockhampton,2003,2,285,0,285
Rockhampton,2003,3,276,0,276
Rockhampton,2003,4,303,0,303
Rockhampton,2003,5,314,0,314
Rockhampton,2003,6,299,0,299
Rockhampton,2003,7,311,0,311
Rockhampton,2003,8,308,0,308
Rockhampton,2003,9,300,0,300
Rockhampton,2003,10,309,0,309
Rockhampton,2003,11,300,0,300
Rockhampton,2003,12,297,0,297
Rockhampton,2004,1,336,0,336
Rockhampton,2004,2,339,0,339
Rockhampton,2004,3,366,0,366
Rockhampton,2004,4,339,0,339
Rockhampton,2004,5,389,0,389
Rockhampton,2004,6,380,0,380
Rockhampton,2004,7,394,0,394
Rockhampton,2004,8,395,0,395
Rockhampton,2004,9,389,0,389
Rockhampton,2004,10,399,0,399
Rockhampton,2004,11,411,0,411
Rockhampton,2004,12,478,0,478
Rockhampton,2005,1,464,0,464
Rockhampton,2005,2,440,0,440
Rockhampton,2005,3,476,0,476
Rockhampton,2005,4,459,0,459
Rockhampton,2005,5,480,0,480
Rockhampton,2005,6,529,0,529
Rockhampton,2005,7,538,0,538
Rockhampton,2005,8,550,0,550
Rockhampton,2005,9,528,0,528
Rockhampton,2005,10,538,0,538
Rockhampton,2005,11,517,0,517
Rockhampton,2005,12,497,0,497
Rockhampton,2006,1,464,0,464
Rockhampton,2006,2,458,0,458
Rockhampton,2006,3,520,0,520
Rockhampton,2006,4,477,0,477
Rockhampton,2006,5,543,0,543
Rockhampton,2006,6,503,0,503
Rockhampton,2006,7,508,0,508
Rockhampton,2006,8,515,0,515
Rockhampton,2006,9,495,0,495
Rockhampton,2006,10,511,0,511
Rockhampton,2006,11,497,0,497
Rockhampton,2006,12,458,0,458
Rockhampton,2007,1,441,0,441
Rockhampton,2007,2,449,0,449
Rockhampton,2007,3,513,0,513
Rockhampton,2007,4,479,0,479
Rockhampton,2007,5,515,0,515
Rockhampton,2007,6,495,0,495
Rockhampton,2007,7,524,0,524
Rockhampton,2007,8,525,0,525
Rockhampton,2007,9,493,0,493
Rockhampton,2007,10,522,0,522
Rockhampton,2007,11,509,0,509
Rockhampton,2007,12,503,0,503
Rockhampton,2008,1,483,0,483
Rockhampton,2008,2,448,0,448
Rockhampton,2008,3,449,0,449
Rockhampton,2008,4,458,0,458
Rockhampton,2008,5,496,0,496
Rockhampton,2008,6,478,0,478
Rockhampton,2008,7,519,0,519
Rockhampton,2008,8,521,0,521
Rockhampton,2008,9,493,0,493
Rockhampton,2008,10,549,0,549
Rockhampton,2008,11,538,0,538
Rockhampton,2008,12,520,0,520
Rockhampton,2009,1,489,0,489
Rockhampton,2009,2,452,0,452
Rockhampton,2009,3,529,0,529
Rockhampton,2009,4,550,0,550
Rockhampton,2009,5,575,0,575
Rockhampton,2009,6,536,0,536
Rockhampton,2009,7,571,0,571
Rockhampton,2009,8,539,0,539
Rockhampton,2009,9,518,0,518
Rockhampton,2009,10,552,0,552
Rockhampton,2009,11,537,0,537
Rockhampton,2009,12,539,0,539
Rockhampton,2010,1,540,0,540
Rockhampton,2010,2,563,0,563
Rockhampton,2010,3,609,0,609
Rockhampton,2010,4,619,0,619
Rockhampton,2010,5,621,0,621
Rockhampton,2010,6,605,0,605
Rockhampton,2010,7,630,0,630
Rockhampton,2010,8,618,0,618
Rockhampton,2010,9,618,0,618
Rockhampton,2010,10,639,0,639
Rockhampton,2010,11,628,0,628
Rockhampton,2010,12,617,0,617
Rockhampton,2011,1,159,0,159
Rockhampton,2011,2,507,0,507
Rockhampton,2011,3,593,0,593
Rockhampton,2011,4,563,0,563
Rockhampton,2011,5,597,0,597
Rockhampton,2011,6,575,0,575
Rockhampton,2011,7,580,0,580
Rockhampton,2011,8,584,0,584
Rockhampton,2011,9,568,0,568
Rockhampton,2011,10,551,0,551
Rockhampton,2011,11,532,0,532
Rockhampton,2011,12,524,0,524
Rockhampton,2012,1,513,0,513
Rockhampton,2012,2,527,0,527
Rockhampton,2012,3,576,0,576
Rockhampton,2012,4,520,0,520
Rockhampton,2012,5,589,0,589
Rockhampton,2012,6,549,0,549
Rockhampton,2012,7,605,0,605
Rockhampton,2012,8,622,0,622
Rockhampton,2012,9,596,0,596
Rockhampton,2012,10,619,0,619
Rockhampton,2012,11,625,0,625
Rockhampton,2012,12,603,0,603
Rockhampton,2013,1,585,0,585
Rockhampton,2013,2,550,0,550
Rockhampton,2013,3,612,0,612
Rockhampton,2013,4,597,0,597
Rockhampton,2013,5,598,0,598
Rockhampton,2013,6,552,0,552
Rockhampton,2013,7,616,0,616
Rockhampton,2013,8,590,0,590
Rockhampton,2013,9,578,0,578
Rockhampton,2013,10,613,0,613
Rockhampton,2013,11,546,0,546
Rockhampton,2013,12,536,0,536
Rockhampton,2014,1,505,0,505
Rockhampton,2014,2,482,0,482
Rockhampton,2014,3,537,0,537
Rockhampton,2014,4,517,0,517
Rockhampton,2014,5,549,0,549
Rockhampton,2014,6,530,0,530
Rockhampton,2014,7,554,0,554
Rockhampton,2014,8,548,0,548
Rockhampton,2014,9,532,0,532
Rockhampton,2014,10,552,0,552
Rockhampton,2014,11,518,0,518
Rockhampton,2014,12,528,0,528
Rockhampton,2015,1,525,0,525
Rockhampton,2015,2,445,0,445
Rockhampton,2015,3,535,0,535
Rockhampton,2015,4,453,0,453
Rockhampton,2015,5,482,0,482
Rockhampton,2015,6,458,0,458
Rockhampton,2015,7,488,0,488
Rockhampton,2015,8,475,0,475
Rockhampton,2015,9,455,0,455
Rockhampton,2015,10,469,0,469
Rockhampton,2015,11,453,0,453
Rockhampton,2015,12,434,0,434
Rockhampton,2016,1,398,0,398
Rockhampton,2016,2,440,0,440
Rockhampton,2016,3,463,0,463
Rockhampton,2016,4,440,0,440
Rockhampton,2016,5,460,0,460
Rockhampton,2016,6,455,0,455
Rockhampton,2016,7,457,0,457
Rockhampton,2016,8,453,0,453
Rockhampton,2016,9,446,0,446
Rockhampton,2016,10,442,0,442
Rockhampton,2016,11,455,0,455
Rockhampton,2016,12,465,0,465
Rockhampton,2017,1,411,0,411
Rockhampton,2017,2,428,0,428
Rockhampton,2017,3,443,0,443
Rockhampton,2017,4,264,0,264
Rockhampton,2017,5,423,0,423
Rockhampton,2017,6,419,0,419
Rockhampton,2017,7,432,0,432
Rockhampton,2017,8,451,0,451
Rockhampton,2017,9,430,0,430
Rockhampton,2017,10,445,0,445
Rockhampton,2017,11,451,0,451
Rockhampton,2017,12,426,0,426
Rockhampton,2018,1,421,0,421
Rockhampton,2018,2,385,0,385
Rockhampton,2018,3,431,0,431
Rockhampton,2018,4,426,0,426
Rockhampton,2018,5,477,0,477
Rockhampton,2018,6,393,0,393
Rockhampton,2018,7,413,0,413
Rockhampton,2018,8,398,0,398
Rockhampton,2018,9,392,0,392
Rockhampton,2018,10,420,0,420
Rockhampton,2018,11,391,0,391
Rockhampton,2018,12,382,0,382
Rockhampton,2019,1,392,0,392
Rockhampton,2019,2,368,0,368
Rockhampton,2019,3,400,0,400
Rockhampton,2019,4,385,0,385
Rockhampton,2019,5,412,0,412
Rockhampton,2019,6,388,0,388
Rockhampton,2019,7,413,0,413
Rockhampton,2019,8,394,0,394
Rockhampton,2019,9,389,0,389
Rockhampton,2019,10,412,0,412
Rockhampton,2019,11,384,0,384
Rockhampton,2019,12,376,0,376
Rockhampton,2020,1,388,0,388
Rockhampton,2020,2,370,0,370
Rockhampton,2020,3,336,0,336
Rockhampton,2020,4,93,0,93
Rockhampton,2020,5,72,0,72
Rockhampton,2020,6,109,0,109
Rockhampton,2020,7,175,0,175
Rockhampton,2020,8,202,0,202
Rockhampton,2020,9,221,0,221
Rockhampton,2020,10,244,0,244
Rockhampton,2020,11,277,0,277
Rockhampton,2020,12,307,0,307
Rockhampton,2021,1,281,0,281
Rockhampton,2021,2,258,0,258
Rockhampton,2021,3,318,0,318
Rockhampton,2021,4,313,0,313
Rockhampton,2021,5,325,0,325
Rockhampton,2021,6,339,0,339
Rockhampton,2021,7,346,0,346
Rockhampton,2021,8,233,0,233
Rockhampton,2021,9,285,0,285
Rockhampton,2021,10,327,0,327
Rockhampton,2021,11,354,0,354
Rockhampton,2021,12,363,0,363
Rockhampton,2022,1,286,0,286
Rockhampton,2022,2,249,0,249
Rockhampton,2022,3,320,0,320
Rockhampton,2022,4,291,0,291
Rockhampton,2022,5,339,0,339
Rockhampton,2022,6,353,0,353
Rockhampton,2022,7,343,0,343
Rockhampton,2022,8,337,0,337
Rockhampton,2022,9,289,0,289
Rockhampton,2022,10,310,0,310
Rockhampton,2022,11,351,0,351
Rockhampton,2022,12,363,0,363
Rockhampton,2023,1,368,0,368
Rockhampton,2023,2,338,0,338
Rockhampton,2023,3,407,0,407
Rockhampton,2023,4,392,0,392
Rockhampton,2023,5,445,0,445
Rockhampton,2023,6,430,0,430
Rockhampton,2023,7,423,0,423
Rockhampton,2023,8,431,0,431
Rockhampton,2023,9,410,0,410
Rockhampton,2023,10,430,0,430
Rockhampton,2023,11,427,0,427
Rockhampton,2023,12,399,0,399
Rockhampton,2024,1,375,0,375
Rockhampton,2024,2,392,0,392
Rockhampton,2024,3,425,0,425
Rockhampton,2024,4,438,0,438
Rockhampton,2024,5,441,0,441
Rockhampton,2024,6,390,0,390
Rockhampton,2024,7,427,0,427
Rockhampton,2024,8,417,0,417
Rockhampton,2024,9,407,0,407
Rockhampton,2024,10,416,0,416
Rockhampton,2024,11,392,0,392
Rockhampton,2024,12,375,0,375
Sunshine Coast,1985,1,198,0,198
Sunshine Coast,1985,2,146,0,146
Sunshine Coast,1985,3,174,0,174
Sunshine Coast,1985,4,186,0,186
Sunshine Coast,1985,5,208,0,208
Sunshine Coast,1985,6,178,0,178
Sunshine Coast,1985,7,179,0,179
Sunshine Coast,1985,8,211,0,211
Sunshine Coast,1985,9,169,0,169
Sunshine Coast,1985,10,170,0,170
Sunshine Coast,1985,11,156,0,156
Sunshine Coast,1985,12,192,0,192
Sunshine Coast,1986,1,230,0,230
Sunshine Coast,1986,2,162,0,162
Sunshine Coast,1986,3,148,0,148
Sunshine Coast,1986,4,179,0,179
Sunshine Coast,1986,5,181,0,181
Sunshine Coast,1986,6,158,0,158
Sunshine Coast,1986,7,192,0,192
Sunshine Coast,1986,8,190,0,190
Sunshine Coast,1986,9,183,0,183
Sunshine Coast,1986,10,174,0,174
Sunshine Coast,1986,11,168,0,168
Sunshine Coast,1986,12,203,0,203
Sunshine Coast,1987,1,167,0,167
Sunshine Coast,1987,2,128,0,128
Sunshine Coast,1987,3,116,0,116
Sunshine Coast,1987,4,174,0,174
Sunshine Coast,1987,5,137,0,137
Sunshine Coast,1987,6,162,0,162
Sunshine Coast,1987,7,209,0,209
Sunshine Coast,1987,8,206,0,206
Sunshine Coast,1987,9,223,0,223
Sunshine Coast,1987,10,271,0,271
Sunshine Coast,1987,11,277,0,277
Sunshine Coast,1987,12,289,0,289
Sunshine Coast,1988,1,291,0,291
Sunshine Coast,1988,2,242,0,242
Sunshine Coast,1988,3,223,0,223
Sunshine Coast,1988,4,221,0,221
Sunshine Coast,1988,5,218,0,218
Sunshine Coast,1988,6,267,0,267
Sunshine Coast,1988,7,254,0,254
Sunshine Coast,1988,8,246,0,246
Sunshine Coast,1988,9,262,0,262
Sunshine Coast,1988,10,253,0,253
Sunshine Coast,1988,11,168,0,168
Sunshine Coast,1988,12,237,0,237
Sunshine Coast,1989,1,254,0,254
Sunshine Coast,1989,2,178,0,178
Sunshine Coast,1989,3,200,0,200
Sunshine Coast,1989,4,171,0,171
Sunshine Coast,1989,5,199,0,199
Sunshine Coast,1989,6,169,0,169
Sunshine Coast,1989,7,205,0,205
Sunshine Coast,1989,8,135,0,135
Sunshine Coast,1989,9,26,0,26
Sunshine Coast,1989,10,66,0,66
Sunshine Coast,1989,11,67,0,67
Sunshine Coast,1989,12,121,0,121
Sunshine Coast,1990,1,177,0,177
Sunshine Coast,1990,2,153,0,153
Sunshine Coast,1990,3,129,0,129
Sunshine Coast,1990,4,180,0,180
Sunshine Coast,1990,5,154,0,154
Sunshine Coast,1990,6,158,0,158
Sunshine Coast,1990,7,185,0,185
Sunshine Coast,1990,8,234,0,234
Sunshine Coast,1990,9,198,0,198
Sunshine Coast,1990,10,214,0,214
Sunshine Coast,1990,11,185,0,185
Sunshine Coast,1990,12,210,0,210
Sunshine Coast,1991,1,151,0,151
Sunshine Coast,1991,2,141,0,141
Sunshine Coast,1991,3,160,0,160
Sunshine Coast,1991,4,159,0,159
Sunshine Coast,1991,5,166,0,166
Sunshine Coast,1991,6,153,0,153
Sunshine Coast,1991,7,152,0,152
Sunshine Coast,1991,8,73,0,73
Sunshine Coast,1991,9,78,0,78
Sunshine Coast,1991,10,79,0,79
Sunshine Coast,1991,11,79,0,79
Sunshine Coast,1991,12,91,0,91
Sunshine Coast,1992,1,92,0,92
Sunshine Coast,1992,2,73,0,73
Sunshine Coast,1992,3,92,0,92
Sunshine Coast,1992,4,121,0,121
Sunshine Coast,1992,5,115,0,115
Sunshine Coast,1992,6,103,0,103
Sunshine Coast,1992,7,119,0,119
Sunshine Coast,1992,8,111,0,111
Sunshine Coast,1992,9,122,0,122
Sunshine Coast,1992,10,120,0,120
Sunshine Coast,1992,11,128,0,128
Sunshine Coast,1992,12,148,0,148
Sunshine Coast,1993,1,182,0,182
Sunshine Coast,1993,2,107,0,107
Sunshine Coast,1993,3,118,0,118
Sunshine Coast,1993,4,156,0,156
Sunshine Coast,1993,5,157,0,157
Sunshine Coast,1993,6,167,0,167
Sunshine Coast,1993,7,213,0,213
Sunshine Coast,1993,8,186,0,186
Sunshine Coast,1993,9,233,0,233
Sunshine Coast,1993,10,247,0,247
Sunshine Coast,1993,11,191,0,191
Sunshine Coast,1993,12,223,0,223
Sunshine Coast,1994,1,201,0,201
Sunshine Coast,1994,2,167,0,167
Sunshine Coast,1994,3,182,0,182
Sunshine Coast,1994,4,199,0,199
Sunshine Coast,1994,5,226,0,226
Sunshine Coast,1994,6,192,0,192
Sunshine Coast,1994,7,233,0,233
Sunshine Coast,1994,8,246,0,246
Sunshine Coast,1994,9,284,0,284
Sunshine Coast,1994,10,278,0,278
Sunshine Coast,1994,11,237,0,237
Sunshine Coast,1994,12,272,0,272
Sunshine Coast,1995,1,306,0,306
Sunshine Coast,1995,2,224,0,224
Sunshine Coast,1995,3,276,0,276
Sunshine Coast,1995,4,316,0,316
Sunshine Coast,1995,5,275,0,275
Sunshine Coast,1995,6,270,0,270
Sunshine Coast,1995,7,330,0,330
Sunshine Coast,1995,8,317,0,317
Sunshine Coast,1995,9,334,0,334
Sunshine Coast,1995,10,343,0,343
Sunshine Coast,1995,11,310,0,310
Sunshine Coast,1995,12,385,0,385
Sunshine Coast,1996,1,439,0,439
Sunshine Coast,1996,2,348,0,348
Sunshine Coast,1996,3,389,0,389
Sunshine Coast,1996,4,411,0,411
Sunshine Coast,1996,5,288,0,288
Sunshine Coast,1996,6,277,0,277
Sunshine Coast,1996,7,349,0,349
Sunshine Coast,1996,8,345,0,345
Sunshine Coast,1996,9,389,0,389
Sunshine Coast,1996,10,412,0,412
Sunshine Coast,1996,11,341,0,341
Sunshine Coast,1996,12,329,0,329
Sunshine Coast,1997,1,298,0,298
Sunshine Coast,1997,2,206,0,206
Sunshine Coast,1997,3,280,0,280
Sunshine Coast,1997,4,244,0,244
Sunshine Coast,1997,5,213,0,213
Sunshine Coast,1997,6,224,0,224
Sunshine Coast,1997,7,240,0,240
Sunshine Coast,1997,8,240,0,240
Sunshine Coast,1997,9,283,0,283
Sunshine Coast,1997,10,297,0,297
Sunshine Coast,1997,11,261,0,261
Sunshine Coast,1997,12,291,0,291
Sunshine Coast,1998,1,287,0,287
Sunshine Coast,1998,2,204,0,204
Sunshine Coast,1998,3,234,0,234
Sunshine Coast,1998,4,254,0,254
Sunshine Coast,1998,5,241,0,241
Sunshine Coast,1998,6,229,0,229
Sunshine Coast,1998,7,246,0,246
Sunshine Coast,1998,8,258,0,258
Sunshine Coast,1998,9,288,0,288
Sunshine Coast,1998,10,307,0,307
Sunshine Coast,1998,11,378,0,378
Sunshine Coast,1998,12,384,0,384
Sunshine Coast,1999,1,402,0,402
Sunshine Coast,1999,2,300,0,300
Sunshine Coast,1999,3,363,0,363
Sunshine Coast,1999,4,374,0,374
Sunshine Coast,1999,5,357,0,357
Sunshine Coast,1999,6,344,0,344
Sunshine Coast,1999,7,374,0,374
Sunshine Coast,1999,8,366,0,366
Sunshine Coast,1999,9,396,0,396
Sunshine Coast,1999,10,455,0,455
Sunshine Coast,1999,11,390,0,390
Sunshine Coast,1999,12,431,0,431
Sunshine Coast,2000,1,443,0,443
Sunshine Coast,2000,2,324,0,324
Sunshine Coast,2000,3,372,0,372
Sunshine Coast,2000,4,417,0,417
Sunshine Coast,2000,5,389,0,389
Sunshine Coast,2000,6,457,0,457
Sunshine Coast,2000,7,418,0,418
Sunshine Coast,2000,8,447,0,447
Sunshine Coast,2000,9,441,0,441
Sunshine Coast,2000,10,446,0,446
Sunshine Coast,2000,11,429,0,429
Sunshine Coast,2000,12,412,0,412
Sunshine Coast,2001,1,405,0,405
Sunshine Coast,2001,2,327,0,327
Sunshine Coast,2001,3,359,0,359
Sunshine Coast,2001,4,360,0,360
Sunshine Coast,2001,5,321,0,321
Sunshine Coast,2001,6,311,0,311
Sunshine Coast,2001,7,356,0,356
Sunshine Coast,2001,8,352,0,352
Sunshine Coast,2001,9,239,0,239
Sunshine Coast,2001,10,185,0,185
Sunshine Coast,2001,11,204,0,204
Sunshine Coast,2001,12,195,0,195
Sunshine Coast,2002,1,215,0,215
Sunshine Coast,2002,2,145,0,145
Sunshine Coast,2002,3,191,0,191
Sunshine Coast,2002,4,190,0,190
Sunshine Coast,2002,5,155,0,155
Sunshine Coast,2002,6,157,0,157
Sunshine Coast,2002,7,184,0,184
Sunshine Coast,2002,8,176,0,176
Sunshine Coast,2002,9,186,0,186
Sunshine Coast,2002,10,204,0,204
Sunshine Coast,2002,11,216,0,216
Sunshine Coast,2002,12,233,0,233
Sunshine Coast,2003,1,257,0,257
Sunshine Coast,2003,2,172,0,172
Sunshine Coast,2003,3,205,0,205
Sunshine Coast,2003,4,202,0,202
Sunshine Coast,2003,5,203,0,203
Sunshine Coast,2003,6,208,0,208
Sunshine Coast,2003,7,224,0,224
Sunshine Coast,2003,8,236,0,236
Sunshine Coast,2003,9,235,0,235
Sunshine Coast,2003,10,252,0,252
Sunshine Coast,2003,11,236,0,236
Sunshine Coast,2003,12,278,0,278
Sunshine Coast,2004,1,282,0,282
Sunshine Coast,2004,2,228,0,228
Sunshine Coast,2004,3,241,0,241
Sunshine Coast,2004,4,237,0,237
Sunshine Coast,2004,5,250,0,250
Sunshine Coast,2004,6,244,0,244
Sunshine Coast,2004,7,274,0,274
Sunshine Coast,2004,8,286,0,286
Sunshine Coast,2004,9,292,0,292
Sunshine Coast,2004,10,356,0,356
Sunshine Coast,2004,11,342,0,342
Sunshine Coast,2004,12,400,0,400
Sunshine Coast,2005,1,390,0,390
Sunshine Coast,2005,2,317,0,317
Sunshine Coast,2005,3,363,0,363
Sunshine Coast,2005,4,332,0,332
Sunshine Coast,2005,5,327,0,327
Sunshine Coast,2005,6,307,0,307
Sunshine Coast,2005,7,342,0,342
Sunshine Coast,2005,8,252,0,252
Sunshine Coast,2005,9,253,0,253
Sunshine Coast,2005,10,260,0,260
Sunshine Coast,2005,11,231,0,231
Sunshine Coast,2005,12,265,0,265
Sunshine Coast,2006,1,281,0,281
Sunshine Coast,2006,2,207,0,207
Sunshine Coast,2006,3,238,0,238
Sunshine Coast,2006,4,258,0,258
Sunshine Coast,2006,5,237,0,237
Sunshine Coast,2006,6,243,0,243
Sunshine Coast,2006,7,264,0,264
Sunshine Coast,2006,8,251,0,251
Sunshine Coast,2006,9,257,0,257
Sunshine Coast,2006,10,265,0,265
Sunshine Coast,2006,11,257,0,257
Sunshine Coast,2006,12,278,0,278
Sunshine Coast,2007,1,276,0,276
Sunshine Coast,2007,2,238,0,238
Sunshine Coast,2007,3,264,0,264
Sunshine Coast,2007,4,258,0,258
Sunshine Coast,2007,5,245,0,245
Sunshine Coast,2007,6,230,0,230
Sunshine Coast,2007,7,234,0,234
Sunshine Coast,2007,8,221,0,221
Sunshine Coast,2007,9,227,0,227
Sunshine Coast,2007,10,265,0,265
Sunshine Coast,2007,11,262,0,262
Sunshine Coast,2007,12,292,0,292
Sunshine Coast,2008,1,288,0,288
Sunshine Coast,2008,2,253,0,253
Sunshine Coast,2008,3,297,0,297
Sunshine Coast,2008,4,291,0,291
Sunshine Coast,2008,5,295,0,295
Sunshine Coast,2008,6,305,0,305
Sunshine Coast,2008,7,314,0,314
Sunshine Coast,2008,8,260,0,260
Sunshine Coast,2008,9,253,0,253
Sunshine Coast,2008,10,263,0,263
Sunshine Coast,2008,11,275,0,275
Sunshine Coast,2008,12,287,0,287
Sunshine Coast,2009,1,310,0,310
Sunshine Coast,2009,2,209,0,209
Sunshine Coast,2009,3,227,0,227
Sunshine Coast,2009,4,263,0,263
Sunshine Coast,2009,5,242,0,242
Sunshine Coast,2009,6,223,0,223
Sunshine Coast,2009,7,244,0,244
Sunshine Coast,2009,8,237,0,237
Sunshine Coast,2009,9,234,0,234
Sunshine Coast,2009,10,251,0,251
Sunshine Coast,2009,11,239,0,239
Sunshine Coast,2009,12,244,0,244
Sunshine Coast,2010,1,255,0,255
Sunshine Coast,2010,2,198,0,198
Sunshine Coast,2010,3,223,0,223
Sunshine Coast,2010,4,287,0,287
Sunshine Coast,2010,5,276,0,276
Sunshine Coast,2010,6,264,0,264
Sunshine Coast,2010,7,312,0,312
Sunshine Coast,2010,8,268,0,268
Sunshine Coast,2010,9,288,0,288
Sunshine Coast,2010,10,313,0,313
Sunshine Coast,2010,11,295,0,295
Sunshine Coast,2010,12,327,0,327
Sunshine Coast,2011,1,355,0,355
Sunshine Coast,2011,2,259,0,259
Sunshine Coast,2011,3,285,0,285
Sunshine Coast,2011,4,310,0,310
Sunshine Coast,2011,5,262,0,262
Sunshine Coast,2011,6,240,0,240
Sunshine Coast,2011,7,260,0,260
Sunshine Coast,2011,8,219,0,219
Sunshine Coast,2011,9,239,0,239
Sunshine Coast,2011,10,233,0,233
Sunshine Coast,2011,11,209,0,209
Sunshine Coast,2011,12,256,0,256
Sunshine Coast,2012,1,274,0,274
Sunshine Coast,2012,2,189,0,189
Sunshine Coast,2012,3,206,0,206
Sunshine Coast,2012,4,234,0,234
Sunshine Coast,2012,5,202,0,202
Sunshine Coast,2012,6,206,0,206
Sunshine Coast,2012,7,242,10,252
Sunshine Coast,2012,8,196,8,204
Sunshine Coast,2012,9,242,6,248
Sunshine Coast,2012,10,229,0,229
Sunshine Coast,2012,11,228,0,228
Sunshine Coast,2012,12,252,0,252
Sunshine Coast,2013,1,245,0,245
Sunshine Coast,2013,2,178,0,178
Sunshine Coast,2013,3,214,0,214
Sunshine Coast,2013,4,258,0,258
Sunshine Coast,2013,5,216,0,216
Sunshine Coast,2013,6,239,4,243
Sunshine Coast,2013,7,263,9,272
Sunshine Coast,2013,8,246,8,254
Sunshine Coast,2013,9,269,9,278
Sunshine Coast,2013,10,273,4,277
Sunshine Coast,2013,11,254,0,254
Sunshine Coast,2013,12,295,0,295
Sunshine Coast,2014,1,291,0,291
Sunshine Coast,2014,2,217,0,217
Sunshine Coast,2014,3,255,0,255
Sunshine Coast,2014,4,273,0,273
Sunshine Coast,2014,5,220,0,220
Sunshine Coast,2014,6,226,2,228
Sunshine Coast,2014,7,251,11,262
Sunshine Coast,2014,8,219,10,229
Sunshine Coast,2014,9,248,10,258
Sunshine Coast,2014,10,259,9,268
Sunshine Coast,2014,11,237,0,237
Sunshine Coast,2014,12,258,0,258
Sunshine Coast,2015,1,272,0,272
Sunshine Coast,2015,2,181,0,181
Sunshine Coast,2015,3,209,0,209
Sunshine Coast,2015,4,255,0,255
Sunshine Coast,2015,5,207,0,207
Sunshine Coast,2015,6,220,2,222
Sunshine Coast,2015,7,260,13,273
Sunshine Coast,2015,8,244,13,257
Sunshine Coast,2015,9,282,13,295
Sunshine Coast,2015,10,284,9,293
Sunshine Coast,2015,11,260,0,260
Sunshine Coast,2015,12,296,7,303
Sunshine Coast,2016,1,320,11,331
Sunshine Coast,2016,2,225,8,233
Sunshine Coast,2016,3,265,0,265
Sunshine Coast,2016,4,290,0,290
Sunshine Coast,2016,5,243,0,243
Sunshine Coast,2016,6,251,0,251
Sunshine Coast,2016,7,313,17,330
Sunshine Coast,2016,8,268,13,281
Sunshine Coast,2016,9,308,14,322
Sunshine Coast,2016,10,331,13,344
Sunshine Coast,2016,11,324,0,324
Sunshine Coast,2016,12,356,0,356
Sunshine Coast,2017,1,365,0,365
Sunshine Coast,2017,2,259,0,259
Sunshine Coast,2017,3,293,0,293
Sunshine Coast,2017,4,367,0,367
Sunshine Coast,2017,5,279,0,279
Sunshine Coast,2017,6,280,0,280
Sunshine Coast,2017,7,346,14,360
Sunshine Coast,2017,8,305,13,318
Sunshine Coast,2017,9,341,14,355
Sunshine Coast,2017,10,373,14,387
Sunshine Coast,2017,11,351,0,351
Sunshine Coast,2017,12,414,0,414
Sunshine Coast,2018,1,424,0,424
Sunshine Coast,2018,2,295,0,295
Sunshine Coast,2018,3,336,0,336
Sunshine Coast,2018,4,373,0,373
Sunshine Coast,2018,5,300,0,300
Sunshine Coast,2018,6,305,0,305
Sunshine Coast,2018,7,374,15,389
Sunshine Coast,2018,8,345,18,363
Sunshine Coast,2018,9,361,16,377
Sunshine Coast,2018,10,383,13,396
Sunshine Coast,2018,11,357,0,357
Sunshine Coast,2018,12,404,0,404
Sunshine Coast,2019,1,398,0,398
Sunshine Coast,2019,2,286,0,286
Sunshine Coast,2019,3,334,0,334
Sunshine Coast,2019,4,417,0,417
Sunshine Coast,2019,5,339,0,339
Sunshine Coast,2019,6,332,0,332
Sunshine Coast,2019,7,391,16,407
Sunshine Coast,2019,8,353,17,370
Sunshine Coast,2019,9,388,18,406
Sunshine Coast,2019,10,397,12,409
Sunshine Coast,2019,11,373,0,373
Sunshine Coast,2019,12,401,0,401
Sunshine Coast,2020,1,341,0,341
Sunshine Coast,2020,2,295,0,295
Sunshine Coast,2020,3,265,0,265
Sunshine Coast,2020,4,0,0,0
Sunshine Coast,2020,5,0,0,0
Sunshine Coast,2020,6,0,0,0
Sunshine Coast,2020,7,42,0,42
Sunshine Coast,2020,8,24,0,24
Sunshine Coast,2020,9,29,0,29
Sunshine Coast,2020,10,39,0,39
Sunshine Coast,2020,11,57,0,57
Sunshine Coast,2020,12,222,0,222
Sunshine Coast,2021,1,269,0,269
Sunshine Coast,2021,2,220,0,220
Sunshine Coast,2021,3,395,0,395
Sunshine Coast,2021,4,508,0,508
Sunshine Coast,2021,5,438,0,438
Sunshine Coast,2021,6,350,0,350
Sunshine Coast,2021,7,235,5,240
Sunshine Coast,2021,8,91,0,91
Sunshine Coast,2021,9,84,0,84
Sunshine Coast,2021,10,83,0,83
Sunshine Coast,2021,11,68,0,68
Sunshine Coast,2021,12,369,0,369
Sunshine Coast,2022,1,523,0,523
Sunshine Coast,2022,2,317,0,317
Sunshine Coast,2022,3,474,0,474
Sunshine Coast,2022,4,641,0,641
Sunshine Coast,2022,5,551,0,551
Sunshine Coast,2022,6,486,0,486
Sunshine Coast,2022,7,462,6,468
Sunshine Coast,2022,8,414,9,423
Sunshine Coast,2022,9,458,8,466
Sunshine Coast,2022,10,474,5,479
Sunshine Coast,2022,11,460,0,460
Sunshine Coast,2022,12,530,0,530
Sunshine Coast,2023,1,560,0,560
Sunshine Coast,2023,2,412,0,412
Sunshine Coast,2023,3,508,0,508
Sunshine Coast,2023,4,567,0,567
Sunshine Coast,2023,5,549,0,549
Sunshine Coast,2023,6,548,3,551
Sunshine Coast,2023,7,586,13,599
Sunshine Coast,2023,8,522,12,534
Sunshine Coast,2023,9,539,13,552
Sunshine Coast,2023,10,585,7,592
Sunshine Coast,2023,11,556,0,556
Sunshine Coast,2023,12,632,0,632
Sunshine Coast,2024,1,679,0,679
Sunshine Coast,2024,2,522,0,522
Sunshine Coast,2024,3,556,0,556
Sunshine Coast,2024,4,572,0,572
Sunshine Coast,2024,5,387,0,387
Sunshine Coast,2024,6,374,3,377
Sunshine Coast,2024,7,426,13,439
Sunshine Coast,2024,8,392,11,403
Sunshine Coast,2024,9,412,12,424
Sunshine Coast,2024,10,426,8,434
Sunshine Coast,2024,11,438,0,438
Sunshine Coast,2024,12,516,9,525
Sydney,1985,1,4655,844,5499
Sydney,1985,2,4261,767,5028
Sydney,1985,3,4872,846,5718
Sydney,1985,4,4674,810,5484
Sydney,1985,5,5112,851,5963
Sydney,1985,6,4560,827,5387
Sydney,1985,7,4227,771,4998
Sydney,1985,8,5024,866,5890
Sydney,1985,9,5069,852,5921
Sydney,1985,10,5273,866,6139
Sydney,1985,11,4945,871,5816
Sydney,1985,12,5013,922,5935
Sydney,1986,1,4822,926,5748
Sydney,1986,2,4397,808,5205
Sydney,1986,3,4964,909,5873
Sydney,1986,4,4866,878,5744
Sydney,1986,5,5166,921,6087
Sydney,1986,6,4761,890,5651
Sydney,1986,7,4951,913,5864
Sydney,1986,8,5203,942,6145
Sydney,1986,9,5126,869,5995
Sydney,1986,10,5371,963,6334
Sydney,1986,11,5014,983,5997
Sydney,1986,12,5135,1022,6157
Sydney,1987,1,4971,1054,6025
Sydney,1987,2,4614,936,5550
Sydney,1987,3,5131,1026,6157
Sydney,1987,4,5206,977,6183
Sydney,1987,5,4909,1031,5940
Sydney,1987,6,4921,979,5900
Sydney,1987,7,5476,1047,6523
Sydney,1987,8,5204,1062,6266
Sydney,1987,9,5276,1023,6299
Sydney,1987,10,5445,1090,6535
Sydney,1987,11,5220,1087,6307
Sydney,1987,12,5273,1158,6431
Sydney,1988,1,5019,1189,6208
Sydney,1988,2,4962,1071,6033
Sydney,1988,3,5406,1115,6521
Sydney,1988,4,5180,1116,6296
Sydney,1988,5,5409,1154,6563
Sydney,1988,6,5420,1107,6527
Sydney,1988,7,6042,1178,7220
Sydney,1988,8,5882,1179,7061
Sydney,1988,9,5842,1143,6985
Sydney,1988,10,5882,1222,7104
Sydney,1988,11,5544,1255,6799
Sydney,1988,12,5619,1345,6964
Sydney,1989,1,5365,1374,6739
Sydney,1989,2,5006,1221,6227
Sydney,1989,3,5842,1299,7141
Sydney,1989,4,5214,1292,6506
Sydney,1989,5,5492,1312,6804
Sydney,1989,6,5475,1234,6709
Sydney,1989,7,5339,1313,6652
Sydney,1989,8,3615,1336,4951
Sydney,1989,9,2561,1320,3881
Sydney,1989,10,3587,1367,4954
Sydney,1989,11,3809,1350,5159
Sydney,1989,12,4188,1388,5576
Sydney,1990,1,4516,1414,5930
Sydney,1990,2,4591,1300,5891
Sydney,1990,3,5125,1415,6540
Sydney,1990,4,5417,1341,6758
Sydney,1990,5,5584,1389,6973
Sydney,1990,6,5262,1330,6592
Sydney,1990,7,5946,1380,7326
Sydney,1990,8,5558,1394,6952
Sydney,1990,9,5382,1310,6692
Sydney,1990,10,5813,1403,7216
Sydney,1990,11,5586,1352,6938
Sydney,1990,12,5599,1398,6997
Sydney,1991,1,5223,1424,6647
Sydney,1991,2,5019,1269,6288
Sydney,1991,3,5618,1395,7013
Sydney,1991,4,5726,1257,6983
Sydney,1991,5,5836,1294,7130
Sydney,1991,6,5605,1269,6874
Sydney,1991,7,6203,1349,7552
Sydney,1991,8,6011,1360,7371
Sydney,1991,9,6083,1311,7394
Sydney,1991,10,6659,1343,8002
Sydney,1991,11,6401,1367,7768
Sydney,1991,12,6388,1432,7820
Sydney,1992,1,5957,1447,7404
Sydney,1992,2,5775,1346,7121
Sydney,1992,3,6319,1406,7725
Sydney,1992,4,6518,1404,7922
Sydney,1992,5,6422,1457,7879
Sydney,1992,6,6312,1407,7719
Sydney,1992,7,6902,1457,8359
Sydney,1992,8,6597,1467,8064
Sydney,1992,9,7109,1435,8544
Sydney,1992,10,7459,1491,8950
Sydney,1992,11,6934,1531,8465
Sydney,1992,12,6972,1617,8589
Sydney,1993,1,6774,1593,8367
Sydney,1993,2,6542,1456,7998
Sydney,1993,3,7139,1572,8711
Sydney,1993,4,7024,1506,8530
Sydney,1993,5,6918,1544,8462
Sydney,1993,6,6903,1475,8378
Sydney,1993,7,7151,1531,8682
Sydney,1993,8,7019,1529,8548
Sydney,1993,9,7053,1488,8541
Sydney,1993,10,7474,1550,9024
Sydney,1993,11,7035,1422,8457
Sydney,1993,12,7051,1506,8557
Sydney,1994,1,6648,1521,8169
Sydney,1994,2,6579,1363,7942
Sydney,1994,3,7419,1477,8896
Sydney,1994,4,7288,1406,8694
Sydney,1994,5,7483,1456,8939
Sydney,1994,6,7509,1411,8920
Sydney,1994,7,7755,1493,9248
Sydney,1994,8,7793,1457,9250
Sydney,1994,9,7667,1465,9132
Sydney,1994,10,7817,1538,9355
Sydney,1994,11,7378,1543,8921
Sydney,1994,12,7643,1610,9253
Sydney,1995,1,7132,1634,8766
Sydney,1995,2,7084,1483,8567
Sydney,1995,3,7830,1606,9436
Sydney,1995,4,7906,1575,9481
Sydney,1995,5,7970,1632,9602
Sydney,1995,6,7963,1575,9538
Sydney,1995,7,8099,1663,9762
Sydney,1995,8,8218,1649,9867
Sydney,1995,9,8007,1600,9607
Sydney,1995,10,8225,1668,9893
Sydney,1995,11,8106,1659,9765
Sydney,1995,12,7916,1772,9688
Sydney,1996,1,7836,1775,9611
Sydney,1996,2,7730,1676,9406
Sydney,1996,3,8337,1763,10100
Sydney,1996,4,8108,1725,9833
Sydney,1996,5,8505,1763,10268
Sydney,1996,6,8062,1713,9775
Sydney,1996,7,8665,1776,10441
Sydney,1996,8,8596,1778,10374
Sydney,1996,9,8407,1722,10129
Sydney,1996,10,8721,1773,10494
Sydney,1996,11,8427,1789,10216
Sydney,1996,12,8301,1861,10162
Sydney,1997,1,7939,1874,9813
Sydney,1997,2,7840,1689,9529
Sydney,1997,3,8591,1842,10433
Sydney,1997,4,8306,1788,10094
Sydney,1997,5,8376,1846,10222
Sydney,1997,6,8061,1792,9853
Sydney,1997,7,8823,1897,10720
Sydney,1997,8,8738,1895,10633
Sydney,1997,9,8527,1815,10342
Sydney,1997,10,8828,1918,10746
Sydney,1997,11,8348,1968,10316
Sydney,1997,12,8193,2033,10226
Sydney,1998,1,7933,2018,9951
Sydney,1998,2,7819,1812,9631
Sydney,1998,3,8614,1989,10603
Sydney,1998,4,8413,1947,10360
Sydney,1998,5,8700,2012,10712
Sydney,1998,6,8376,1879,10255
Sydney,1998,7,8989,1985,10974
Sydney,1998,8,8784,2015,10799
Sydney,1998,9,8746,1919,10665
Sydney,1998,10,8880,2002,10882
Sydney,1998,11,8507,1907,10414
Sydney,1998,12,8382,1983,10365
Sydney,1999,1,7800,2013,9813
Sydney,1999,2,7742,1814,9556
Sydney,1999,3,8606,1978,10584
Sydney,1999,4,8288,1871,10159
Sydney,1999,5,8466,1880,10346
Sydney,1999,6,8251,1814,10065
Sydney,1999,7,8900,1974,10874
Sydney,1999,8,8961,1974,10935
Sydney,1999,9,8761,1895,10656
Sydney,1999,10,8887,1949,10836
Sydney,1999,11,8584,1947,10531
Sydney,1999,12,8677,2034,10711
Sydney,2000,1,8056,2059,10115
Sydney,2000,2,8047,1914,9961
Sydney,2000,3,8708,2065,10773
Sydney,2000,4,8272,2073,10345
Sydney,2000,5,8860,2069,10929
Sydney,2000,6,9174,2039,11213
Sydney,2000,7,9566,2191,11757
Sydney,2000,8,9768,2153,11921
Sydney,2000,9,9768,2153,11921
Sydney,2000,10,10109,2169,12278
Sydney,2000,11,9782,2053,11835
Sydney,2000,12,9697,2179,11876
Sydney,2001,1,9436,2154,11590
Sydney,2001,2,9121,1918,11039
Sydney,2001,3,10489,2138,12627
Sydney,2001,4,9858,2076,11934
Sydney,2001,5,9904,2111,12015
Sydney,2001,6,9153,2038,11191
Sydney,2001,7,9664,2089,11753
Sydney,2001,8,9844,2054,11898
Sydney,2001,9,7363,1951,9314
Sydney,2001,10,7411,1974,9385
Sydney,2001,11,7431,1877,9308
Sydney,2001,12,7279,2040,9319
Sydney,2002,1,7040,1988,9028
Sydney,2002,2,6739,1787,8526
Sydney,2002,3,6891,1969,8860
Sydney,2002,4,6784,1908,8692
Sydney,2002,5,7059,1954,9013
Sydney,2002,6,6875,1902,8777
Sydney,2002,7,7693,1983,9676
Sydney,2002,8,7589,1965,9554
Sydney,2002,9,7606,1876,9482
Sydney,2002,10,7968,1956,9924
Sydney,2002,11,7604,1983,9587
Sydney,2002,12,7576,2126,9702
Sydney,2003,1,7116,2118,9234
Sydney,2003,2,6833,1916,8749
Sydney,2003,3,7684,2076,9760
Sydney,2003,4,7151,1939,9090
Sydney,2003,5,7383,1861,9244
Sydney,2003,6,7204,1824,9028
Sydney,2003,7,7608,2044,9652
Sydney,2003,8,7545,2117,9662
Sydney,2003,9,7853,2109,9962
Sydney,2003,10,8192,2179,10371
Sydney,2003,11,7898,2184,10082
Sydney,2003,12,7739,2279,10018
Sydney,2004,1,7423,2291,9714
Sydney,2004,2,7558,2135,9693
Sydney,2004,3,8320,2317,10637
Sydney,2004,4,7817,2281,10098
Sydney,2004,5,8153,2365,10518
Sydney,2004,6,8189,2285,10474
Sydney,2004,7,8480,2406,10886
Sydney,2004,8,8636,2376,11012
Sydney,2004,9,8575,2337,10912
Sydney,2004,10,8654,2392,11046
Sydney,2004,11,8403,2364,10767
Sydney,2004,12,8434,2536,10970
Sydney,2005,1,7749,2588,10337
Sydney,2005,2,7652,2283,9935
Sydney,2005,3,8471,2472,10943
Sydney,2005,4,8112,2427,10539
Sydney,2005,5,8426,2444,10870
Sydney,2005,6,8221,2376,10597
Sydney,2005,7,8498,2521,11019
Sydney,2005,8,8655,2441,11096
Sydney,2005,9,8519,2422,10941
Sydney,2005,10,8570,2485,11055
Sydney,2005,11,8350,2392,10742
Sydney,2005,12,8259,2556,10815
Sydney,2006,1,7677,2596,10273
Sydney,2006,2,7767,2298,10065
Sydney,2006,3,8717,2496,11213
Sydney,2006,4,8155,2400,10555
Sydney,2006,5,8660,2408,11068
Sydney,2006,6,8259,2339,10598
Sydney,2006,7,8749,2470,11219
Sydney,2006,8,8792,2412,11204
Sydney,2006,9,8654,2366,11020
Sydney,2006,10,8809,2439,11248
Sydney,2006,11,8737,2394,11131
Sydney,2006,12,8473,2513,10986
Sydney,2007,1,8102,2523,10625
Sydney,2007,2,8003,2295,10298
Sydney,2007,3,9056,2475,11531
Sydney,2007,4,8458,2343,10801
Sydney,2007,5,8964,2394,11358
Sydney,2007,6,8490,2368,10858
Sydney,2007,7,8872,2494,11366
Sydney,2007,8,9211,2475,11686
Sydney,2007,9,8685,2421,11106
Sydney,2007,10,9088,2493,11581
Sydney,2007,11,8854,2457,11311
Sydney,2007,12,8767,2584,11351
Sydney,2008,1,8578,2611,11189
Sydney,2008,2,8743,2418,11161
Sydney,2008,3,9293,2566,11859
Sydney,2008,4,9099,2476,11575
Sydney,2008,5,9378,2520,11898
Sydney,2008,6,8840,2416,11256
Sydney,2008,7,9397,2589,11986
Sydney,2008,8,9237,2504,11741
Sydney,2008,9,9136,2410,11546
Sydney,2008,10,9533,2543,12076
Sydney,2008,11,9009,2509,11518
Sydney,2008,12,8853,2602,11455
Sydney,2009,1,8282,2611,10893
Sydney,2009,2,7958,2273,10231
Sydney,2009,3,8885,2491,11376
Sydney,2009,4,8536,2425,10961
Sydney,2009,5,8601,2434,11035
Sydney,2009,6,8308,2345,10653
Sydney,2009,7,8977,2571,11548
Sydney,2009,8,8770,2565,11335
Sydney,2009,9,8720,2482,11202
Sydney,2009,10,9368,2601,11969
Sydney,2009,11,9059,2507,11566
Sydney,2009,12,8909,2763,11672
Sydney,2010,1,8512,2796,11308
Sydney,2010,2,8440,2447,10887
Sydney,2010,3,9618,2668,12286
Sydney,2010,4,9448,2517,11965
Sydney,2010,5,9680,2532,12212
Sydney,2010,6,9285,2491,11776
Sydney,2010,7,9899,2678,12577
Sydney,2010,8,9624,2619,12243
Sydney,2010,9,9424,2548,11972
Sydney,2010,10,9828,2653,12481
Sydney,2010,11,9579,2612,12191
Sydney,2010,12,9692,2794,12486
Sydney,2011,1,8982,2830,11812
Sydney,2011,2,8625,2504,11129
Sydney,2011,3,9862,2743,12605
Sydney,2011,4,9391,2686,12077
Sydney,2011,5,9621,2660,12281
Sydney,2011,6,8906,2491,11397
Sydney,2011,7,9529,2800,12329
Sydney,2011,8,9617,2749,12366
Sydney,2011,9,9370,2686,12056
Sydney,2011,10,9362,2827,12189
Sydney,2011,11,9428,2716,12144
Sydney,2011,12,9358,2867,12225
Sydney,2012,1,8778,2927,11705
Sydney,2012,2,9108,2626,11734
Sydney,2012,3,9787,2744,12531
Sydney,2012,4,9472,2722,12194
Sydney,2012,5,9618,2678,12296
Sydney,2012,6,9135,2681,11816
Sydney,2012,7,10140,2910,13050
Sydney,2012,8,10359,2856,13215
Sydney,2012,9,10088,2813,12901
Sydney,2012,10,10356,2889,13245
Sydney,2012,11,9994,2785,12779
Sydney,2012,12,9763,2970,12733
Sydney,2013,1,9206,2987,12193
Sydney,2013,2,8899,2592,11491
Sydney,2013,3,10014,2881,12895
Sydney,2013,4,10052,2828,12880
Sydney,2013,5,10047,2772,12819
Sydney,2013,6,9583,2730,12313
Sydney,2013,7,10355,2981,13336
Sydney,2013,8,10142,2875,13017
Sydney,2013,9,10166,2885,13051
Sydney,2013,10,10474,3000,13474
Sydney,2013,11,9875,2908,12783
Sydney,2013,12,9892,3105,12997
Sydney,2014,1,9313,3115,12428
Sydney,2014,2,8793,2688,11481
Sydney,2014,3,9938,2983,12921
Sydney,2014,4,9832,2904,12736
Sydney,2014,5,10015,2798,12813
Sydney,2014,6,9560,2796,12356
Sydney,2014,7,10232,2989,13221
Sydney,2014,8,9989,2909,12898
Sydney,2014,9,10077,2838,12915
Sydney,2014,10,10398,2948,13346
Sydney,2014,11,9679,2790,12469
Sydney,2014,12,9877,3095,12972
Sydney,2015,1,9350,3134,12484
Sydney,2015,2,9048,2626,11674
Sydney,2015,3,10287,2855,13142
Sydney,2015,4,9911,2789,12700
Sydney,2015,5,10079,2725,12804
Sydney,2015,6,9986,2698,12684
Sydney,2015,7,10618,2940,13558
Sydney,2015,8,10430,2795,13225
Sydney,2015,9,10437,2744,13181
Sydney,2015,10,10653,2877,13530
Sydney,2015,11,10191,2829,13020
Sydney,2015,12,10236,3256,13492
Sydney,2016,1,9548,3333,12881
Sydney,2016,2,9829,2899,12728
Sydney,2016,3,10554,3099,13653
Sydney,2016,4,10138,3013,13151
Sydney,2016,5,10103,2948,13051
Sydney,2016,6,9706,2943,12649
Sydney,2016,7,10579,3248,13827
Sydney,2016,8,10624,3110,13734
Sydney,2016,9,10459,3026,13485
Sydney,2016,10,10541,3154,13695
Sydney,2016,11,10331,3052,13383
Sydney,2016,12,10216,3390,13606
Sydney,2017,1,9584,3496,13080
Sydney,2017,2,9486,2966,12452
Sydney,2017,3,10505,3220,13725
Sydney,2017,4,9921,3167,13088
Sydney,2017,5,10208,3067,13275
Sydney,2017,6,9745,3112,12857
Sydney,2017,7,10518,3650,14168
Sydney,2017,8,10413,3228,13641
Sydney,2017,9,10011,3148,13159
Sydney,2017,10,10467,3260,13727
Sydney,2017,11,10254,3162,13416
Sydney,2017,12,9910,3514,13424
Sydney,2018,1,9462,3587,13049
Sydney,2018,2,9304,3112,12416
Sydney,2018,3,10365,3391,13756
Sydney,2018,4,9897,3326,13223
Sydney,2018,5,10057,3267,13324
Sydney,2018,6,9554,3218,12772
Sydney,2018,7,10325,3547,13872
Sydney,2018,8,10239,3390,13629
Sydney,2018,9,9947,3265,13212
Sydney,2018,10,10630,3448,14078
Sydney,2018,11,10062,3380,13442
Sydney,2018,12,9694,3696,13390
Sydney,2019,1,9444,3769,13213
Sydney,2019,2,9330,3185,12515
Sydney,2019,3,10319,3434,13753
Sydney,2019,4,10086,3366,13452
Sydney,2019,5,10311,3296,13607
Sydney,2019,6,9681,3261,12942
Sydney,2019,7,10668,3494,14162
Sydney,2019,8,10140,3352,13492
Sydney,2019,9,10203,3274,13477
Sydney,2019,10,10827,3447,14274
Sydney,2019,11,10138,3348,13486
Sydney,2019,12,9872,3706,13578
Sydney,2020,1,9316,3776,13092
Sydney,2020,2,9296,2986,12282
Sydney,2020,3,7983,2340,10323
Sydney,2020,4,981,783,1764
Sydney,2020,5,851,932,1783
Sydney,2020,6,1226,905,2131
Sydney,2020,7,1993,926,2919
Sydney,2020,8,1329,1032,2361
Sydney,2020,9,1364,990,2354
Sydney,2020,10,1812,1115,2927
Sydney,2020,11,2425,1167,3592
Sydney,2020,12,4313,1183,5496
Sydney,2021,1,2155,1103,3258
Sydney,2021,2,3635,944,4579
Sydney,2021,3,6332,1078,7410
Sydney,2021,4,7573,1132,8705
Sydney,2021,5,7677,1324,9001
Sydney,2021,6,5999,1231,7230
Sydney,2021,7,1888,1113,3001
Sydney,2021,8,1218,1122,2340
Sydney,2021,9,1167,1098,2265
Sydney,2021,10,1226,1132,2358
Sydney,2021,11,3252,1241,4493
Sydney,2021,12,6500,1434,7934
Sydney,2022,1,5946,1512,7458
Sydney,2022,2,5544,1402,6946
Sydney,2022,3,7726,1655,9381
Sydney,2022,4,9314,1768,11082
Sydney,2022,5,9598,1833,11431
Sydney,2022,6,9026,1937,10963
Sydney,2022,7,9203,2296,11499
Sydney,2022,8,9181,2279,11460
Sydney,2022,9,8725,2231,10956
Sydney,2022,10,8990,2410,11400
Sydney,2022,11,9065,2594,11659
Sydney,2022,12,9127,2886,12013
Sydney,2023,1,8752,2991,11743
Sydney,2023,2,8526,2648,11174
Sydney,2023,3,9734,2918,12652
Sydney,2023,4,9099,2956,12055
Sydney,2023,5,9440,2953,12393
Sydney,2023,6,9087,3019,12106
Sydney,2023,7,9473,3260,12733
Sydney,2023,8,9559,3216,12775
Sydney,2023,9,9301,3154,12455
Sydney,2023,10,9449,3219,12668
Sydney,2023,11,9086,3263,12349
Sydney,2023,12,8959,3740,12699
Sydney,2024,1,8854,3770,12624
Sydney,2024,2,8619,3254,11873
Sydney,2024,3,9310,3375,12685
Sydney,2024,4,9304,3259,12563
Sydney,2024,5,9409,3221,12630
Sydney,2024,6,8793,3157,11950
Sydney,2024,7,9575,3386,12961
Sydney,2024,8,8986,3287,12273
Sydney,2024,9,8945,3210,12155
Sydney,2024,10,9399,3340,12739
Sydney,2024,11,8795,3321,12116
Sydney,2024,12,8727,3687,12414
Townsville,1985,1,694,9,703
Townsville,1985,2,623,8,631
Townsville,1985,3,710,8,718
Townsville,1985,4,682,9,691
Townsville,1985,5,795,9,804
Townsville,1985,6,733,8,741
Townsville,1985,7,792,10,802
Townsville,1985,8,779,8,787
Townsville,1985,9,764,9,773
Townsville,1985,10,732,9,741
Townsville,1985,11,741,8,749
Townsville,1985,12,746,9,755
Townsville,1986,1,706,9,715
Townsville,1986,2,566,8,574
Townsville,1986,3,677,8,685
Townsville,1986,4,653,13,666
Townsville,1986,5,764,16,780
Townsville,1986,6,693,17,710
Townsville,1986,7,731,14,745
Townsville,1986,8,771,14,785
Townsville,1986,9,738,16,754
Townsville,1986,10,780,13,793
Townsville,1986,11,750,13,763
Townsville,1986,12,755,13,768
Townsville,1987,1,733,14,747
Townsville,1987,2,638,12,650
Townsville,1987,3,721,12,733
Townsville,1987,4,720,11,731
Townsville,1987,5,773,9,782
Townsville,1987,6,677,8,685
Townsville,1987,7,724,9,733
Townsville,1987,8,708,9,717
Townsville,1987,9,687,12,699
Townsville,1987,10,713,14,727
Townsville,1987,11,636,13,649
Townsville,1987,12,640,13,653
Townsville,1988,1,629,19,648
Townsville,1988,2,566,12,578
Townsville,1988,3,660,13,673
Townsville,1988,4,741,15,756
Townsville,1988,5,724,14,738
Townsville,1988,6,704,12,716
Townsville,1988,7,727,14,741
Townsville,1988,8,721,14,735
Townsville,1988,9,749,15,764
Townsville,1988,10,736,13,749
Townsville,1988,11,676,19,695
Townsville,1988,12,703,26,729
Townsville,1989,1,679,21,700
Townsville,1989,2,608,21,629
Townsville,1989,3,684,24,708
Townsville,1989,4,701,23,724
Townsville,1989,5,743,22,765
Townsville,1989,6,703,23,726
Townsville,1989,7,714,24,738
Townsville,1989,8,551,21,572
Townsville,1989,9,314,23,337
Townsville,1989,10,348,21,369
Townsville,1989,11,306,18,324
Townsville,1989,12,314,14,328
Townsville,1990,1,347,12,359
Townsville,1990,2,365,12,377
Townsville,1990,3,426,16,442
Townsville,1990,4,460,12,472
Townsville,1990,5,490,13,503
Townsville,1990,6,530,14,544
Townsville,1990,7,534,13,547
Townsville,1990,8,549,13,562
Townsville,1990,9,516,16,532
Townsville,1990,10,538,13,551
Townsville,1990,11,488,13,501
Townsville,1990,12,429,14,443
Townsville,1991,1,641,18,659
Townsville,1991,2,575,12,587
Townsville,1991,3,644,14,658
Townsville,1991,4,608,0,608
Townsville,1991,5,618,0,618
Townsville,1991,6,607,0,607
Townsville,1991,7,630,0,630
Townsville,1991,8,657,0,657
Townsville,1991,9,606,0,606
Townsville,1991,10,631,0,631
Townsville,1991,11,611,0,611
Townsville,1991,12,612,0,612
Townsville,1992,1,597,0,597
Townsville,1992,2,564,0,564
Townsville,1992,3,558,0,558
Townsville,1992,4,561,0,561
Townsville,1992,5,572,0,572
Townsville,1992,6,554,0,554
Townsville,1992,7,598,0,598
Townsville,1992,8,585,0,585
Townsville,1992,9,600,0,600
Townsville,1992,10,640,0,640
Townsville,1992,11,620,8,628
Townsville,1992,12,621,10,631
Townsville,1993,1,601,8,609
Townsville,1993,2,562,8,570
Townsville,1993,3,592,8,600
Townsville,1993,4,574,9,583
Townsville,1993,5,555,8,563
Townsville,1993,6,560,9,569
Townsville,1993,7,587,11,598
Townsville,1993,8,590,10,600
Townsville,1993,9,625,8,633
Townsville,1993,10,631,9,640
Townsville,1993,11,621,8,629
Townsville,1993,12,621,8,629
Townsville,1994,1,635,10,645
Townsville,1994,2,575,8,583
Townsville,1994,3,657,9,666
Townsville,1994,4,629,5,634
Townsville,1994,5,655,4,659
Townsville,1994,6,641,4,645
Townsville,1994,7,643,5,648
Townsville,1994,8,651,4,655
Townsville,1994,9,669,4,673
Townsville,1994,10,701,5,706
Townsville,1994,11,671,0,671
Townsville,1994,12,663,0,663
Townsville,1995,1,656,0,656
Townsville,1995,2,588,0,588
Townsville,1995,3,681,0,681
Townsville,1995,4,662,0,662
Townsville,1995,5,680,0,680
Townsville,1995,6,676,0,676
Townsville,1995,7,739,0,739
Townsville,1995,8,743,0,743
Townsville,1995,9,722,0,722
Townsville,1995,10,739,0,739
Townsville,1995,11,701,0,701
Townsville,1995,12,692,0,692
Townsville,1996,1,717,0,717
Townsville,1996,2,649,0,649
Townsville,1996,3,708,0,708
Townsville,1996,4,712,0,712
Townsville,1996,5,734,0,734
Townsville,1996,6,694,0,694
Townsville,1996,7,760,0,760
Townsville,1996,8,730,0,730
Townsville,1996,9,742,0,742
Townsville,1996,10,800,0,800
Townsville,1996,11,786,0,786
Townsville,1996,12,778,0,778
Townsville,1997,1,755,0,755
Townsville,1997,2,681,0,681
Townsville,1997,3,730,0,730
Townsville,1997,4,742,0,742
Townsville,1997,5,758,4,762
Townsville,1997,6,734,13,747
Townsville,1997,7,795,12,807
Townsville,1997,8,769,15,784
Townsville,1997,9,756,2,758
Townsville,1997,10,782,9,791
Townsville,1997,11,732,0,732
Townsville,1997,12,728,0,728
Townsville,1998,1,695,0,695
Townsville,1998,2,616,0,616
Townsville,1998,3,688,0,688
Townsville,1998,4,690,0,690
Townsville,1998,5,704,0,704
Townsville,1998,6,702,0,702
Townsville,1998,7,780,0,780
Townsville,1998,8,796,0,796
Townsville,1998,9,753,0,753
Townsville,1998,10,777,6,783
Townsville,1998,11,749,7,756
Townsville,1998,12,749,9,758
Townsville,1999,1,699,8,707
Townsville,1999,2,645,6,651
Townsville,1999,3,742,0,742
Townsville,1999,4,740,0,740
Townsville,1999,5,746,0,746
Townsville,1999,6,757,0,757
Townsville,1999,7,775,0,775
Townsville,1999,8,750,0,750
Townsville,1999,9,745,0,745
Townsville,1999,10,744,0,744
Townsville,1999,11,719,0,719
Townsville,1999,12,710,0,710
Townsville,2000,1,693,0,693
Townsville,2000,2,734,0,734
Townsville,2000,3,824,0,824
Townsville,2000,4,727,0,727
Townsville,2000,5,809,0,809
Townsville,2000,6,787,0,787
Townsville,2000,7,802,0,802
Townsville,2000,8,819,0,819
Townsville,2000,9,791,0,791
Townsville,2000,10,844,0,844
Townsville,2000,11,815,0,815
Townsville,2000,12,760,0,760
Townsville,2001,1,720,0,720
Townsville,2001,2,724,0,724
Townsville,2001,3,829,0,829
Townsville,2001,4,825,0,825
Townsville,2001,5,863,0,863
Townsville,2001,6,723,0,723
Townsville,2001,7,571,0,571
Townsville,2001,8,566,0,566
Townsville,2001,9,500,0,500
Townsville,2001,10,522,2,524
Townsville,2001,11,562,8,570
Townsville,2001,12,551,8,559
Townsville,2002,1,527,0,527
Townsville,2002,2,495,0,495
Townsville,2002,3,525,0,525
Townsville,2002,4,525,0,525
Townsville,2002,5,537,0,537
Townsville,2002,6,502,0,502
Townsville,2002,7,572,0,572
Townsville,2002,8,648,0,648
Townsville,2002,9,627,0,627
Townsville,2002,10,646,0,646
Townsville,2002,11,618,0,618
Townsville,2002,12,604,0,604
Townsville,2003,1,648,0,648
Townsville,2003,2,615,0,615
Townsville,2003,3,672,0,672
Townsville,2003,4,643,0,643
Townsville,2003,5,696,0,696
Townsville,2003,6,651,0,651
Townsville,2003,7,694,0,694
Townsville,2003,8,705,0,705
Townsville,2003,9,708,0,708
Townsville,2003,10,745,0,745
Townsville,2003,11,717,0,717
Townsville,2003,12,723,0,723
Townsville,2004,1,719,0,719
Townsville,2004,2,684,0,684
Townsville,2004,3,747,0,747
Townsville,2004,4,734,0,734
Townsville,2004,5,768,0,768
Townsville,2004,6,761,0,761
Townsville,2004,7,801,0,801
Townsville,2004,8,788,0,788
Townsville,2004,9,786,0,786
Townsville,2004,10,784,0,784
Townsville,2004,11,757,0,757
Townsville,2004,12,741,0,741
Townsville,2005,1,780,0,780
Townsville,2005,2,791,0,791
Townsville,2005,3,909,0,909
Townsville,2005,4,1004,0,1004
Townsville,2005,5,941,0,941
Townsville,2005,6,936,0,936
Townsville,2005,7,946,0,946
Townsville,2005,8,973,0,973
Townsville,2005,9,909,0,909
Townsville,2005,10,934,0,934
Townsville,2005,11,986,0,986
Townsville,2005,12,927,0,927
Townsville,2006,1,896,0,896
Townsville,2006,2,859,0,859
Townsville,2006,3,935,2,937
Townsville,2006,4,881,0,881
Townsville,2006,5,923,1,924
Townsville,2006,6,896,0,896
Townsville,2006,7,936,0,936
Townsville,2006,8,940,0,940
Townsville,2006,9,905,0,905
Townsville,2006,10,938,0,938
Townsville,2006,11,894,0,894
Townsville,2006,12,847,0,847
Townsville,2007,1,827,0,827
Townsville,2007,2,849,0,849
Townsville,2007,3,927,0,927
Townsville,2007,4,796,0,796
Townsville,2007,5,863,0,863
Townsville,2007,6,836,0,836
Townsville,2007,7,842,0,842
Townsville,2007,8,862,0,862
Townsville,2007,9,800,0,800
Townsville,2007,10,882,0,882
Townsville,2007,11,853,0,853
Townsville,2007,12,838,0,838
Townsville,2008,1,802,0,802
Townsville,2008,2,810,0,810
Townsville,2008,3,850,0,850
Townsville,2008,4,814,0,814
Townsville,2008,5,860,0,860
Townsville,2008,6,844,0,844
Townsville,2008,7,910,0,910
Townsville,2008,8,896,0,896
Townsville,2008,9,826,0,826
Townsville,2008,10,861,0,861
Townsville,2008,11,825,0,825
Townsville,2008,12,817,0,817
Townsville,2009,1,731,0,731
Townsville,2009,2,759,0,759
Townsville,2009,3,876,0,876
Townsville,2009,4,977,0,977
Townsville,2009,5,1017,0,1017
Townsville,2009,6,993,0,993
Townsville,2009,7,1059,0,1059
Townsville,2009,8,1003,0,1003
Townsville,2009,9,993,0,993
Townsville,2009,10,1100,0,1100
Townsville,2009,11,1132,0,1132
Townsville,2009,12,1066,0,1066
Townsville,2010,1,1037,0,1037
Townsville,2010,2,893,0,893
Townsville,2010,3,995,0,995
Townsville,2010,4,1131,0,1131
Townsville,2010,5,1223,0,1223
Townsville,2010,6,1222,0,1222
Townsville,2010,7,1287,0,1287
Townsville,2010,8,1315,0,1315
Townsville,2010,9,1232,0,1232
Townsville,2010,10,1242,0,1242
Townsville,2010,11,1262,0,1262
Townsville,2010,12,1202,7,1209
Townsville,2011,1,1077,9,1086
Townsville,2011,2,1054,8,1062
Townsville,2011,3,1229,7,1236
Townsville,2011,4,1173,4,1177
Townsville,2011,5,1250,5,1255
Townsville,2011,6,1215,4,1219
Townsville,2011,7,1242,5,1247
Townsville,2011,8,1285,4,1289
Townsville,2011,9,1223,4,1227
Townsville,2011,10,1173,2,1175
Townsville,2011,11,1179,0,1179
Townsville,2011,12,1108,0,1108
Townsville,2012,1,1016,0,1016
Townsville,2012,2,1130,0,1130
Townsville,2012,3,1170,0,1170
Townsville,2012,4,1124,0,1124
Townsville,2012,5,1181,0,1181
Townsville,2012,6,1128,0,1128
Townsville,2012,7,1179,0,1179
Townsville,2012,8,1216,0,1216
Townsville,2012,9,1143,0,1143
Townsville,2012,10,1215,0,1215
Townsville,2012,11,1180,0,1180
Townsville,2012,12,1068,0,1068
Townsville,2013,1,1040,0,1040
Townsville,2013,2,1040,0,1040
Townsville,2013,3,1146,0,1146
Townsville,2013,4,1125,0,1125
Townsville,2013,5,1203,0,1203
Townsville,2013,6,1093,0,1093
Townsville,2013,7,1195,0,1195
Townsville,2013,8,1173,0,1173
Townsville,2013,9,1143,0,1143
Townsville,2013,10,1199,0,1199
Townsville,2013,11,1094,0,1094
Townsville,2013,12,1059,0,1059
Townsville,2014,1,1001,0,1001
Townsville,2014,2,988,0,988
Townsville,2014,3,1038,0,1038
Townsville,2014,4,1002,0,1002
Townsville,2014,5,1104,0,1104
Townsville,2014,6,1070,0,1070
Townsville,2014,7,1148,0,1148
Townsville,2014,8,1106,0,1106
Townsville,2014,9,1106,0,1106
Townsville,2014,10,1140,0,1140
Townsville,2014,11,1044,0,1044
Townsville,2014,12,1018,0,1018
Townsville,2015,1,1018,0,1018
Townsville,2015,2,976,0,976
Townsville,2015,3,1083,0,1083
Townsville,2015,4,1024,0,1024
Townsville,2015,5,1042,0,1042
Townsville,2015,6,1017,0,1017
Townsville,2015,7,1116,0,1116
Townsville,2015,8,1088,0,1088
Townsville,2015,9,1067,12,1079
Townsville,2015,10,1070,13,1083
Townsville,2015,11,1025,5,1030
Townsville,2015,12,989,14,1003
Townsville,2016,1,964,13,977
Townsville,2016,2,987,12,999
Townsville,2016,3,1049,13,1062
Townsville,2016,4,1021,12,1033
Townsville,2016,5,1059,14,1073
Townsville,2016,6,1065,13,1078
Townsville,2016,7,1089,13,1102
Townsville,2016,8,1157,12,1169
Townsville,2016,9,1095,13,1108
Townsville,2016,10,1080,13,1093
Townsville,2016,11,1071,12,1083
Townsville,2016,12,1015,13,1028
Townsville,2017,1,1014,14,1028
Townsville,2017,2,970,12,982
Townsville,2017,3,1019,12,1031
Townsville,2017,4,1002,21,1023
Townsville,2017,5,1088,22,1110
Townsville,2017,6,1073,22,1095
Townsville,2017,7,1123,22,1145
Townsville,2017,8,1162,22,1184
Townsville,2017,9,1079,21,1100
Townsville,2017,10,1095,23,1118
Townsville,2017,11,1055,18,1073
Townsville,2017,12,983,21,1004
Townsville,2018,1,1030,22,1052
Townsville,2018,2,938,20,958
Townsville,2018,3,1016,18,1034
Townsville,2018,4,986,9,995
Townsville,2018,5,1057,8,1065
Townsville,2018,6,1007,9,1016
Townsville,2018,7,1075,9,1084
Townsville,2018,8,1060,9,1069
Townsville,2018,9,993,8,1001
Townsville,2018,10,1050,0,1050
Townsville,2018,11,995,0,995
Townsville,2018,12,888,0,888
Townsville,2019,1,927,0,927
Townsville,2019,2,812,0,812
Townsville,2019,3,967,0,967
Townsville,2019,4,992,0,992
Townsville,2019,5,1079,0,1079
Townsville,2019,6,998,0,998
Townsville,2019,7,1078,0,1078
Townsville,2019,8,1060,0,1060
Townsville,2019,9,1042,0,1042
Townsville,2019,10,1072,0,1072
Townsville,2019,11,1005,0,1005
Townsville,2019,12,970,0,970
Townsville,2020,1,958,0,958
Townsville,2020,2,921,0,921
Townsville,2020,3,877,0,877
Townsville,2020,4,221,0,221
Townsville,2020,5,237,0,237
Townsville,2020,6,323,0,323
Townsville,2020,7,551,0,551
Townsville,2020,8,610,0,610
Townsville,2020,9,670,0,670
Townsville,2020,10,691,0,691
Townsville,2020,11,708,0,708
Townsville,2020,12,739,0,739
Townsville,2021,1,667,0,667
Townsville,2021,2,703,0,703
Townsville,2021,3,832,0,832
Townsville,2021,4,780,0,780
Townsville,2021,5,839,0,839
Townsville,2021,6,863,0,863
Townsville,2021,7,855,0,855
Townsville,2021,8,750,0,750
Townsville,2021,9,848,0,848
Townsville,2021,10,849,0,849
Townsville,2021,11,908,0,908
Townsville,2021,12,972,0,972
Townsville,2022,1,822,0,822
Townsville,2022,2,754,0,754
Townsville,2022,3,991,0,991
Townsville,2022,4,955,0,955
Townsville,2022,5,1056,0,1056
Townsville,2022,6,1079,0,1079
Townsville,2022,7,1027,0,1027
Townsville,2022,8,1075,0,1075
Townsville,2022,9,999,0,999
Townsville,2022,10,1012,0,1012
Townsville,2022,11,1030,0,1030
Townsville,2022,12,966,0,966
Townsville,2023,1,961,0,961
Townsville,2023,2,922,0,922
Townsville,2023,3,1078,0,1078
Townsville,2023,4,1002,0,1002
Townsville,2023,5,1121,0,1121
Townsville,2023,6,1063,0,1063
Townsville,2023,7,1063,0,1063
Townsville,2023,8,1109,0,1109
Townsville,2023,9,1037,0,1037
Townsville,2023,10,1086,0,1086
Townsville,2023,11,1056,0,1056
Townsville,2023,12,949,0,949
Townsville,2024,1,903,0,903
Townsville,2024,2,909,0,909
Townsville,2024,3,1005,0,1005
Townsville,2024,4,995,0,995
Townsville,2024,5,1018,0,1018
Townsville,2024,6,955,0,955
Townsville,2024,7,1105,0,1105
Townsville,2024,8,1069,0,1069
Townsville,2024,9,1045,0,1045
Townsville,2024,10,1084,0,1084
Townsville,2024,11,985,0,985
Townsville,2024,12,956,0,956
All Australian Airports,1985,1,34670,1759,36429
All Australian Airports,1985,2,31181,1599,32780
All Australian Airports,1985,3,35812,1762,37574
All Australian Airports,1985,4,34463,1693,36156
All Australian Airports,1985,5,37863,1774,39637
All Australian Airports,1985,6,34215,1715,35930
All Australian Airports,1985,7,34088,1673,35761
All Australian Airports,1985,8,37299,1800,39099
All Australian Airports,1985,9,35965,1742,37707
All Australian Airports,1985,10,37207,1767,38974
All Australian Airports,1985,11,35955,1834,37789
All Australian Airports,1985,12,36472,1945,38417
All Australian Airports,1986,1,35804,1981,37785
All Australian Airports,1986,2,31883,1718,33601
All Australian Airports,1986,3,35225,1926,37151
All Australian Airports,1986,4,35040,1941,36981
All Australian Airports,1986,5,36834,2051,38885
All Australian Airports,1986,6,34678,1979,36657
All Australian Airports,1986,7,35573,2035,37608
All Australian Airports,1986,8,36781,2079,38860
All Australian Airports,1986,9,36729,1913,38642
All Australian Airports,1986,10,36695,2133,38828
All Australian Airports,1986,11,34938,2153,37091
All Australian Airports,1986,12,37517,2241,39758
All Australian Airports,1987,1,35518,2303,37821
All Australian Airports,1987,2,33194,2035,35229
All Australian Airports,1987,3,35950,2207,38157
All Australian Airports,1987,4,35736,2122,37858
All Australian Airports,1987,5,34216,2221,36437
All Australian Airports,1987,6,34302,2113,36415
All Australian Airports,1987,7,36872,2256,39128
All Australian Airports,1987,8,35812,2269,38081
All Australian Airports,1987,9,36264,2198,38462
All Australian Airports,1987,10,37469,2328,39797
All Australian Airports,1987,11,36667,2286,38953
All Australian Airports,1987,12,37913,2457,40370
All Australian Airports,1988,1,35486,2530,38016
All Australian Airports,1988,2,33515,2278,35793
All Australian Airports,1988,3,37193,2350,39543
All Australian Airports,1988,4,35852,2410,38262
All Australian Airports,1988,5,36162,2506,38668
All Australian Airports,1988,6,36417,2430,38847
All Australian Airports,1988,7,39467,2570,42037
All Australian Airports,1988,8,40066,2547,42613
All Australian Airports,1988,9,40441,2469,42910
All Australian Airports,1988,10,39981,2597,42578
All Australian Airports,1988,11,37938,2643,40581
All Australian Airports,1988,12,37962,2885,40847
All Australian Airports,1989,1,37156,2936,40092
All Australian Airports,1989,2,34391,2594,36985
All Australian Airports,1989,3,37501,2747,40248
All Australian Airports,1989,4,35663,2762,38425
All Australian Airports,1989,5,36759,2778,39537
All Australian Airports,1989,6,35108,2646,37754
All Australian Airports,1989,7,36075,2799,38874
All Australian Airports,1989,8,28818,2824,31642
All Australian Airports,1989,9,22160,2823,24983
All Australian Airports,1989,10,26147,2929,29076
All Australian Airports,1989,11,27709,2917,30626
All Australian Airports,1989,12,28833,3029,31862
All Australian Airports,1990,1,30592,3074,33666
All Australian Airports,1990,2,28707,2779,31486
All Australian Airports,1990,3,32357,3040,35397
All Australian Airports,1990,4,33873,2940,36813
All Australian Airports,1990,5,35219,3024,38243
All Australian Airports,1990,6,34105,2934,37039
All Australian Airports,1990,7,36419,3056,39475
All Australian Airports,1990,8,35941,3074,39015
All Australian Airports,1990,9,36236,2971,39207
All Australian Airports,1990,10,39250,3114,42364
All Australian Airports,1990,11,37188,3122,40310
All Australian Airports,1990,12,35305,3273,38578
All Australian Airports,1991,1,37068,3293,40361
All Australian Airports,1991,2,33831,2933,36764
All Australian Airports,1991,3,37322,3235,40557
All Australian Airports,1991,4,38070,2910,40980
All Australian Airports,1991,5,39047,2987,42034
All Australian Airports,1991,6,38506,2991,41497
All Australian Airports,1991,7,41158,3100,44258
All Australian Airports,1991,8,39839,3109,42948
All Australian Airports,1991,9,39849,2993,42842
All Australian Airports,1991,10,42247,3088,45335
All Australian Airports,1991,11,41630,3139,44769
All Australian Airports,1991,12,41254,3310,44564
All Australian Airports,1992,1,40729,3330,44059
All Australian Airports,1992,2,38030,3112,41142
All Australian Airports,1992,3,41314,3304,44618
All Australian Airports,1992,4,41245,3278,44523
All Australian Airports,1992,5,41861,3377,45238
All Australian Airports,1992,6,41584,3250,44834
All Australian Airports,1992,7,43983,3372,47355
All Australian Airports,1992,8,42167,3415,45582
All Australian Airports,1992,9,44195,3334,47529
All Australian Airports,1992,10,45739,3484,49223
All Australian Airports,1992,11,43473,3530,47003
All Australian Airports,1992,12,44472,3774,48246
All Australian Airports,1993,1,42926,3729,46655
All Australian Airports,1993,2,40449,3389,43838
All Australian Airports,1993,3,44596,3665,48261
All Australian Airports,1993,4,44170,3572,47742
All Australian Airports,1993,5,43563,3680,47243
All Australian Airports,1993,6,43146,3526,46672
All Australian Airports,1993,7,44088,3717,47805
All Australian Airports,1993,8,44230,3673,47903
All Australian Airports,1993,9,44372,3606,47978
All Australian Airports,1993,10,46191,3776,49967
All Australian Airports,1993,11,44565,3558,48123
All Australian Airports,1993,12,45216,3786,49002
All Australian Airports,1994,1,43413,3803,47216
All Australian Airports,1994,2,40735,3390,44125
All Australian Airports,1994,3,46486,3679,50165
All Australian Airports,1994,4,44427,3510,47937
All Australian Airports,1994,5,45655,3628,49283
All Australian Airports,1994,6,44993,3528,48521
All Australian Airports,1994,7,47448,3714,51162
All Australian Airports,1994,8,47616,3651,51267
All Australian Airports,1994,9,46950,3646,50596
All Australian Airports,1994,10,48357,3812,52169
All Australian Airports,1994,11,46359,3804,50163
All Australian Airports,1994,12,47584,3962,51546
All Australian Airports,1995,1,45318,4010,49328
All Australian Airports,1995,2,42933,3606,46539
All Australian Airports,1995,3,48138,3947,52085
All Australian Airports,1995,4,47166,3881,51047
All Australian Airports,1995,5,48249,3979,52228
All Australian Airports,1995,6,47164,3900,51064
All Australian Airports,1995,7,48695,4074,52769
All Australian Airports,1995,8,49143,4050,53193
All Australian Airports,1995,9,48004,3915,51919
All Australian Airports,1995,10,49797,4076,53873
All Australian Airports,1995,11,48511,4017,52528
All Australian Airports,1995,12,47825,4266,52091
All Australian Airports,1996,1,48089,4270,52359
All Australian Airports,1996,2,46132,4061,50193
All Australian Airports,1996,3,49265,4250,53515
All Australian Airports,1996,4,48457,4154,52611
All Australian Airports,1996,5,49839,4252,54091
All Australian Airports,1996,6,47315,4173,51488
All Australian Airports,1996,7,50956,4374,55330
All Australian Airports,1996,8,50246,4355,54601
All Australian Airports,1996,9,49027,4271,53298
All Australian Airports,1996,10,51330,4350,55680
All Australian Airports,1996,11,49277,4346,53623
All Australian Airports,1996,12,48858,4567,53425
All Australian Airports,1997,1,47507,4551,52058
All Australian Airports,1997,2,44937,4089,49026
All Australian Airports,1997,3,48835,4458,53293
All Australian Airports,1997,4,47851,4240,52091
All Australian Airports,1997,5,48564,4377,52941
All Australian Airports,1997,6,47092,4259,51351
All Australian Airports,1997,7,50638,4502,55140
All Australian Airports,1997,8,49701,4494,54195
All Australian Airports,1997,9,49254,4288,53542
All Australian Airports,1997,10,50964,4499,55463
All Australian Airports,1997,11,48079,4494,52573
All Australian Airports,1997,12,48301,4668,52969
All Australian Airports,1998,1,46997,4654,51651
All Australian Airports,1998,2,44341,4124,48465
All Australian Airports,1998,3,49365,4490,53855
All Australian Airports,1998,4,48119,4386,52505
All Australian Airports,1998,5,48726,4537,53263
All Australian Airports,1998,6,47376,4294,51670
All Australian Airports,1998,7,50304,4510,54814
All Australian Airports,1998,8,49760,4566,54326
All Australian Airports,1998,9,49751,4400,54151
All Australian Airports,1998,10,50954,4568,55522
All Australian Airports,1998,11,49204,4324,53528
All Australian Airports,1998,12,49616,4494,54110
All Australian Airports,1999,1,47314,4559,51873
All Australian Airports,1999,2,45302,4098,49400
All Australian Airports,1999,3,50772,4484,55256
All Australian Airports,1999,4,48842,4312,53154
All Australian Airports,1999,5,49547,4383,53930
All Australian Airports,1999,6,48368,4180,52548
All Australian Airports,1999,7,49836,4496,54332
All Australian Airports,1999,8,50098,4491,54589
All Australian Airports,1999,9,49297,4347,53644
All Australian Airports,1999,10,50302,4482,54784
All Australian Airports,1999,11,48839,4392,53231
All Australian Airports,1999,12,49095,4598,53693
All Australian Airports,2000,1,46320,4673,50993
All Australian Airports,2000,2,45871,4351,50222
All Australian Airports,2000,3,50400,4623,55023
All Australian Airports,2000,4,47852,4615,52467
All Australian Airports,2000,5,50984,4631,55615
All Australian Airports,2000,6,50583,4527,55110
All Australian Airports,2000,7,51801,4848,56649
All Australian Airports,2000,8,53116,4797,57913
All Australian Airports,2000,9,51541,4734,56275
All Australian Airports,2000,10,53691,4808,58499
All Australian Airports,2000,11,52127,4643,56770
All Australian Airports,2000,12,51494,4946,56440
All Australian Airports,2001,1,50819,4906,55725
All Australian Airports,2001,2,47966,4289,52255
All Australian Airports,2001,3,54166,4779,58945
All Australian Airports,2001,4,51824,4685,56509
All Australian Airports,2001,5,52923,4711,57634
All Australian Airports,2001,6,48870,4579,53449
All Australian Airports,2001,7,49879,4679,54558
All Australian Airports,2001,8,50611,4651,55262
All Australian Airports,2001,9,38495,4456,42951
All Australian Airports,2001,10,38548,4505,43053
All Australian Airports,2001,11,39859,4246,44105
All Australian Airports,2001,12,39967,4595,44562
All Australian Airports,2002,1,39227,4491,43718
All Australian Airports,2002,2,37123,4004,41127
All Australian Airports,2002,3,38889,4403,43292
All Australian Airports,2002,4,38199,4177,42376
All Australian Airports,2002,5,39751,4350,44101
All Australian Airports,2002,6,38148,4246,42394
All Australian Airports,2002,7,41669,4526,46195
All Australian Airports,2002,8,41566,4531,46097
All Australian Airports,2002,9,41303,4336,45639
All Australian Airports,2002,10,42712,4487,47199
All Australian Airports,2002,11,40119,4493,44612
All Australian Airports,2002,12,40005,4704,44709
All Australian Airports,2003,1,38983,4692,43675
All Australian Airports,2003,2,36770,4223,40993
All Australian Airports,2003,3,40344,4593,44937
All Australian Airports,2003,4,38308,4364,42672
All Australian Airports,2003,5,39779,4176,43955
All Australian Airports,2003,6,38473,4028,42501
All Australian Airports,2003,7,40636,4442,45078
All Australian Airports,2003,8,40065,4564,44629
All Australian Airports,2003,9,40751,4535,45286
All Australian Airports,2003,10,42368,4760,47128
All Australian Airports,2003,11,40736,4873,45609
All Australian Airports,2003,12,40874,5103,45977
All Australian Airports,2004,1,40201,5183,45384
All Australian Airports,2004,2,39684,4810,44494
All Australian Airports,2004,3,43506,5181,48687
All Australian Airports,2004,4,41603,5112,46715
All Australian Airports,2004,5,42649,5282,47931
All Australian Airports,2004,6,43109,5145,48254
All Australian Airports,2004,7,45090,5528,50618
All Australian Airports,2004,8,45825,5482,51307
All Australian Airports,2004,9,45293,5385,50678
All Australian Airports,2004,10,46046,5562,51608
All Australian Airports,2004,11,45062,5477,50539
All Australian Airports,2004,12,45610,5830,51440
All Australian Airports,2005,1,43186,5863,49049
All Australian Airports,2005,2,41587,5219,46806
All Australian Airports,2005,3,45764,5649,51413
All Australian Airports,2005,4,44687,5543,50230
All Australian Airports,2005,5,46024,5635,51659
All Australian Airports,2005,6,44920,5522,50442
All Australian Airports,2005,7,46220,5829,52049
All Australian Airports,2005,8,46988,5699,52687
All Australian Airports,2005,9,45658,5537,51195
All Australian Airports,2005,10,46516,5667,52183
All Australian Airports,2005,11,45156,5348,50504
All Australian Airports,2005,12,44885,5683,50568
All Australian Airports,2006,1,42745,5767,48512
All Australian Airports,2006,2,41432,5125,46557
All Australian Airports,2006,3,46659,5555,52214
All Australian Airports,2006,4,43688,5345,49033
All Australian Airports,2006,5,46887,5379,52266
All Australian Airports,2006,6,44576,5291,49867
All Australian Airports,2006,7,45832,5646,51478
All Australian Airports,2006,8,46511,5551,52062
All Australian Airports,2006,9,45325,5443,50768
All Australian Airports,2006,10,46024,5513,51537
All Australian Airports,2006,11,45139,5456,50595
All Australian Airports,2006,12,44084,5741,49825
All Australian Airports,2007,1,42620,5758,48378
All Australian Airports,2007,2,41158,5190,46348
All Australian Airports,2007,3,46572,5683,52255
All Australian Airports,2007,4,43939,5424,49363
All Australian Airports,2007,5,46717,5534,52251
All Australian Airports,2007,6,44699,5459,50158
All Australian Airports,2007,7,46523,5724,52247
All Australian Airports,2007,8,47743,5681,53424
All Australian Airports,2007,9,45192,5555,50747
All Australian Airports,2007,10,47704,5721,53425
All Australian Airports,2007,11,46390,5621,52011
All Australian Airports,2007,12,46121,5994,52115
All Australian Airports,2008,1,45726,6036,51762
All Australian Airports,2008,2,44869,5559,50428
All Australian Airports,2008,3,47416,5871,53287
All Australian Airports,2008,4,46685,5772,52457
All Australian Airports,2008,5,48466,5932,54398
All Australian Airports,2008,6,46462,5776,52238
All Australian Airports,2008,7,48863,6174,55037
All Australian Airports,2008,8,48244,6030,54274
All Australian Airports,2008,9,47568,5886,53454
All Australian Airports,2008,10,49758,6151,55909
All Australian Airports,2008,11,47299,6043,53342
All Australian Airports,2008,12,47004,6502,53506
All Australian Airports,2009,1,44493,6506,50999
All Australian Airports,2009,2,41580,5634,47214
All Australian Airports,2009,3,46527,6182,52709
All Australian Airports,2009,4,45622,6046,51668
All Australian Airports,2009,5,46550,6058,52608
All Australian Airports,2009,6,45535,5921,51456
All Australian Airports,2009,7,48421,6366,54787
All Australian Airports,2009,8,47006,6405,53411
All Australian Airports,2009,9,46917,6220,53137
All Australian Airports,2009,10,48808,6453,55261
All Australian Airports,2009,11,46958,6256,53214
All Australian Airports,2009,12,46886,6764,53650
All Australian Airports,2010,1,45369,6867,52236
All Australian Airports,2010,2,43979,6069,50048
All Australian Airports,2010,3,50283,6628,56911
All Australian Airports,2010,4,49779,6319,56098
All Australian Airports,2010,5,50649,6392,57041
All Australian Airports,2010,6,49279,6322,55601
All Australian Airports,2010,7,52565,6869,59434
All Australian Airports,2010,8,51655,6713,58368
All Australian Airports,2010,9,50847,6536,57383
All Australian Airports,2010,10,52211,6685,58896
All Australian Airports,2010,11,51123,6530,57653
All Australian Airports,2010,12,52122,7061,59183
All Australian Airports,2011,1,48440,7219,55659
All Australian Airports,2011,2,45609,6282,51891
All Australian Airports,2011,3,52333,6874,59207
All Australian Airports,2011,4,50323,6772,57095
All Australian Airports,2011,5,51782,6791,58573
All Australian Airports,2011,6,48585,6338,54923
All Australian Airports,2011,7,51895,7039,58934
All Australian Airports,2011,8,52557,6940,59497
All Australian Airports,2011,9,50999,6735,57734
All Australian Airports,2011,10,51209,6965,58174
All Australian Airports,2011,11,51000,6707,57707
All Australian Airports,2011,12,50824,7193,58017
All Australian Airports,2012,1,49228,7340,56568
All Australian Airports,2012,2,49322,6471,55793
All Australian Airports,2012,3,53209,6797,60006
All Australian Airports,2012,4,51372,6807,58179
All Australian Airports,2012,5,52545,6628,59173
All Australian Airports,2012,6,50057,6664,56721
All Australian Airports,2012,7,54770,7306,62076
All Australian Airports,2012,8,55522,7185,62707
All Australian Airports,2012,9,53425,6980,60405
All Australian Airports,2012,10,55950,7139,63089
All Australian Airports,2012,11,54319,6880,61199
All Australian Airports,2012,12,52143,7448,59591
All Australian Airports,2013,1,51211,7471,58682
All Australian Airports,2013,2,48054,6509,54563
All Australian Airports,2013,3,53740,7217,60957
All Australian Airports,2013,4,54109,7049,61158
All Australian Airports,2013,5,54686,6951,61637
All Australian Airports,2013,6,51635,6988,58623
All Australian Airports,2013,7,56470,7733,64203
All Australian Airports,2013,8,55323,7573,62896
All Australian Airports,2013,9,54705,7421,62126
All Australian Airports,2013,10,56616,7691,64307
All Australian Airports,2013,11,53216,7369,60585
All Australian Airports,2013,12,52930,8095,61025
All Australian Airports,2014,1,51429,8227,59656
All Australian Airports,2014,2,47544,6986,54530
All Australian Airports,2014,3,53457,7682,61139
All Australian Airports,2014,4,52824,7535,60359
All Australian Airports,2014,5,53641,7284,60925
All Australian Airports,2014,6,51595,7275,58870
All Australian Airports,2014,7,55239,7932,63171
All Australian Airports,2014,8,53607,7685,61292
All Australian Airports,2014,9,53860,7463,61323
All Australian Airports,2014,10,55793,7618,63411
All Australian Airports,2014,11,51845,7144,58989
All Australian Airports,2014,12,52827,8037,60864
All Australian Airports,2015,1,50494,8181,58675
All Australian Airports,2015,2,47706,6879,54585
All Australian Airports,2015,3,54023,7377,61400
All Australian Airports,2015,4,52551,7357,59908
All Australian Airports,2015,5,52974,7154,60128
All Australian Airports,2015,6,52485,7133,59618
All Australian Airports,2015,7,55930,7780,63710
All Australian Airports,2015,8,54276,7462,61738
All Australian Airports,2015,9,54304,7314,61618
All Australian Airports,2015,10,55440,7614,63054
All Australian Airports,2015,11,53295,7252,60547
All Australian Airports,2015,12,53445,8454,61899
All Australian Airports,2016,1,50777,8707,59484
All Australian Airports,2016,2,50973,7544,58517
All Australian Airports,2016,3,54883,7946,62829
All Australian Airports,2016,4,53135,7803,60938
All Australian Airports,2016,5,53112,7662,60774
All Australian Airports,2016,6,51580,7664,59244
All Australian Airports,2016,7,55254,8456,63710
All Australian Airports,2016,8,55812,8079,63891
All Australian Airports,2016,9,55009,7948,62957
All Australian Airports,2016,10,55316,8269,63585
All Australian Airports,2016,11,54099,7877,61976
All Australian Airports,2016,12,53720,8861,62581
All Australian Airports,2017,1,51488,9025,60513
All Australian Airports,2017,2,48976,7629,56605
All Australian Airports,2017,3,54779,8219,62998
All Australian Airports,2017,4,51785,8196,59981
All Australian Airports,2017,5,53546,7869,61415
All Australian Airports,2017,6,51988,7985,59973
All Australian Airports,2017,7,55055,9044,64099
All Australian Airports,2017,8,55256,8412,63668
All Australian Airports,2017,9,53229,8282,61511
All Australian Airports,2017,10,55380,8561,63941
All Australian Airports,2017,11,54049,8168,62217
All Australian Airports,2017,12,52679,9245,61924
All Australian Airports,2018,1,51588,9435,61023
All Australian Airports,2018,2,48581,8026,56607
All Australian Airports,2018,3,53753,8696,62449
All Australian Airports,2018,4,52057,8594,60651
All Australian Airports,2018,5,52777,8309,61086
All Australian Airports,2018,6,49857,8397,58254
All Australian Airports,2018,7,54219,9230,63449
All Australian Airports,2018,8,53893,8905,62798
All Australian Airports,2018,9,52023,8610,60633
All Australian Airports,2018,10,55482,8916,64398
All Australian Airports,2018,11,53238,8592,61830
All Australian Airports,2018,12,51672,9484,61156
All Australian Airports,2019,1,51456,9645,61101
All Australian Airports,2019,2,48624,8206,56830
All Australian Airports,2019,3,53619,8771,62390
All Australian Airports,2019,4,53384,8631,62015
All Australian Airports,2019,5,54345,8365,62710
All Australian Airports,2019,6,50994,8397,59391
All Australian Airports,2019,7,55839,9163,65002
All Australian Airports,2019,8,53458,8813,62271
All Australian Airports,2019,9,53319,8592,61911
All Australian Airports,2019,10,56051,8915,64966
All Australian Airports,2019,11,52514,8662,61176
All Australian Airports,2019,12,52026,9654,61680
All Australian Airports,2020,1,50134,9870,60004
All Australian Airports,2020,2,48327,7860,56187
All Australian Airports,2020,3,43051,5914,48965
All Australian Airports,2020,4,8240,1302,9542
All Australian Airports,2020,5,7820,1592,9412
All Australian Airports,2020,6,10334,1511,11845
All Australian Airports,2020,7,14904,1611,16515
All Australian Airports,2020,8,14250,1769,16019
All Australian Airports,2020,9,16047,1764,17811
All Australian Airports,2020,10,18193,1920,20113
All Australian Airports,2020,11,20641,2000,22641
All Australian Airports,2020,12,30349,2089,32438
All Australian Airports,2021,1,25948,1932,27880
All Australian Airports,2021,2,26186,1669,27855
All Australian Airports,2021,3,37149,1915,39064
All Australian Airports,2021,4,42850,2150,45000
All Australian Airports,2021,5,43718,2666,46384
All Australian Airports,2021,6,36378,2517,38895
All Australian Airports,2021,7,27353,2488,29841
All Australian Airports,2021,8,19364,2185,21549
All Australian Airports,2021,9,20698,2186,22884
All Australian Airports,2021,10,21366,2260,23626
All Australian Airports,2021,11,26901,2434,29335
All Australian Airports,2021,12,39602,2866,42468
All Australian Airports,2022,1,36732,2993,39725
All Australian Airports,2022,2,32229,2891,35120
All Australian Airports,2022,3,43723,3469,47192
All Australian Airports,2022,4,49940,3913,53853
All Australian Airports,2022,5,50836,4223,55059
All Australian Airports,2022,6,49343,4517,53860
All Australian Airports,2022,7,49167,5405,54572
All Australian Airports,2022,8,49234,5364,54598
All Australian Airports,2022,9,47974,5286,53260
All Australian Airports,2022,10,48841,5655,54496
All Australian Airports,2022,11,49144,6166,55310
All Australian Airports,2022,12,49516,6959,56475
All Australian Airports,2023,1,48916,7310,56226
All Australian Airports,2023,2,45948,6390,52338
All Australian Airports,2023,3,52582,7038,59620
All Australian Airports,2023,4,50026,7333,57359
All Australian Airports,2023,5,52399,7200,59599
All Australian Airports,2023,6,50376,7415,57791
All Australian Airports,2023,7,52006,8146,60152
All Australian Airports,2023,8,53074,7989,61063
All Australian Airports,2023,9,51500,7909,59409
All Australian Airports,2023,10,52928,8014,60942
All Australian Airports,2023,11,51194,8056,59250
All Australian Airports,2023,12,50208,9362,59570
All Australian Airports,2024,1,50739,9556,60295
All Australian Airports,2024,2,48655,8266,56921
All Australian Airports,2024,3,51866,8595,60461
All Australian Airports,2024,4,52509,8369,60878
All Australian Airports,2024,5,52390,8168,60558
All Australian Airports,2024,6,49259,8198,57457
All Australian Airports,2024,7,54064,8854,62918
All Australian Airports,2024,8,50965,8580,59545
All Australian Airports,2024,9,50865,8487,59352
All Australian Airports,2024,10,52790,8713,61503
All Australian Airports,2024,11,49490,8598,58088
All Australian Airports,2024,12,49835,9870,59705